,Account Number,Balance Date,Transaction Value,Balance
0,10005367,2023-01-31,,728.25
1,10005367,2023-02-02,-1097.6,-369.3499999999999
2,10005367,2023-02-04,144.75,-224.5999999999999
3,10005367,2023-02-04,-67.01,-291.6099999999999
4,10005367,2023-02-05,-108.26,-399.8699999999999
5,10005367,2023-02-08,941.0,541.1300000000001
6,10005367,2023-02-08,-65.49,475.6400000000001
7,10005367,2023-02-10,-27.61,448.0300000000001
8,10005367,2023-02-11,137.25,585.2800000000001
9,10011977,2023-01-31,,676.54
10,10011977,2023-02-02,-51.0,625.54
11,10011977,2023-02-03,120.88,746.42
12,10011977,2023-02-04,58.05,804.4699999999999
13,10011977,2023-02-04,-170.56,633.91
14,10011977,2023-02-04,-189.38,444.53
15,10011977,2023-02-05,-124.61,319.91999999999996
16,10011977,2023-02-08,133.74,453.65999999999997
17,10011977,2023-02-10,-103.55,350.10999999999996
18,10011977,2023-02-11,-43.89,306.21999999999997
19,10011977,2023-02-14,1100.7,1406.92
20,10024680,2023-01-31,,567.46
21,10024680,2023-02-01,-153.43,414.03000000000003
22,10024680,2023-02-03,676.5,1090.53
23,10024680,2023-02-07,-91.92,998.61
24,10024680,2023-02-07,-127.45,871.16
25,10024680,2023-02-08,-138.18,732.98
26,10031238,2023-01-31,,576.52
27,10031238,2023-02-05,121.7,698.22
28,10031238,2023-02-05,-110.07,588.15
29,10031238,2023-02-09,-35.39,552.76
30,10031238,2023-02-10,65.02,617.78
31,10031238,2023-02-10,-160.6,457.18
32,10031238,2023-02-11,-157.96,299.22
33,10034341,2023-01-31,,390.39
34,10034341,2023-02-03,1566.6,1956.9899999999998
35,10034341,2023-02-05,-217.15,1739.8399999999997
36,10034341,2023-02-08,-110.25,1629.5899999999997
37,10034341,2023-02-12,123.13,1752.7199999999998
38,10034341,2023-02-14,-74.72,1677.9999999999998
39,10079965,2023-01-31,,799.27
40,10079965,2023-02-03,156.35,955.62
41,10079965,2023-02-08,-63.9,891.72
42,10079965,2023-02-08,-132.2,759.52
43,10079965,2023-02-08,-442.3,317.21999999999997
44,10091076,2023-01-31,,831.83
45,10091076,2023-02-01,75.45,907.2800000000001
46,10091076,2023-02-01,-18.77,888.51
47,10091076,2023-02-01,-83.96,804.5500000000001
48,10091076,2023-02-05,53.92,858.47
49,10091076,2023-02-14,53.72,912.19
50,10091076,2023-02-14,-10.22,901.97
51,10231977,2023-01-31,,61.63
52,10231977,2023-02-01,116.0,177.63
53,10231977,2023-02-08,-68.31,109.32
54,10231977,2023-02-09,-1410.1,-1300.78
55,10231977,2023-02-14,78.92,-1221.86
56,10231977,2023-02-14,-723.4,-1945.26
57,10232603,2023-01-31,,732.55
58,10232603,2023-02-01,125.68,858.23
59,10232603,2023-02-02,-1190.9,-332.6700000000001
60,10232603,2023-02-04,-888.9,-1221.5700000000002
61,10232603,2023-02-06,88.22,-1133.3500000000001
62,10232603,2023-02-07,-185.47,-1318.8200000000002
63,10232603,2023-02-10,85.03,-1233.79
64,10232603,2023-02-10,-1128.4,-2362.19
65,10243581,2023-01-31,,104.27
66,10243581,2023-02-04,-109.65,-5.38000000000001
67,10243581,2023-02-06,-78.93,-84.31000000000002
68,10243581,2023-02-10,83.3,-1.0100000000000193
69,10243581,2023-02-12,-1482.9,-1483.91
70,10243581,2023-02-13,-20.17,-1504.0800000000002
71,10243581,2023-02-14,-134.51,-1638.5900000000001
72,10271519,2023-01-31,,50.02
73,10271519,2023-02-03,2285.6,2335.62
74,10271519,2023-02-03,95.05,2430.67
75,10271519,2023-02-03,17.57,2448.24
76,10271519,2023-02-03,-100.99,2347.25
77,10271519,2023-02-11,-89.55,2257.7
78,10271519,2023-02-12,98.81,2356.5099999999998
79,10271519,2023-02-12,76.71,2433.22
80,10273387,2023-01-31,,581.83
81,10273387,2023-02-03,113.03,694.86
82,10273387,2023-02-03,-556.5,138.36
83,10273387,2023-02-06,181.24,319.6
84,10273387,2023-02-07,-38.41,281.19000000000005
85,10273387,2023-02-08,-140.45,140.74000000000004
86,10273387,2023-02-10,138.8,279.5400000000001
87,10273387,2023-02-10,-71.11,208.43000000000006
88,10273387,2023-02-12,130.68,339.11000000000007
89,10273387,2023-02-14,278.4,617.51
90,10288821,2023-01-31,,642.41
91,10288821,2023-02-07,-151.7,490.71
92,10288821,2023-02-11,85.41,576.12
93,10288821,2023-02-12,228.52,804.64
94,10288821,2023-02-14,94.21,898.85
95,10295384,2023-01-31,,153.85
96,10295384,2023-02-03,10.64,164.49
97,10295384,2023-02-04,55.98,220.47
98,10295384,2023-02-04,-96.09,124.38
99,10295384,2023-02-06,100.34,224.72
100,10295384,2023-02-06,87.57,312.28999999999996
101,10295384,2023-02-07,186.15,498.44
102,10295384,2023-02-07,133.09,631.53
103,10295384,2023-02-09,-110.01,521.52
104,10295384,2023-02-11,-62.52,459.0
105,10295384,2023-02-13,128.0,587.0
106,10350324,2023-01-31,,861.81
107,10350324,2023-02-03,247.64,1109.4499999999998
108,10350324,2023-02-04,81.35,1190.8
109,10350324,2023-02-04,47.39,1238.1899999999998
110,10350324,2023-02-07,-42.19,1196.0
111,10350324,2023-02-10,-91.04,1104.96
112,10350324,2023-02-11,132.19,1237.1499999999999
113,10350324,2023-02-11,119.75,1356.8999999999999
114,10350324,2023-02-13,-142.63,1214.27
115,10437896,2023-01-31,,661.08
116,10437896,2023-02-04,55.24,716.32
117,10437896,2023-02-04,-51.84,664.48
118,10437896,2023-02-06,68.72,733.2
119,10437896,2023-02-09,116.34,849.5400000000001
120,10437896,2023-02-11,1107.1,1956.6399999999999
121,10437896,2023-02-13,73.97,2030.61
122,10449180,2023-01-31,,228.24
123,10449180,2023-02-01,48.99,277.23
124,10449180,2023-02-02,25.81,303.04
125,10449180,2023-02-06,784.3,1087.34
126,10449180,2023-02-11,75.88,1163.2199999999998
127,10464544,2023-01-31,,755.99
128,10464544,2023-02-01,-89.56,666.4300000000001
129,10464544,2023-02-07,135.77,802.2
130,10464544,2023-02-08,132.1,934.3
131,10464544,2023-02-12,-463.1,471.2
132,10464544,2023-02-14,987.9,1459.1
133,10464544,2023-02-14,-81.26,1377.84
134,10473116,2023-01-31,,387.7
135,10473116,2023-02-01,-94.91,292.78999999999996
136,10473116,2023-02-03,87.46,380.25
137,10473116,2023-02-06,-1194.9,-814.6500000000001
138,10473116,2023-02-08,103.49,-711.1600000000001
139,10473116,2023-02-10,28.23,-682.9300000000001
140,10473116,2023-02-12,-108.51,-791.44
141,10521885,2023-01-31,,54.87
142,10521885,2023-02-01,127.41,182.28
143,10521885,2023-02-01,-83.86,98.42
144,10521885,2023-02-03,120.33,218.75
145,10521885,2023-02-09,37.14,255.89
146,10521885,2023-02-12,70.6,326.49
147,10521885,2023-02-14,150.19,476.68
148,10521885,2023-02-14,53.35,530.03
149,10553619,2023-01-31,,756.2
150,10553619,2023-02-01,72.18,828.3800000000001
151,10553619,2023-02-01,-112.77,715.61
152,10553619,2023-02-03,133.94,849.5500000000001
153,10553619,2023-02-04,-1263.9,-414.35
154,10553619,2023-02-05,-89.62,-503.97
155,10553619,2023-02-06,-1085.4,-1589.3700000000001
156,10553619,2023-02-11,873.9,-715.4700000000001
157,10553619,2023-02-14,1485.6,770.1299999999998
158,10553619,2023-02-14,-43.02,727.1099999999998
159,10554116,2023-01-31,,243.95
160,10554116,2023-02-01,-121.83,122.11999999999999
161,10586481,2023-01-31,,73.83
162,10586481,2023-02-03,100.42,174.25
163,10586481,2023-02-11,142.56,316.81
164,10586481,2023-02-12,128.32,445.13
165,10586481,2023-02-12,-49.53,395.6
166,10586481,2023-02-14,-24.89,370.71
167,10608220,2023-01-31,,632.92
168,10608220,2023-02-01,33.49,666.41
169,10608220,2023-02-01,-89.41,577.0
170,10608220,2023-02-04,-117.26,459.73999999999995
171,10608220,2023-02-05,78.8,538.54
172,10608220,2023-02-10,-55.88,482.65999999999997
173,10608220,2023-02-11,-142.56,340.09999999999997
174,10608220,2023-02-13,86.79,426.89
175,10608220,2023-02-13,-98.19,328.7
176,10608220,2023-02-13,-118.5,210.2
177,10631690,2023-01-31,,947.45
178,10631690,2023-02-03,165.39,1112.8400000000001
179,10631690,2023-02-03,-41.04,1071.8
180,10631690,2023-02-11,-151.02,920.78
181,10675607,2023-01-31,,284.84
182,10675607,2023-02-01,-114.21,170.63
183,10675607,2023-02-08,-19.11,151.51999999999998
184,10675607,2023-02-14,-908.4,-756.88
185,10725127,2023-01-31,,984.69
186,10725127,2023-02-04,-1268.7,-284.01
187,10725127,2023-02-09,148.39,-135.62
188,10725127,2023-02-11,102.03,-33.59
189,10725127,2023-02-12,-228.52,-262.11
190,10725127,2023-02-13,-157.99,-420.1
191,10769769,2023-01-31,,906.91
192,10769769,2023-02-01,-93.28,813.63
193,10769769,2023-02-02,38.78,852.41
194,10769769,2023-02-02,-20.72,831.6899999999999
195,10769769,2023-02-02,-96.8,734.89
196,10769769,2023-02-02,-1502.2,-767.3100000000001
197,10769769,2023-02-03,-89.51,-856.82
198,10769769,2023-02-05,145.08,-711.74
199,10769769,2023-02-05,-59.15,-770.8900000000001
200,10769769,2023-02-08,-143.57,-914.46
201,10769769,2023-02-09,58.86,-855.6
202,10769769,2023-02-10,-51.82,-907.4200000000001
203,10769769,2023-02-10,-85.7,-993.1200000000001
204,10769769,2023-02-11,666.5,-326.6200000000001
205,10769769,2023-02-11,172.32,-154.30000000000013
206,10783139,2023-01-31,,992.98
207,10783139,2023-02-04,103.81,1096.79
208,10783139,2023-02-05,-92.78,1004.01
209,10783139,2023-02-08,-96.33,907.6800000000001
210,10783139,2023-02-09,9.69,917.37
211,10783139,2023-02-09,-129.76,787.61
212,10783139,2023-02-10,72.06,859.6700000000001
213,10783139,2023-02-12,109.08,968.75
214,10799356,2023-01-31,,915.04
215,10799356,2023-02-06,138.24,1053.28
216,10799356,2023-02-06,127.85,1181.1299999999999
217,10799356,2023-02-11,-120.98,1060.1499999999999
218,10799356,2023-02-11,-259.39,800.76
219,10799356,2023-02-12,-94.16,706.6
220,10799356,2023-02-14,-1314.7,-608.1
221,10819898,2023-01-31,,750.25
222,10819898,2023-02-01,103.68,853.9300000000001
223,10819898,2023-02-02,15.52,869.45
224,10819898,2023-02-03,-91.02,778.4300000000001
225,10819898,2023-02-05,-36.13,742.3
226,10819898,2023-02-08,123.29,865.59
227,10819898,2023-02-10,-104.75,760.84
228,10819898,2023-02-12,98.15,858.99
229,10819898,2023-02-14,114.54,973.53
230,10819898,2023-02-14,47.83,1021.36
231,10842511,2023-01-31,,651.77
232,10842511,2023-02-02,-155.92,495.85
233,10842511,2023-02-13,102.44,598.29
234,10847941,2023-01-31,,40.25
235,10847941,2023-02-06,-64.29,-24.040000000000006
236,10847941,2023-02-07,-143.62,-167.66000000000003
237,10847941,2023-02-08,92.54,-75.12000000000002
238,10847941,2023-02-10,-146.12,-221.24
239,10847941,2023-02-11,1094.0,872.76
240,10864084,2023-01-31,,119.98
241,10864084,2023-02-02,-150.75,-30.769999999999996
242,10864084,2023-02-02,-179.69,-210.45999999999998
243,10864084,2023-02-05,-39.08,-249.53999999999996
244,10864084,2023-02-06,154.92,-94.62
245,10864084,2023-02-06,114.81,20.189999999999998
246,10864084,2023-02-06,72.7,92.89
247,10864084,2023-02-10,98.32,191.20999999999998
248,10864084,2023-02-11,65.15,256.36
249,10864084,2023-02-13,-1545.5,-1289.1399999999999
250,10942334,2023-01-31,,55.42
251,10942334,2023-02-05,-92.89,-37.47
252,10942334,2023-02-07,-33.98,-71.44999999999999
253,10942334,2023-02-10,116.67,45.22
254,10942334,2023-02-11,84.45,129.67000000000002
255,10949168,2023-01-31,,471.8
256,10949168,2023-02-04,-105.89,365.91
257,10949168,2023-02-04,-127.73,238.18
258,10949168,2023-02-07,71.99,310.17
259,10949168,2023-02-09,-214.76,95.41000000000003
260,10949168,2023-02-11,146.95,242.36
261,10949168,2023-02-12,52.81,295.17
262,10949168,2023-02-14,-13.43,281.74
263,10989769,2023-01-31,,334.18
264,10989769,2023-02-03,854.4,1188.58
265,10989769,2023-02-12,-154.56,1034.02
266,10989769,2023-02-13,102.22,1136.24
267,10989769,2023-02-13,-66.55,1069.69
268,11008868,2023-01-31,,271.3
269,11008868,2023-02-02,-0.91,270.39
270,11008868,2023-02-07,-207.86,62.53
271,11008868,2023-02-13,96.98,159.51
272,11008868,2023-02-13,93.56,253.07
273,11008868,2023-02-14,131.58,384.65000000000003
274,11026937,2023-01-31,,303.44
275,11026937,2023-02-02,90.91,394.35
276,11026937,2023-02-02,-47.72,346.63
277,11026937,2023-02-06,-85.44,261.19
278,11026937,2023-02-07,-75.08,186.11
279,11026937,2023-02-07,-92.55,93.56
280,11026937,2023-02-13,-42.26,51.300000000000004
281,11026937,2023-02-14,67.47,118.77000000000001
282,11061291,2023-01-31,,72.7
283,11061291,2023-02-01,-162.41,-89.71
284,11061291,2023-02-03,-53.42,-143.13
285,11061291,2023-02-03,-149.54,-292.66999999999996
286,11061291,2023-02-04,186.95,-105.72
287,11061291,2023-02-08,61.41,-44.31
288,11061291,2023-02-08,5.73,-38.58
289,11061291,2023-02-09,-119.17,-157.75
290,11061291,2023-02-12,121.86,-35.89
291,11061291,2023-02-14,-78.98,-114.87
292,11067879,2023-01-31,,481.56
293,11067879,2023-02-01,187.01,668.5699999999999
294,11067879,2023-02-01,-812.6,-144.02999999999997
295,11067879,2023-02-02,-15.52,-159.54999999999998
296,11067879,2023-02-04,81.63,-77.91999999999997
297,11067879,2023-02-06,97.09,19.17000000000003
298,11067879,2023-02-07,151.33,170.50000000000006
299,11067879,2023-02-07,-96.93,73.57000000000002
300,11067879,2023-02-07,-123.45,-49.87999999999998
301,11067879,2023-02-08,-66.39,-116.26999999999998
302,11067879,2023-02-11,172.57,56.30000000000001
303,11067879,2023-02-11,-87.16,-30.859999999999985
304,11067879,2023-02-13,-78.91,-109.76999999999998
305,11110085,2023-01-31,,861.29
306,11110085,2023-02-03,107.9,969.1899999999999
307,11110085,2023-02-05,1712.2,2681.39
308,11110085,2023-02-06,97.33,2778.7200000000003
309,11110085,2023-02-11,109.66,2888.38
310,11110085,2023-02-12,122.36,3010.7400000000002
311,11110085,2023-02-12,-66.27,2944.4700000000003
312,11110085,2023-02-13,-147.67,2796.8
313,11110085,2023-02-14,1397.8,4194.6
314,11110085,2023-02-14,-152.84,4041.76
315,11150945,2023-01-31,,858.83
316,11150945,2023-02-01,240.2,1099.03
317,11150945,2023-02-01,-345.3,753.73
318,11150945,2023-02-03,32.07,785.8000000000001
319,11150945,2023-02-03,-189.03,596.77
320,11150945,2023-02-06,43.59,640.36
321,11150945,2023-02-09,133.16,773.52
322,11150945,2023-02-09,98.03,871.55
323,11150945,2023-02-13,763.2,1634.75
324,11150945,2023-02-13,-126.72,1508.03
325,11228111,2023-01-31,,130.36
326,11228111,2023-02-01,-142.2,-11.839999999999975
327,11228111,2023-02-02,-1501.3,-1513.1399999999999
328,11228111,2023-02-09,179.65,-1333.4899999999998
329,11228111,2023-02-10,169.47,-1164.02
330,11228111,2023-02-11,77.54,-1086.4799999999998
331,11228111,2023-02-11,69.11,-1017.3699999999999
332,11242986,2023-01-31,,344.68
333,11242986,2023-02-01,-160.4,184.28
334,11242986,2023-02-06,-21.12,163.16
335,11242986,2023-02-08,-93.77,69.39
336,11242986,2023-02-09,55.87,125.25999999999999
337,11242986,2023-02-11,-102.16,23.099999999999994
338,11251776,2023-01-31,,504.02
339,11251776,2023-02-03,88.94,592.96
340,11251776,2023-02-04,84.15,677.11
341,11251776,2023-02-09,150.22,827.3299999999999
342,11251776,2023-02-10,-67.69,759.64
343,11251776,2023-02-11,79.08,838.72
344,11251776,2023-02-14,-950.7,-111.98000000000002
345,11302888,2023-01-31,,458.83
346,11302888,2023-02-04,117.6,576.43
347,11302888,2023-02-05,-80.56,495.87
348,11302888,2023-02-06,182.96,678.8299999999999
349,11302888,2023-02-10,-19.72,659.11
350,11306584,2023-01-31,,522.4
351,11306584,2023-02-01,52.0,574.4
352,11306584,2023-02-03,-432.2,142.2
353,11306584,2023-02-07,1198.9,1341.1000000000001
354,11306584,2023-02-07,45.38,1386.4800000000002
355,11306584,2023-02-09,151.14,1537.6200000000001
356,11306584,2023-02-10,-30.61,1507.0100000000002
357,11306584,2023-02-11,63.83,1570.8400000000001
358,11306584,2023-02-12,1681.9,3252.7400000000002
359,11306584,2023-02-12,-71.74,3181.0000000000005
360,11306584,2023-02-14,-701.1,2479.9
361,11333185,2023-01-31,,693.23
362,11333185,2023-02-02,99.58,792.8100000000001
363,11333185,2023-02-06,113.2,906.01
364,11333185,2023-02-06,-676.7,229.30999999999995
365,11333185,2023-02-07,186.08,415.39
366,11333185,2023-02-07,-1440.9,-1025.5100000000002
367,11333185,2023-02-10,-67.29,-1092.8000000000002
368,11333185,2023-02-11,155.81,-936.9900000000002
369,11333185,2023-02-11,88.41,-848.5800000000003
370,11333185,2023-02-11,-138.48,-987.0600000000002
371,11333185,2023-02-13,1582.4,595.3399999999999
372,11346696,2023-01-31,,661.99
373,11346696,2023-02-04,-91.69,570.3
374,11346696,2023-02-06,-75.77,494.53000000000003
375,11346696,2023-02-09,-113.15,381.38
376,11346696,2023-02-10,-812.8,-431.41999999999996
377,11346696,2023-02-13,-1487.7,-1919.12
378,11359678,2023-01-31,,837.17
379,11359678,2023-02-07,65.16,902.3299999999999
380,11359678,2023-02-07,-67.04,835.29
381,11359678,2023-02-11,62.24,897.53
382,11359678,2023-02-14,-74.53,823.0
383,11360263,2023-01-31,,136.79
384,11360263,2023-02-01,100.02,236.81
385,11360263,2023-02-03,130.53,367.34
386,11360263,2023-02-03,101.8,469.14
387,11360263,2023-02-06,173.03,642.17
388,11360263,2023-02-06,80.15,722.3199999999999
389,11360263,2023-02-09,-68.25,654.0699999999999
390,11360263,2023-02-12,-47.25,606.8199999999999
391,11368995,2023-01-31,,565.8
392,11368995,2023-02-01,-63.48,502.31999999999994
393,11368995,2023-02-02,150.75,653.0699999999999
394,11368995,2023-02-02,-140.61,512.4599999999999
395,11368995,2023-02-04,-121.49,390.96999999999997
396,11368995,2023-02-05,-92.6,298.36999999999995
397,11368995,2023-02-06,52.22,350.59
398,11368995,2023-02-08,65.06,415.65
399,11437275,2023-01-31,,115.34
400,11437275,2023-02-05,98.47,213.81
401,11437275,2023-02-07,112.5,326.31
402,11437275,2023-02-07,-144.5,181.81
403,11437275,2023-02-09,94.06,275.87
404,11437275,2023-02-10,-100.43,175.44
405,11437275,2023-02-10,-112.61,62.83
406,11438427,2023-01-31,,484.08
407,11438427,2023-02-06,123.77,607.85
408,11438427,2023-02-07,-23.9,583.9499999999999
409,11438427,2023-02-08,-190.12,393.83
410,11438427,2023-02-08,-1686.0,-1292.17
411,11463412,2023-01-31,,342.53
412,11463412,2023-02-07,-97.82,244.70999999999998
413,11463412,2023-02-09,1582.3,1827.01
414,11475827,2023-01-31,,363.88
415,11475827,2023-02-01,48.39,412.27
416,11475827,2023-02-07,89.09,501.36
417,11475827,2023-02-08,-45.54,455.82
418,11475827,2023-02-11,1129.9,1585.72
419,11475827,2023-02-11,86.86,1672.58
420,11475827,2023-02-12,106.02,1778.6
421,11522216,2023-01-31,,590.37
422,11522216,2023-02-03,43.61,633.98
423,11522216,2023-02-04,199.41,833.39
424,11522216,2023-02-10,106.62,940.01
425,11522216,2023-02-10,82.97,1022.98
426,11522216,2023-02-14,81.37,1104.35
427,11662506,2023-01-31,,573.89
428,11662506,2023-02-01,-167.85,406.03999999999996
429,11662506,2023-02-05,102.96,509.0
430,11662506,2023-02-05,89.72,598.72
431,11662506,2023-02-09,-38.09,560.63
432,11662506,2023-02-09,-134.78,425.84999999999997
433,11662506,2023-02-11,-84.35,341.5
434,11662506,2023-02-14,-77.33,264.16999999999996
435,11662506,2023-02-14,-1397.8,-1133.63
436,11694020,2023-01-31,,379.2
437,11694020,2023-02-04,-189.72,189.48
438,11694020,2023-02-06,44.43,233.91
439,11694020,2023-02-09,-1363.6,-1129.6899999999998
440,11694020,2023-02-12,1.29,-1128.3999999999999
441,11694020,2023-02-14,725.0,-403.39999999999986
442,11717885,2023-01-31,,6.06
443,11717885,2023-02-05,-72.53,-66.47
444,11717885,2023-02-13,-86.51,-152.98000000000002
445,11728970,2023-01-31,,711.65
446,11728970,2023-02-06,123.61,835.26
447,11728970,2023-02-06,84.79,920.05
448,11728970,2023-02-09,-135.18,784.87
449,11728970,2023-02-14,93.35,878.22
450,11736814,2023-01-31,,381.51
451,11736814,2023-02-03,-133.06,248.45
452,11736814,2023-02-05,-790.5,-542.05
453,11736814,2023-02-06,98.86,-443.18999999999994
454,11736814,2023-02-11,-1851.4,-2294.59
455,11744491,2023-01-31,,105.92
456,11744491,2023-02-01,142.98,248.89999999999998
457,11744491,2023-02-01,112.17,361.07
458,11744491,2023-02-03,656.3,1017.3699999999999
459,11744491,2023-02-04,-144.75,872.6199999999999
460,11744491,2023-02-06,-92.39,780.2299999999999
461,11744491,2023-02-09,87.15,867.3799999999999
462,11744491,2023-02-09,-176.85,690.53
463,11744491,2023-02-10,-39.7,650.8299999999999
464,11744491,2023-02-11,85.89,736.7199999999999
465,11744491,2023-02-12,-55.81,680.9099999999999
466,11744491,2023-02-13,115.86,796.7699999999999
467,11744491,2023-02-13,-121.39,675.3799999999999
468,11764022,2023-01-31,,286.66
469,11764022,2023-02-01,-117.24,169.42000000000002
470,11764022,2023-02-03,3.65,173.07000000000002
471,11764022,2023-02-10,86.61,259.68000000000006
472,11778031,2023-01-31,,514.7
473,11778031,2023-02-08,-37.69,477.01000000000005
474,11778031,2023-02-09,-64.44,412.57000000000005
475,11778031,2023-02-11,102.08,514.6500000000001
476,11778031,2023-02-13,569.6,1084.25
477,11790056,2023-01-31,,49.7
478,11790056,2023-02-01,119.97,169.67000000000002
479,11790056,2023-02-01,-95.49,74.18
480,11790056,2023-02-03,12.0,86.18
481,11790056,2023-02-05,-91.81,-5.6299999999999955
482,11790056,2023-02-06,-47.78,-53.41
483,11790056,2023-02-06,-688.5,-741.91
484,11790056,2023-02-08,90.7,-651.2099999999999
485,11790056,2023-02-08,-41.57,-692.78
486,11790056,2023-02-09,-969.7,-1662.48
487,11804173,2023-01-31,,353.62
488,11804173,2023-02-02,119.36,472.98
489,11804173,2023-02-04,100.25,573.23
490,11804173,2023-02-04,-159.42,413.81
491,11804173,2023-02-11,-53.59,360.22
492,11826060,2023-01-31,,782.13
493,11826060,2023-02-05,63.32,845.45
494,11826060,2023-02-07,81.64,927.09
495,11826060,2023-02-09,38.13,965.22
496,11826060,2023-02-11,-63.83,901.39
497,11826060,2023-02-13,118.67,1020.06
498,11826060,2023-02-13,93.04,1113.1
499,11831265,2023-01-31,,292.14
500,11831265,2023-02-01,-91.77,200.37
501,11831265,2023-02-01,-103.4,96.96999999999998
502,11831265,2023-02-01,-140.67,-43.7
503,11831265,2023-02-09,-98.31,-142.01
504,11831265,2023-02-10,89.98,-52.03
505,11831265,2023-02-13,157.99,105.96000000000001
506,11831265,2023-02-14,-85.67,20.290000000000006
507,11836917,2023-01-31,,650.14
508,11836917,2023-02-01,-138.19,511.95
509,11836917,2023-02-12,90.66,602.61
510,11836917,2023-02-14,165.55,768.16
511,11836917,2023-02-14,87.88,856.04
512,11846043,2023-01-31,,915.59
513,11846043,2023-02-02,69.49,985.08
514,11846043,2023-02-06,87.82,1072.9
515,11846043,2023-02-07,-56.28,1016.62
516,11846043,2023-02-10,-1640.4,-623.7800000000001
517,11846043,2023-02-12,139.76,-484.0200000000001
518,11882775,2023-01-31,,299.41
519,11882775,2023-02-01,-105.63,193.78000000000003
520,11882775,2023-02-01,-1058.7,-864.9200000000001
521,11882775,2023-02-03,118.76,-746.1600000000001
522,11882775,2023-02-03,-753.5,-1499.66
523,11882775,2023-02-05,84.05,-1415.6100000000001
524,11882775,2023-02-06,-90.05,-1505.66
525,11882775,2023-02-06,-1791.9,-3297.5600000000004
526,11882775,2023-02-08,209.73,-3087.8300000000004
527,11882775,2023-02-09,1202.9,-1884.93
528,11910409,2023-01-31,,241.22
529,11910409,2023-02-01,-80.43,160.79
530,11910409,2023-02-04,-78.93,81.85999999999999
531,11910409,2023-02-05,78.36,160.21999999999997
532,11910409,2023-02-05,-118.22,41.999999999999986
533,11910409,2023-02-06,-53.53,-11.530000000000015
534,11910409,2023-02-12,103.79,92.25999999999999
535,11910409,2023-02-13,112.31,204.57
536,11928523,2023-01-31,,818.51
537,11928523,2023-02-05,-149.91,668.6
538,11928523,2023-02-07,-76.58,592.02
539,11928523,2023-02-08,-74.38,517.64
540,11928523,2023-02-11,99.31,616.95
541,11928523,2023-02-12,2208.4,2825.3500000000004
542,11928523,2023-02-13,68.67,2894.02
543,12035637,2023-01-31,,461.35
544,12035637,2023-02-02,-779.9,-318.54999999999995
545,12035637,2023-02-02,-1138.0,-1456.55
546,12035637,2023-02-03,-36.14,-1492.69
547,12035637,2023-02-07,1190.8,-301.8900000000001
548,12035637,2023-02-07,260.82,-41.07000000000011
549,12035637,2023-02-07,230.31,189.2399999999999
550,12035637,2023-02-08,-90.52,98.7199999999999
551,12035637,2023-02-08,-143.15,-44.430000000000106
552,12035637,2023-02-08,-1169.6,-1214.03
553,12035637,2023-02-10,551.6,-662.43
554,12035637,2023-02-11,-137.31,-799.74
555,12035637,2023-02-12,-123.5,-923.24
556,12042151,2023-01-31,,336.44
557,12042151,2023-02-03,-89.74,246.7
558,12042151,2023-02-05,97.45,344.15
559,12042151,2023-02-07,101.5,445.65
560,12042151,2023-02-09,-64.03,381.62
561,12042151,2023-02-11,1271.5,1653.12
562,12042151,2023-02-11,-32.04,1621.08
563,12042151,2023-02-13,-61.53,1559.55
564,12088180,2023-01-31,,656.51
565,12088180,2023-02-11,22.62,679.13
566,12088180,2023-02-12,190.9,870.03
567,12088180,2023-02-14,-45.9,824.13
568,12099406,2023-01-31,,681.11
569,12099406,2023-02-01,-94.97,586.14
570,12099406,2023-02-07,-934.2,-348.06000000000006
571,12099406,2023-02-10,-143.73,-491.7900000000001
572,12099406,2023-02-12,1201.1,709.3099999999998
573,12099406,2023-02-13,112.0,821.3099999999998
574,12111805,2023-01-31,,890.99
575,12111805,2023-02-01,110.9,1001.89
576,12111805,2023-02-03,-79.35,922.54
577,12111805,2023-02-06,128.91,1051.45
578,12111805,2023-02-10,-185.21,866.24
579,12111805,2023-02-11,-77.84,788.4
580,12111805,2023-02-13,-202.54,585.86
581,12111805,2023-02-14,-94.45,491.41
582,12172627,2023-01-31,,550.41
583,12172627,2023-02-02,137.03,687.4399999999999
584,12172627,2023-02-05,-116.16,571.28
585,12172627,2023-02-12,-76.51,494.77
586,12185627,2023-01-31,,873.23
587,12185627,2023-02-02,-30.52,842.71
588,12185627,2023-02-03,225.89,1068.6
589,12185627,2023-02-04,-50.19,1018.41
590,12185627,2023-02-05,-80.67,937.74
591,12185627,2023-02-10,206.97,1144.71
592,12185627,2023-02-11,193.89,1338.6
593,12185627,2023-02-11,100.94,1439.54
594,12185627,2023-02-12,-72.94,1366.6
595,12185627,2023-02-13,-91.8,1274.8
596,12198380,2023-01-31,,445.46
597,12198380,2023-02-03,145.97,591.43
598,12198380,2023-02-04,134.24,725.67
599,12198380,2023-02-05,100.05,825.72
600,12198380,2023-02-05,-144.38,681.3399999999999
601,12198380,2023-02-05,-171.75,509.59
602,12198380,2023-02-07,-34.47,475.12
603,12198380,2023-02-09,145.71,620.8299999999999
604,12198380,2023-02-12,67.66,688.49
605,12198380,2023-02-14,-85.37,603.12
606,12199229,2023-01-31,,804.0
607,12199229,2023-02-11,-30.47,773.53
608,12199229,2023-02-11,-31.4,742.13
609,12233762,2023-01-31,,386.05
610,12233762,2023-02-05,-114.97,271.08000000000004
611,12233762,2023-02-06,-102.35,168.73000000000002
612,12233762,2023-02-07,-110.05,58.68000000000002
613,12233762,2023-02-07,-134.62,-75.93999999999998
614,12233762,2023-02-10,83.93,7.990000000000023
615,12233762,2023-02-11,-370.4,-362.40999999999997
616,12233762,2023-02-12,150.86,-211.54999999999995
617,12233762,2023-02-14,-176.37,-387.91999999999996
618,12240007,2023-01-31,,894.48
619,12240007,2023-02-02,93.98,988.46
620,12240007,2023-02-04,-2.44,986.02
621,12240007,2023-02-05,1748.6,2734.62
622,12240007,2023-02-05,-64.41,2670.21
623,12240007,2023-02-12,-127.13,2543.08
624,12240007,2023-02-13,-562.4,1980.6799999999998
625,12241820,2023-01-31,,207.29
626,12388837,2023-01-31,,463.31
627,12388837,2023-02-03,55.47,518.78
628,12388837,2023-02-05,-183.42,335.36
629,12388837,2023-02-07,65.45,400.81
630,12388837,2023-02-13,111.37,512.1800000000001
631,12388837,2023-02-14,87.61,599.79
632,12420291,2023-01-31,,578.47
633,12420291,2023-02-03,-1223.8,-645.3299999999999
634,12420291,2023-02-08,-796.3,-1441.6299999999999
635,12420291,2023-02-11,-105.46,-1547.09
636,12420291,2023-02-12,-70.05,-1617.1399999999999
637,12423613,2023-01-31,,459.18
638,12423613,2023-02-02,-1805.5,-1346.32
639,12423613,2023-02-04,95.13,-1251.19
640,12423613,2023-02-14,73.71,-1177.48
641,12440230,2023-01-31,,842.67
642,12440230,2023-02-07,16.27,858.9399999999999
643,12440230,2023-02-07,-197.12,661.8199999999999
644,12440230,2023-02-14,-175.06,486.76
645,12493067,2023-01-31,,404.61
646,12493067,2023-02-03,86.49,491.1
647,12493067,2023-02-06,114.74,605.84
648,12493067,2023-02-08,-105.32,500.52
649,12493067,2023-02-13,-93.04,407.48
650,12493067,2023-02-14,44.96,452.44
651,12494185,2023-01-31,,762.16
652,12494185,2023-02-04,71.39,833.55
653,12494185,2023-02-04,-97.26,736.29
654,12494185,2023-02-07,-97.29,639.0
655,12494185,2023-02-07,-117.32,521.68
656,12499656,2023-01-31,,96.27
657,12499656,2023-02-01,168.84,265.11
658,12499656,2023-02-01,75.09,340.2
659,12499656,2023-02-02,140.57,480.77
660,12499656,2023-02-03,-111.35,369.41999999999996
661,12499656,2023-02-05,147.75,517.17
662,12499656,2023-02-06,-88.22,428.95
663,12499656,2023-02-07,-38.62,390.33
664,12499656,2023-02-10,152.92,543.25
665,12499656,2023-02-13,98.34,641.5899999999999
666,12499656,2023-02-14,-156.27,485.31999999999994
667,12560453,2023-01-31,,85.03
668,12560453,2023-02-01,147.6,232.63
669,12560453,2023-02-05,152.02,384.65
670,12560453,2023-02-05,71.33,455.98
671,12560453,2023-02-08,47.58,503.56
672,12560453,2023-02-08,-55.71,447.85
673,12560453,2023-02-13,-49.05,398.8
674,12583269,2023-01-31,,910.46
675,12583269,2023-02-02,125.46,1035.92
676,12583269,2023-02-03,-118.33,917.59
677,12583269,2023-02-04,-129.11,788.48
678,12583269,2023-02-05,80.89,869.37
679,12583269,2023-02-14,63.34,932.71
680,12666385,2023-01-31,,554.24
681,12666385,2023-02-01,246.14,800.38
682,12666385,2023-02-01,106.46,906.84
683,12666385,2023-02-04,1593.8,2500.64
684,12666385,2023-02-12,149.57,2650.21
685,12680102,2023-01-31,,674.64
686,12680102,2023-02-05,-41.65,632.99
687,12680102,2023-02-08,603.0,1235.99
688,12680102,2023-02-09,-97.29,1138.7
689,12680102,2023-02-11,-1010.6,128.10000000000002
690,12680102,2023-02-12,94.03,222.13000000000002
691,12680102,2023-02-13,-851.7,-629.57
692,12725274,2023-01-31,,26.19
693,12725274,2023-02-01,167.85,194.04
694,12725274,2023-02-04,125.11,319.15
695,12725274,2023-02-05,-58.28,260.87
696,12725274,2023-02-14,412.8,673.6700000000001
697,12725274,2023-02-14,-162.9,510.77
698,12859818,2023-01-31,,151.06
699,12859818,2023-02-01,89.22,240.28
700,12859818,2023-02-03,-129.38,110.9
701,12859818,2023-02-04,-81.01,29.89
702,12859818,2023-02-04,-110.3,-80.41
703,12859818,2023-02-07,-106.24,-186.64999999999998
704,12859818,2023-02-10,-36.91,-223.56
705,12859818,2023-02-10,-131.38,-354.94
706,12859818,2023-02-13,-203.37,-558.31
707,12859818,2023-02-14,24.89,-533.42
708,12899540,2023-01-31,,957.2
709,12899540,2023-02-01,-83.35,873.85
710,12899540,2023-02-04,125.25,999.1
711,12899540,2023-02-06,159.04,1158.14
712,12899540,2023-02-06,-78.47,1079.67
713,12899540,2023-02-10,-85.03,994.6400000000001
714,12964138,2023-01-31,,557.04
715,12964138,2023-02-01,101.62,658.66
716,12964138,2023-02-01,-55.49,603.17
717,12964138,2023-02-06,104.0,707.17
718,12964138,2023-02-13,-357.3,349.86999999999995
719,12985543,2023-01-31,,402.94
720,12985543,2023-02-01,-140.27,262.66999999999996
721,12985543,2023-02-07,-99.51,163.15999999999997
722,12985543,2023-02-09,118.41,281.57
723,12985543,2023-02-11,57.3,338.87
724,12985543,2023-02-13,-62.13,276.73999999999995
725,13058003,2023-01-31,,218.0
726,13058003,2023-02-02,-35.9,182.1
727,13058003,2023-02-09,-1246.4,-1064.3000000000002
728,13058003,2023-02-11,-96.36,-1160.66
729,13058003,2023-02-13,565.6,-595.0600000000002
730,13076932,2023-01-31,,419.47
731,13076932,2023-02-02,-125.46,294.01000000000005
732,13076932,2023-02-08,-94.91,199.10000000000002
733,13076932,2023-02-11,146.03,345.13000000000005
734,13076932,2023-02-13,136.72,481.85
735,13117442,2023-01-31,,799.69
736,13117442,2023-02-02,-46.31,753.3800000000001
737,13117442,2023-02-05,101.84,855.22
738,13117442,2023-02-05,59.8,915.0200000000001
739,13117442,2023-02-05,-164.35,750.6700000000001
740,13117442,2023-02-08,-109.72,640.95
741,13117442,2023-02-11,1828.9,2469.8500000000004
742,13117442,2023-02-12,-132.28,2337.57
743,13167285,2023-01-31,,301.93
744,13167285,2023-02-01,-3.89,298.04
745,13167285,2023-02-01,-199.99,98.05000000000001
746,13167285,2023-02-03,139.6,237.65
747,13167285,2023-02-03,-529.6,-291.95000000000005
748,13167285,2023-02-05,-21.67,-313.62000000000006
749,13167285,2023-02-06,204.86,-108.76000000000005
750,13167285,2023-02-07,-78.2,-186.96000000000004
751,13167285,2023-02-09,-20.1,-207.06000000000006
752,13167285,2023-02-13,-99.54,-306.6
753,13167285,2023-02-13,-136.9,-443.50000000000006
754,13167285,2023-02-14,38.92,-404.58000000000004
755,13176075,2023-01-31,,67.3
756,13176075,2023-02-04,127.96,195.26
757,13176075,2023-02-08,-167.77,27.48999999999998
758,13176075,2023-02-12,-149.27,-121.78000000000003
759,13182613,2023-01-31,,384.42
760,13182613,2023-02-05,220.0,604.4200000000001
761,13182613,2023-02-06,63.49,667.91
762,13182613,2023-02-08,-113.46,554.45
763,13182613,2023-02-09,55.88,610.33
764,13182613,2023-02-09,-79.45,530.88
765,13197335,2023-01-31,,625.71
766,13197335,2023-02-01,98.45,724.1600000000001
767,13197335,2023-02-01,85.83,809.99
768,13197335,2023-02-02,100.61,910.6
769,13197335,2023-02-02,-93.5,817.1
770,13197335,2023-02-08,79.86,896.96
771,13197335,2023-02-09,1043.8,1940.76
772,13197335,2023-02-10,1812.5,3753.26
773,13197335,2023-02-11,-215.83,3537.43
774,13267945,2023-01-31,,299.77
775,13267945,2023-02-03,102.35,402.12
776,13267945,2023-02-04,1080.2,1482.3200000000002
777,13267945,2023-02-07,81.75,1564.07
778,13267945,2023-02-08,154.6,1718.6699999999998
779,13267945,2023-02-10,71.11,1789.78
780,13274987,2023-01-31,,902.06
781,13274987,2023-02-01,-33.51,868.55
782,13274987,2023-02-03,-53.43,815.1199999999999
783,13274987,2023-02-03,-111.04,704.0799999999999
784,13274987,2023-02-04,-93.78,610.3
785,13274987,2023-02-05,101.16,711.4599999999999
786,13274987,2023-02-08,1290.2,2001.6599999999999
787,13274987,2023-02-12,118.61,2120.27
788,13274987,2023-02-12,-117.48,2002.79
789,13277127,2023-01-31,,793.22
790,13277127,2023-02-03,17.26,810.48
791,13277127,2023-02-05,-17.93,792.5500000000001
792,13277127,2023-02-06,-1037.3,-244.7499999999999
793,13277127,2023-02-08,714.2,469.45000000000016
794,13277127,2023-02-08,251.9,721.3500000000001
795,13322659,2023-01-31,,690.27
796,13322659,2023-02-01,-153.9,536.37
797,13322659,2023-02-02,-145.27,391.09999999999997
798,13322659,2023-02-04,123.49,514.5899999999999
799,13322659,2023-02-05,36.77,551.36
800,13322659,2023-02-05,-53.92,497.43999999999994
801,13322659,2023-02-09,-85.8,411.64
802,13322659,2023-02-09,-106.38,305.26
803,13322659,2023-02-14,-113.46,191.79999999999995
804,13388069,2023-01-31,,13.45
805,13388069,2023-02-07,134.99,148.44
806,13388069,2023-02-08,27.53,175.97
807,13388069,2023-02-12,-69.99,105.98
808,13426667,2023-01-31,,70.47
809,13426667,2023-02-05,-121.7,-51.230000000000004
810,13426667,2023-02-08,32.44,-18.790000000000006
811,13426667,2023-02-12,1224.6,1205.81
812,13426667,2023-02-13,-902.0,303.80999999999995
813,13459523,2023-01-31,,814.31
814,13459523,2023-02-03,135.59,949.9
815,13459523,2023-02-03,-952.0,-2.1000000000000227
816,13459523,2023-02-06,-171.67,-173.77
817,13459523,2023-02-07,57.31,-116.46000000000001
818,13459523,2023-02-08,898.2,781.74
819,13459523,2023-02-10,166.54,948.28
820,13459523,2023-02-10,-132.35,815.9300000000001
821,13459523,2023-02-13,162.92,978.85
822,13474543,2023-01-31,,438.36
823,13474543,2023-02-01,120.92,559.28
824,13474543,2023-02-05,-107.87,451.41
825,13474543,2023-02-06,87.33,538.74
826,13474543,2023-02-09,264.6,803.34
827,13474543,2023-02-14,159.08,962.4200000000001
828,13474543,2023-02-14,76.83,1039.25
829,13537427,2023-01-31,,556.98
830,13537427,2023-02-01,52.56,609.54
831,13537427,2023-02-07,164.7,774.24
832,13537427,2023-02-11,246.42,1020.66
833,13537427,2023-02-12,-172.13,848.53
834,13551717,2023-01-31,,26.95
835,13551717,2023-02-01,-1361.0,-1334.05
836,13551717,2023-02-05,-627.1,-1961.15
837,13551717,2023-02-11,-42.85,-2004.0
838,13551717,2023-02-14,-115.32,-2119.32
839,13558846,2023-01-31,,598.45
840,13558846,2023-02-01,50.33,648.7800000000001
841,13558846,2023-02-01,-94.06,554.72
842,13558846,2023-02-04,148.08,702.8000000000001
843,13558846,2023-02-05,-148.46,554.34
844,13558846,2023-02-09,-115.1,439.24000000000007
845,13558846,2023-02-13,-112.18,327.06000000000006
846,13563384,2023-01-31,,952.65
847,13563384,2023-02-02,39.75,992.4
848,13563384,2023-02-11,54.28,1046.68
849,13563384,2023-02-12,70.05,1116.73
850,13563384,2023-02-14,-860.1,256.63
851,13584908,2023-01-31,,162.0
852,13584908,2023-02-02,-75.16,86.84
853,13584908,2023-02-05,-85.05,1.7900000000000063
854,13584908,2023-02-10,135.21,137.0
855,13584908,2023-02-10,-81.43,55.57000000000002
856,13610259,2023-01-31,,587.73
857,13610259,2023-02-09,33.72,621.45
858,13610259,2023-02-10,655.8,1277.25
859,13610259,2023-02-11,91.03,1368.28
860,13610259,2023-02-12,-100.74,1267.54
861,13687711,2023-01-31,,757.76
862,13687711,2023-02-02,-75.11,682.65
863,13687711,2023-02-04,-135.11,547.54
864,13687711,2023-02-11,-73.61,473.92999999999995
865,13687711,2023-02-13,734.3,1208.23
866,13687711,2023-02-14,-76.83,1131.3999999999999
867,13713704,2023-01-31,,1.48
868,13713704,2023-02-02,91.84,93.32000000000001
869,13713704,2023-02-04,-184.38,-91.05999999999999
870,13713704,2023-02-10,122.82,31.760000000000005
871,13713704,2023-02-10,-97.03,-65.27
872,13713704,2023-02-11,78.2,12.930000000000007
873,13713704,2023-02-13,-14.09,-1.159999999999993
874,13788234,2023-01-31,,302.78
875,13788234,2023-02-06,-100.59,202.18999999999997
876,13788234,2023-02-07,-140.37,61.819999999999965
877,13788234,2023-02-07,-163.8,-101.98000000000005
878,13788234,2023-02-08,-33.64,-135.62000000000006
879,13788234,2023-02-10,147.03,11.409999999999968
880,13788234,2023-02-14,112.47,123.87999999999997
881,13788234,2023-02-14,90.07,213.94999999999996
882,13945841,2023-01-31,,339.81
883,13945841,2023-02-01,473.7,813.51
884,13945841,2023-02-14,43.02,856.53
885,13965360,2023-01-31,,299.46
886,13965360,2023-02-11,-1655.3,-1355.84
887,13997603,2023-01-31,,516.79
888,13997603,2023-02-03,34.72,551.51
889,13997603,2023-02-07,788.3,1339.81
890,13997603,2023-02-07,52.55,1392.36
891,13997603,2023-02-10,-69.88,1322.48
892,13997603,2023-02-10,-155.28,1167.1999999999998
893,14000447,2023-01-31,,443.94
894,14000447,2023-02-01,97.79,541.73
895,14000447,2023-02-06,-154.42,387.31
896,14000447,2023-02-09,-74.98,312.33
897,14000447,2023-02-10,26.87,339.2
898,14000447,2023-02-13,147.67,486.87
899,14000447,2023-02-13,-55.26,431.60999999999996
900,14014401,2023-01-31,,554.46
901,14014401,2023-02-06,185.73,740.19
902,14014401,2023-02-08,40.08,780.27
903,14014401,2023-02-09,-1549.1,-768.8299999999999
904,14014401,2023-02-10,73.16,-695.67
905,14039438,2023-01-31,,94.52
906,14039438,2023-02-02,248.7,343.21999999999997
907,14039438,2023-02-03,117.17,460.39
908,14039438,2023-02-05,35.3,495.68999999999994
909,14039438,2023-02-06,-155.88,339.80999999999995
910,14039438,2023-02-09,141.4,481.21
911,14045416,2023-01-31,,265.63
912,14045416,2023-02-01,-53.46,212.17
913,14045416,2023-02-02,152.95,365.12
914,14045416,2023-02-03,67.35,432.46999999999997
915,14045416,2023-02-03,-89.03,343.43999999999994
916,14045416,2023-02-08,-42.88,300.55999999999995
917,14052052,2023-01-31,,915.74
918,14052052,2023-02-05,-89.52,826.22
919,14052052,2023-02-08,-192.5,633.72
920,14052052,2023-02-09,-512.3,121.42000000000007
921,14052052,2023-02-09,-666.4,-544.9799999999999
922,14052052,2023-02-12,117.55,-427.4299999999999
923,14052052,2023-02-14,-137.73,-565.1599999999999
924,14086187,2023-01-31,,340.59
925,14086187,2023-02-02,551.2,891.79
926,14086187,2023-02-03,166.13,1057.92
927,14086187,2023-02-04,146.29,1204.21
928,14086187,2023-02-05,-98.2,1106.01
929,14086187,2023-02-06,135.77,1241.78
930,14086187,2023-02-08,58.95,1300.73
931,14086187,2023-02-08,-42.56,1258.17
932,14103210,2023-01-31,,369.01
933,14103210,2023-02-04,-111.88,257.13
934,14103210,2023-02-06,-1.14,255.99
935,14103210,2023-02-06,-1144.5,-888.51
936,14103210,2023-02-08,116.37,-772.14
937,14103210,2023-02-09,-6.19,-778.33
938,14103210,2023-02-11,130.19,-648.14
939,14103210,2023-02-11,-151.17,-799.31
940,14103210,2023-02-13,1406.7,607.3900000000001
941,14136082,2023-01-31,,219.84
942,14136082,2023-02-01,82.18,302.02
943,14136082,2023-02-02,526.8,828.8199999999999
944,14136082,2023-02-03,89.93,918.75
945,14136082,2023-02-07,49.76,968.51
946,14136082,2023-02-09,125.63,1094.1399999999999
947,14136082,2023-02-11,-39.58,1054.56
948,14136082,2023-02-11,-169.33,885.2299999999999
949,14136082,2023-02-12,351.6,1236.83
950,14136082,2023-02-14,140.8,1377.6299999999999
951,14144267,2023-01-31,,97.69
952,14144267,2023-02-06,44.47,142.16
953,14144267,2023-02-08,114.12,256.28
954,14144267,2023-02-09,89.43,345.71000000000004
955,14183437,2023-01-31,,779.47
956,14183437,2023-02-02,30.01,809.48
957,14183437,2023-02-02,-95.08,714.4000000000001
958,14183437,2023-02-03,99.07,813.47
959,14183437,2023-02-10,1975.6,2789.0699999999997
960,14183437,2023-02-11,43.17,2832.24
961,14183437,2023-02-11,-90.85,2741.39
962,14183437,2023-02-14,120.06,2861.45
963,14253152,2023-01-31,,43.85
964,14253152,2023-02-03,81.28,125.13
965,14253152,2023-02-04,-111.13,14.0
966,14253152,2023-02-06,176.53,190.53
967,14253152,2023-02-08,215.14,405.66999999999996
968,14253152,2023-02-09,-157.13,248.54
969,14253152,2023-02-11,-130.43,118.10999999999999
970,14253152,2023-02-14,100.16,218.26999999999998
971,14253152,2023-02-14,-963.5,-745.23
972,14337606,2023-01-31,,561.8
973,14337606,2023-02-04,-53.8,507.99999999999994
974,14337606,2023-02-04,-79.62,428.37999999999994
975,14337606,2023-02-06,-1792.7,-1364.3200000000002
976,14337606,2023-02-08,-160.99,-1525.3100000000002
977,14337606,2023-02-09,-158.61,-1683.92
978,14337606,2023-02-11,175.69,-1508.2300000000002
979,14337606,2023-02-11,-170.72,-1678.9500000000003
980,14337606,2023-02-12,-132.03,-1810.9800000000002
981,14337606,2023-02-14,76.49,-1734.4900000000002
982,14355869,2023-01-31,,329.16
983,14355869,2023-02-01,-1052.6,-723.4399999999998
984,14355869,2023-02-03,123.39,-600.0499999999998
985,14355869,2023-02-04,-515.6,-1115.6499999999999
986,14355869,2023-02-12,-19.96,-1135.61
987,14397662,2023-01-31,,363.51
988,14397662,2023-02-04,61.88,425.39
989,14397662,2023-02-08,1800.8,2226.19
990,14397662,2023-02-08,126.11,2352.2999999999997
991,14397662,2023-02-08,54.11,2406.41
992,14397662,2023-02-08,37.69,2444.1
993,14397662,2023-02-11,-74.51,2369.5899999999997
994,14421453,2023-01-31,,813.76
995,14421453,2023-02-01,150.38,964.14
996,14421453,2023-02-04,44.06,1008.2
997,14421453,2023-02-04,-183.25,824.95
998,14421453,2023-02-06,67.0,891.95
999,14421453,2023-02-08,35.51,927.46
1000,14421453,2023-02-11,-102.02,825.44
1001,14448009,2023-01-31,,958.46
1002,14448009,2023-02-01,-102.39,856.07
1003,14448009,2023-02-01,-107.97,748.1
1004,14448009,2023-02-02,144.05,892.1500000000001
1005,14448009,2023-02-02,122.38,1014.53
1006,14448009,2023-02-04,-1367.4,-352.8700000000001
1007,14448009,2023-02-08,-1779.2,-2132.07
1008,14448009,2023-02-09,-139.36,-2271.4300000000003
1009,14448009,2023-02-09,-1300.7,-3572.13
1010,14448009,2023-02-14,78.98,-3493.15
1011,14448009,2023-02-14,-14.98,-3508.13
1012,14505806,2023-01-31,,689.25
1013,14505806,2023-02-01,974.4,1663.65
1014,14505806,2023-02-08,121.72,1785.37
1015,14505806,2023-02-09,-102.41,1682.96
1016,14505806,2023-02-11,130.43,1813.3899999999999
1017,14505806,2023-02-11,38.37,1851.76
1018,14505806,2023-02-13,-71.51,1780.25
1019,14505806,2023-02-14,956.2,2736.45
1020,14564252,2023-01-31,,263.39
1021,14564252,2023-02-02,-133.0,130.39
1022,14564252,2023-02-14,-158.38,-27.99000000000001
1023,14592080,2023-01-31,,245.22
1024,14592080,2023-02-02,149.36,394.58000000000004
1025,14592080,2023-02-02,-70.88,323.70000000000005
1026,14592080,2023-02-02,-113.73,209.97000000000003
1027,14592080,2023-02-04,-213.8,-3.829999999999984
1028,14592080,2023-02-05,99.57,95.74000000000001
1029,14592080,2023-02-06,-93.76,1.980000000000004
1030,14592080,2023-02-07,50.0,51.980000000000004
1031,14594928,2023-01-31,,470.64
1032,14594928,2023-02-03,-145.32,325.32
1033,14594928,2023-02-07,123.7,449.02
1034,14594928,2023-02-10,75.71,524.73
1035,14594928,2023-02-12,-140.65,384.08
1036,14600288,2023-01-31,,622.77
1037,14600288,2023-02-02,43.55,666.3199999999999
1038,14600288,2023-02-02,-140.31,526.01
1039,14600288,2023-02-02,-147.71,378.29999999999995
1040,14600288,2023-02-03,88.58,466.88
1041,14600288,2023-02-05,110.92,577.8
1042,14600288,2023-02-08,93.19,670.99
1043,14600288,2023-02-13,-138.07,532.92
1044,14600288,2023-02-14,83.11,616.03
1045,14648004,2023-01-31,,236.67
1046,14648004,2023-02-01,92.2,328.87
1047,14648004,2023-02-01,-77.41,251.45999999999998
1048,14648004,2023-02-04,100.53,351.99
1049,14648004,2023-02-04,72.87,424.86
1050,14648004,2023-02-05,-16.24,408.62
1051,14648004,2023-02-07,114.81,523.4300000000001
1052,14648004,2023-02-07,21.02,544.45
1053,14648004,2023-02-07,-111.26,433.19
1054,14648004,2023-02-08,-1330.7,-897.51
1055,14648004,2023-02-12,-1808.9,-2706.41
1056,14648004,2023-02-13,-113.24,-2819.65
1057,14685853,2023-01-31,,45.2
1058,14685853,2023-02-01,-142.37,-97.17
1059,14685853,2023-02-04,109.08,11.909999999999997
1060,14685853,2023-02-06,79.32,91.22999999999999
1061,14685853,2023-02-07,26.93,118.16
1062,14685853,2023-02-11,370.4,488.55999999999995
1063,14723713,2023-01-31,,378.07
1064,14723713,2023-02-10,67.56,445.63
1065,14723713,2023-02-10,-113.36,332.27
1066,14723713,2023-02-11,126.78,459.05
1067,14723713,2023-02-13,149.91,608.96
1068,14749214,2023-01-31,,194.54
1069,14749214,2023-02-03,49.32,243.85999999999999
1070,14749214,2023-02-07,-145.52,98.33999999999997
1071,14749214,2023-02-12,207.81,306.15
1072,14780986,2023-01-31,,180.2
1073,14780986,2023-02-01,105.85,286.04999999999995
1074,14780986,2023-02-04,164.38,450.42999999999995
1075,14780986,2023-02-06,-965.2,-514.7700000000001
1076,14780986,2023-02-07,132.81,-381.9600000000001
1077,14780986,2023-02-07,-168.78,-550.7400000000001
1078,14812157,2023-01-31,,534.54
1079,14812157,2023-02-01,645.5,1180.04
1080,14812157,2023-02-04,-134.48,1045.56
1081,14812157,2023-02-06,-473.7,571.86
1082,14812157,2023-02-09,-117.1,454.76
1083,14812157,2023-02-14,-120.54,334.22
1084,14840078,2023-01-31,,584.16
1085,14840078,2023-02-01,-118.24,465.91999999999996
1086,14840078,2023-02-05,62.37,528.29
1087,14840078,2023-02-06,-188.27,340.02
1088,14840078,2023-02-07,-87.19,252.82999999999996
1089,14840078,2023-02-09,-102.32,150.50999999999996
1090,14840078,2023-02-10,210.07,360.5799999999999
1091,14840078,2023-02-10,-144.1,216.47999999999996
1092,14840078,2023-02-13,-82.99,133.48999999999995
1093,14840078,2023-02-14,75.98,209.46999999999997
1094,14866733,2023-01-31,,249.35
1095,14866733,2023-02-01,-77.78,171.57
1096,14866733,2023-02-02,16.74,188.31
1097,14866733,2023-02-03,68.61,256.91999999999996
1098,14866733,2023-02-07,83.68,340.6
1099,14866733,2023-02-14,-38.4,302.2
1100,14866733,2023-02-14,-93.66,208.54
1101,14897645,2023-01-31,,89.0
1102,14897645,2023-02-01,113.69,202.69
1103,14897645,2023-02-09,-69.51,133.18
1104,14897645,2023-02-11,-51.73,81.44999999999999
1105,14897645,2023-02-12,106.92,188.37
1106,14897645,2023-02-14,143.79,332.15999999999997
1107,14907946,2023-01-31,,845.72
1108,14907946,2023-02-03,66.37,912.09
1109,14907946,2023-02-07,-84.76,827.33
1110,14907946,2023-02-07,-150.1,677.23
1111,14907946,2023-02-08,129.86,807.09
1112,14907946,2023-02-10,11.73,818.82
1113,14907946,2023-02-12,115.04,933.86
1114,14907946,2023-02-14,190.15,1124.01
1115,14907946,2023-02-14,98.03,1222.04
1116,14907946,2023-02-14,-67.7,1154.3400000000001
1117,14907946,2023-02-14,-161.34,993.0
1118,15033812,2023-01-31,,504.58
1119,15044055,2023-01-31,,204.3
1120,15044055,2023-02-04,93.78,298.08000000000004
1121,15044055,2023-02-06,-78.94,219.14000000000001
1122,15044055,2023-02-09,-1434.1,-1214.9599999999998
1123,15044055,2023-02-10,-181.71,-1396.6699999999998
1124,15044055,2023-02-14,161.91,-1234.7599999999998
1125,15044055,2023-02-14,52.78,-1181.9799999999998
1126,15052808,2023-01-31,,786.05
1127,15052808,2023-02-02,936.1,1722.15
1128,15052808,2023-02-09,953.9,2676.05
1129,15052808,2023-02-09,127.23,2803.2799999999997
1130,15052808,2023-02-14,-71.18,2732.1
1131,15052808,2023-02-14,-1288.0,1444.1
1132,15055504,2023-01-31,,339.94
1133,15055504,2023-02-05,-170.82,169.12
1134,15055504,2023-02-07,-106.77,62.35000000000001
1135,15055504,2023-02-08,22.97,85.32000000000001
1136,15055504,2023-02-11,-107.49,-22.169999999999987
1137,15055504,2023-02-11,-126.14,-148.31
1138,15077298,2023-01-31,,507.62
1139,15077298,2023-02-01,-77.55,430.07
1140,15077298,2023-02-01,-81.02,349.05
1141,15077298,2023-02-04,75.48,424.53000000000003
1142,15077298,2023-02-04,-150.76,273.77000000000004
1143,15077298,2023-02-07,-46.51,227.26000000000005
1144,15077298,2023-02-09,88.16,315.4200000000001
1145,15077298,2023-02-09,-56.29,259.13000000000005
1146,15077298,2023-02-11,124.08,383.21000000000004
1147,15100785,2023-01-31,,934.1
1148,15100785,2023-02-02,25.61,959.71
1149,15100785,2023-02-05,54.49,1014.2
1150,15100785,2023-02-06,-114.3,899.9000000000001
1151,15100785,2023-02-06,-149.07,750.83
1152,15100785,2023-02-07,166.29,917.12
1153,15100785,2023-02-09,1038.5,1955.62
1154,15100785,2023-02-11,-178.01,1777.61
1155,15100785,2023-02-12,128.81,1906.4199999999998
1156,15163829,2023-01-31,,458.6
1157,15163829,2023-02-04,120.19,578.79
1158,15163829,2023-02-07,-97.64,481.15000000000003
1159,15163829,2023-02-08,-141.03,340.12
1160,15163829,2023-02-12,-98.23,241.89
1161,15163829,2023-02-13,43.56,285.45
1162,15258886,2023-01-31,,689.34
1163,15258886,2023-02-01,-124.86,564.48
1164,15258886,2023-02-05,-155.76,408.72
1165,15258886,2023-02-08,-103.03,305.69000000000005
1166,15258886,2023-02-08,-134.18,171.51000000000002
1167,15258886,2023-02-10,47.01,218.52
1168,15258886,2023-02-11,1733.6,1952.12
1169,15258886,2023-02-12,-135.05,1817.07
1170,15258886,2023-02-13,-87.58,1729.4899999999998
1171,15265650,2023-01-31,,147.72
1172,15265650,2023-02-01,146.1,293.82
1173,15265650,2023-02-03,-81.73,212.08999999999997
1174,15265650,2023-02-04,-63.54,148.54999999999998
1175,15265650,2023-02-05,-98.03,50.51999999999998
1176,15265650,2023-02-08,-10.58,39.93999999999998
1177,15265650,2023-02-11,-100.86,-60.920000000000016
1178,15265650,2023-02-11,-105.66,-166.58
1179,15265650,2023-02-12,64.01,-102.57000000000001
1180,15265650,2023-02-13,-25.57,-128.14000000000001
1181,15265650,2023-02-14,-118.21,-246.35
1182,15265700,2023-01-31,,829.86
1183,15265700,2023-02-01,19.88,849.74
1184,15265700,2023-02-02,77.04,926.78
1185,15265700,2023-02-02,-83.44,843.34
1186,15265700,2023-02-08,-898.2,-54.860000000000014
1187,15265700,2023-02-12,91.07,36.20999999999998
1188,15290238,2023-01-31,,93.23
1189,15290238,2023-02-01,83.96,177.19
1190,15290238,2023-02-04,-59.13,118.06
1191,15290238,2023-02-09,-119.77,-1.710000000000008
1192,15290238,2023-02-13,-103.44,-105.15
1193,15296624,2023-01-31,,731.68
1194,15296624,2023-02-01,-58.05,673.63
1195,15296624,2023-02-01,-80.86,592.77
1196,15296624,2023-02-06,152.83,745.5999999999999
1197,15296624,2023-02-09,104.33,849.93
1198,15296624,2023-02-09,-141.82,708.1099999999999
1199,15296624,2023-02-14,120.42,828.53
1200,15324178,2023-01-31,,833.62
1201,15324178,2023-02-05,91.78,925.4
1202,15324178,2023-02-07,-82.91,842.49
1203,15324178,2023-02-08,157.76,1000.25
1204,15324178,2023-02-09,-898.1,102.14999999999998
1205,15324178,2023-02-13,-96.04,6.109999999999971
1206,15324178,2023-02-13,-134.6,-128.49
1207,15334737,2023-01-31,,197.12
1208,15334737,2023-02-01,115.14,312.26
1209,15334737,2023-02-01,102.21,414.47
1210,15334737,2023-02-04,91.69,506.15999999999997
1211,15334737,2023-02-04,-91.7,414.46
1212,15334737,2023-02-06,-176.53,237.93
1213,15334737,2023-02-07,63.12,301.05
1214,15334737,2023-02-12,86.27,387.32
1215,15377274,2023-01-31,,902.14
1216,15377274,2023-02-04,-124.14,778.0
1217,15377274,2023-02-07,150.1,928.0999999999999
1218,15377274,2023-02-07,-56.42,871.68
1219,15377274,2023-02-12,102.73,974.41
1220,15377274,2023-02-14,135.14,1109.55
1221,15428008,2023-01-31,,131.02
1222,15428008,2023-02-07,-199.86,-68.84
1223,15428008,2023-02-09,-548.3,-617.14
1224,15428008,2023-02-12,-1077.3,-1694.44
1225,15428008,2023-02-13,-47.89,-1742.33
1226,15428008,2023-02-14,-161.91,-1904.2399999999998
1227,15468532,2023-01-31,,819.87
1228,15468532,2023-02-03,-40.13,779.74
1229,15468532,2023-02-03,-141.04,638.7
1230,15468532,2023-02-09,132.75,771.45
1231,15522788,2023-01-31,,154.26
1232,15522788,2023-02-01,-101.62,52.639999999999986
1233,15522788,2023-02-02,117.73,170.37
1234,15522788,2023-02-04,109.65,280.02
1235,15522788,2023-02-04,81.01,361.03
1236,15522788,2023-02-05,-23.13,337.9
1237,15522788,2023-02-06,-99.27,238.63
1238,15522788,2023-02-08,66.05,304.68
1239,15529292,2023-01-31,,382.95
1240,15529292,2023-02-01,-117.6,265.35
1241,15529292,2023-02-06,76.0,341.35
1242,15529292,2023-02-12,154.74,496.09000000000003
1243,15563919,2023-01-31,,492.34
1244,15563919,2023-02-01,-90.71,401.63
1245,15563919,2023-02-02,46.46,448.09
1246,15563919,2023-02-04,174.55,622.64
1247,15563919,2023-02-05,65.68,688.3199999999999
1248,15563919,2023-02-06,178.82,867.14
1249,15563919,2023-02-10,36.91,904.05
1250,15563919,2023-02-14,1083.0,1987.05
1251,15665459,2023-01-31,,68.94
1252,15665459,2023-02-02,-74.71,-5.769999999999996
1253,15665459,2023-02-03,534.6,528.83
1254,15665459,2023-02-05,67.95,596.7800000000001
1255,15665459,2023-02-07,161.73,758.51
1256,15665459,2023-02-13,-66.23,692.2800000000001
1257,15668160,2023-01-31,,810.02
1258,15668160,2023-02-05,179.02,989.04
1259,15668160,2023-02-09,-156.67,832.37
1260,15668160,2023-02-13,201.95,1034.32
1261,15732629,2023-01-31,,975.81
1262,15732629,2023-02-02,191.44,1167.25
1263,15732629,2023-02-04,-362.7,804.55
1264,15732629,2023-02-05,78.82,883.3699999999999
1265,15732629,2023-02-08,144.78,1028.1499999999999
1266,15732629,2023-02-08,143.15,1171.3
1267,15732629,2023-02-12,76.86,1248.1599999999999
1268,15732629,2023-02-13,-1393.1,-144.94000000000005
1269,15768459,2023-01-31,,997.4
1270,15768459,2023-02-02,-154.06,843.3399999999999
1271,15768459,2023-02-03,-44.0,799.3399999999999
1272,15768459,2023-02-08,120.35,919.6899999999999
1273,15768459,2023-02-08,118.54,1038.23
1274,15768459,2023-02-13,139.76,1177.99
1275,15768459,2023-02-13,-131.61,1046.3799999999999
1276,15779976,2023-01-31,,129.01
1277,15779976,2023-02-03,-120.76,8.249999999999986
1278,15779976,2023-02-12,-127.27,-119.02000000000001
1279,15779976,2023-02-14,-100.83,-219.85000000000002
1280,15779976,2023-02-14,-128.39,-348.24
1281,15793232,2023-01-31,,45.88
1282,15793232,2023-02-02,-120.7,-74.82
1283,15793232,2023-02-05,1580.8,1505.98
1284,15793232,2023-02-12,57.42,1563.4
1285,15793232,2023-02-14,20.41,1583.81
1286,15796180,2023-01-31,,755.58
1287,15796180,2023-02-07,-105.97,649.61
1288,15796180,2023-02-07,-113.23,536.38
1289,15796180,2023-02-10,114.59,650.97
1290,15796180,2023-02-12,133.04,784.01
1291,15801209,2023-01-31,,8.84
1292,15801209,2023-02-01,-695.3,-686.4599999999999
1293,15801209,2023-02-05,-45.42,-731.8799999999999
1294,15801209,2023-02-08,126.03,-605.8499999999999
1295,15801209,2023-02-13,134.72,-471.12999999999994
1296,15801209,2023-02-13,46.32,-424.80999999999995
1297,15801209,2023-02-13,-80.6,-505.40999999999997
1298,15805500,2023-01-31,,230.39
1299,15805500,2023-02-02,170.79,401.17999999999995
1300,15805500,2023-02-06,-175.36,225.81999999999996
1301,15805500,2023-02-09,-71.12,154.69999999999996
1302,15810455,2023-01-31,,81.69
1303,15810455,2023-02-06,110.66,192.35
1304,15810455,2023-02-08,238.9,431.25
1305,15810455,2023-02-08,100.19,531.44
1306,15810455,2023-02-11,165.48,696.92
1307,15810455,2023-02-11,112.23,809.15
1308,15810455,2023-02-12,-145.1,664.05
1309,15810455,2023-02-13,80.87,744.9200000000001
1310,15826579,2023-01-31,,596.77
1311,15826579,2023-02-01,-948.2,-351.43000000000006
1312,15826579,2023-02-09,255.62,-95.81000000000006
1313,15826579,2023-02-10,-1662.6,-1758.4099999999999
1314,15826579,2023-02-11,1137.9,-620.5099999999998
1315,15826579,2023-02-13,128.09,-492.41999999999973
1316,15830962,2023-01-31,,570.89
1317,15830962,2023-02-03,50.42,621.31
1318,15830962,2023-02-07,65.97,687.28
1319,15830962,2023-02-10,-97.09,590.1899999999999
1320,15841031,2023-01-31,,579.98
1321,15841031,2023-02-05,-61.09,518.89
1322,15841031,2023-02-08,124.32,643.21
1323,15841031,2023-02-14,133.19,776.4
1324,15899774,2023-01-31,,773.38
1325,15899774,2023-02-06,151.33,924.71
1326,15899774,2023-02-08,1382.5,2307.21
1327,15899774,2023-02-09,-64.55,2242.66
1328,15914466,2023-01-31,,436.62
1329,15914466,2023-02-08,157.06,593.6800000000001
1330,15914466,2023-02-09,-109.67,484.01
1331,15914466,2023-02-09,-1208.0,-723.99
1332,15914466,2023-02-11,-125.01,-849.0
1333,15918861,2023-01-31,,781.97
1334,15918861,2023-02-03,122.97,904.94
1335,15918861,2023-02-04,-22.38,882.5600000000001
1336,15918861,2023-02-09,-103.16,779.4000000000001
1337,15918861,2023-02-14,125.82,905.22
1338,15922706,2023-01-31,,478.87
1339,15922706,2023-02-02,150.2,629.0699999999999
1340,15922706,2023-02-04,104.07,733.14
1341,15922706,2023-02-04,-44.55,688.59
1342,15922706,2023-02-06,77.22,765.81
1343,15922706,2023-02-06,64.62,830.43
1344,15922706,2023-02-06,-124.41,706.02
1345,15922706,2023-02-08,80.77,786.79
1346,15922706,2023-02-09,88.92,875.71
1347,15922706,2023-02-11,1370.2,2245.91
1348,15922706,2023-02-14,29.41,2275.32
1349,15944303,2023-01-31,,977.44
1350,15944303,2023-02-05,-108.31,869.1300000000001
1351,15944303,2023-02-06,-100.18,768.95
1352,15944303,2023-02-09,181.01,949.96
1353,15944303,2023-02-12,1267.9,2217.86
1354,15944303,2023-02-13,107.16,2325.02
1355,15960008,2023-01-31,,455.42
1356,15960008,2023-02-07,-132.81,322.61
1357,15960008,2023-02-10,-43.52,279.09000000000003
1358,15960008,2023-02-13,-47.03,232.06
1359,15980710,2023-01-31,,955.7
1360,15980710,2023-02-03,158.58,1114.28
1361,15980710,2023-02-04,97.86,1212.14
1362,15980710,2023-02-11,-58.0,1154.14
1363,15980710,2023-02-13,134.36,1288.5
1364,15980710,2023-02-14,79.89,1368.39
1365,16013218,2023-01-31,,322.63
1366,16013218,2023-02-02,83.89,406.52
1367,16013218,2023-02-06,1436.4,1842.92
1368,16013218,2023-02-06,-111.41,1731.51
1369,16013218,2023-02-10,26.43,1757.94
1370,16013218,2023-02-10,-77.1,1680.8400000000001
1371,16013218,2023-02-12,115.11,1795.95
1372,16013218,2023-02-12,-228.38,1567.5700000000002
1373,16026987,2023-01-31,,772.57
1374,16026987,2023-02-02,-96.85,675.72
1375,16026987,2023-02-03,56.34,732.0600000000001
1376,16026987,2023-02-07,101.07,833.1300000000001
1377,16026987,2023-02-08,95.14,928.2700000000001
1378,16026987,2023-02-13,1678.8,2607.07
1379,16030234,2023-01-31,,174.55
1380,16030234,2023-02-01,-92.81,81.74000000000001
1381,16030234,2023-02-01,-189.32,-107.57999999999998
1382,16030234,2023-02-06,-170.43,-278.01
1383,16030234,2023-02-08,129.99,-148.01999999999998
1384,16030234,2023-02-09,-97.62,-245.64
1385,16030234,2023-02-10,-86.54,-332.18
1386,16030234,2023-02-12,-80.58,-412.76
1387,16063411,2023-01-31,,896.73
1388,16063411,2023-02-13,-77.8,818.9300000000001
1389,16063411,2023-02-14,128.86,947.79
1390,16063411,2023-02-14,17.11,964.9
1391,16067516,2023-01-31,,494.33
1392,16067516,2023-02-06,-646.5,-152.17000000000002
1393,16067516,2023-02-08,-1044.7,-1196.8700000000001
1394,16067516,2023-02-12,168.73,-1028.14
1395,16087504,2023-01-31,,56.65
1396,16087504,2023-02-01,144.25,200.9
1397,16087504,2023-02-03,147.01,347.90999999999997
1398,16087504,2023-02-12,-895.2,-547.2900000000001
1399,16087504,2023-02-13,18.85,-528.44
1400,16087504,2023-02-14,-93.61,-622.0500000000001
1401,16093178,2023-01-31,,96.62
1402,16093178,2023-02-02,-136.28,-39.66
1403,16093178,2023-02-03,114.47,74.81
1404,16093178,2023-02-05,57.87,132.68
1405,16093178,2023-02-11,87.08,219.76
1406,16093178,2023-02-11,-159.21,60.54999999999998
1407,16093178,2023-02-13,-118.36,-57.81000000000002
1408,16118153,2023-01-31,,829.58
1409,16118153,2023-02-03,173.01,1002.59
1410,16118153,2023-02-05,-45.9,956.69
1411,16118153,2023-02-05,-49.78,906.9100000000001
1412,16118153,2023-02-09,125.98,1032.89
1413,16118153,2023-02-09,113.36,1146.25
1414,16118153,2023-02-10,-59.44,1086.81
1415,16118153,2023-02-13,1827.6,2914.41
1416,16124993,2023-01-31,,148.14
1417,16124993,2023-02-05,25.75,173.89
1418,16124993,2023-02-06,46.33,220.21999999999997
1419,16124993,2023-02-06,-97.34,122.87999999999998
1420,16124993,2023-02-08,1668.5,1791.3799999999999
1421,16124993,2023-02-08,-167.59,1623.79
1422,16124993,2023-02-11,245.04,1868.83
1423,16124993,2023-02-11,124.32,1993.1499999999999
1424,16124993,2023-02-12,-643.6,1349.5499999999997
1425,16124993,2023-02-14,-104.78,1244.7699999999998
1426,16124993,2023-02-14,-143.07,1101.6999999999998
1427,16152779,2023-01-31,,65.09
1428,16152779,2023-02-01,131.11,196.20000000000002
1429,16152779,2023-02-01,96.26,292.46000000000004
1430,16152779,2023-02-02,-135.95,156.51000000000005
1431,16152779,2023-02-04,173.9,330.4100000000001
1432,16152779,2023-02-12,-117.51,212.90000000000003
1433,16157014,2023-01-31,,858.73
1434,16157014,2023-02-01,99.09,957.82
1435,16157014,2023-02-03,-76.11,881.71
1436,16157014,2023-02-08,103.69,985.4
1437,16157014,2023-02-11,58.0,1043.4
1438,16157014,2023-02-13,-111.36,932.04
1439,16181964,2023-01-31,,979.44
1440,16181964,2023-02-01,-49.69,929.75
1441,16181964,2023-02-03,-121.15,808.6
1442,16181964,2023-02-06,59.73,868.33
1443,16181964,2023-02-07,-80.36,787.97
1444,16181964,2023-02-13,-763.2,24.769999999999982
1445,16191280,2023-01-31,,825.86
1446,16191280,2023-02-02,666.0,1491.8600000000001
1447,16191280,2023-02-03,21.47,1513.33
1448,16191280,2023-02-07,113.55,1626.88
1449,16191280,2023-02-08,138.88,1765.76
1450,16191280,2023-02-09,69.51,1835.27
1451,16191280,2023-02-10,-121.81,1713.46
1452,16191280,2023-02-12,86.65,1800.11
1453,16191280,2023-02-13,-77.77,1722.34
1454,16191280,2023-02-14,173.04,1895.38
1455,16223952,2023-01-31,,222.18
1456,16223952,2023-02-03,197.64,419.82
1457,16223952,2023-02-05,1174.8,1594.62
1458,16223952,2023-02-08,83.5,1678.12
1459,16223952,2023-02-09,168.19,1846.31
1460,16223952,2023-02-11,-94.59,1751.7199999999998
1461,16229373,2023-01-31,,256.89
1462,16229373,2023-02-01,-96.26,160.63
1463,16229373,2023-02-03,-1131.6,-970.9699999999999
1464,16229373,2023-02-05,161.01,-809.9599999999999
1465,16229373,2023-02-09,127.53,-682.43
1466,16229373,2023-02-13,83.84,-598.5899999999999
1467,16229373,2023-02-13,-153.16,-751.7499999999999
1468,16270746,2023-01-31,,904.31
1469,16270746,2023-02-01,49.84,954.15
1470,16270746,2023-02-07,227.16,1181.31
1471,16270746,2023-02-14,110.13,1291.44
1472,16306280,2023-01-31,,921.83
1473,16306280,2023-02-04,139.51,1061.3400000000001
1474,16306280,2023-02-06,136.49,1197.83
1475,16306280,2023-02-08,70.15,1267.98
1476,16306280,2023-02-13,79.84,1347.8200000000002
1477,16306280,2023-02-14,143.03,1490.8500000000001
1478,16312979,2023-01-31,,833.92
1479,16312979,2023-02-02,-57.84,776.0799999999999
1480,16312979,2023-02-05,47.51,823.5899999999999
1481,16312979,2023-02-06,155.04,978.6299999999999
1482,16312979,2023-02-07,-100.4,878.2299999999999
1483,16312979,2023-02-08,2113.3,2991.53
1484,16334793,2023-01-31,,297.75
1485,16334793,2023-02-02,-126.12,171.63
1486,16334793,2023-02-08,-77.8,93.83
1487,16334793,2023-02-09,-88.92,4.909999999999997
1488,16334793,2023-02-11,-1991.3,-1986.3899999999999
1489,16334793,2023-02-12,-81.87,-2068.2599999999998
1490,16453812,2023-01-31,,356.9
1491,16453812,2023-02-04,63.26,420.15999999999997
1492,16453812,2023-02-09,146.33,566.49
1493,16453812,2023-02-13,-159.89,406.6
1494,16453812,2023-02-14,-47.25,359.35
1495,16506904,2023-01-31,,602.17
1496,16506904,2023-02-01,-106.68,495.48999999999995
1497,16506904,2023-02-03,125.04,620.53
1498,16506904,2023-02-06,-22.66,597.87
1499,16506904,2023-02-07,-134.11,463.75999999999993
1500,16506904,2023-02-09,-164.72,299.03999999999996
1501,16506904,2023-02-12,77.47,376.50999999999993
1502,16506904,2023-02-13,-53.69,322.81999999999994
1503,16506904,2023-02-14,-278.4,44.41999999999996
1504,16584745,2023-01-31,,129.46
1505,16584745,2023-02-01,-136.51,-7.049999999999983
1506,16584745,2023-02-04,109.21,102.16000000000001
1507,16584745,2023-02-05,-62.34,39.82000000000001
1508,16584745,2023-02-06,-76.04,-36.22
1509,16584745,2023-02-09,-912.8,-949.02
1510,16584745,2023-02-10,55.02,-894.0
1511,16584745,2023-02-11,-184.5,-1078.5
1512,16584745,2023-02-12,170.0,-908.5
1513,16584745,2023-02-13,-111.37,-1019.87
1514,16628269,2023-01-31,,27.11
1515,16628269,2023-02-04,155.79,182.89999999999998
1516,16628269,2023-02-04,-53.03,129.87
1517,16628269,2023-02-05,88.27,218.14
1518,16628269,2023-02-05,55.52,273.66
1519,16628269,2023-02-11,-79.06,194.6
1520,16628269,2023-02-12,151.34,345.94
1521,16628269,2023-02-13,41.75,387.69
1522,16633794,2023-01-31,,263.05
1523,16633794,2023-02-02,75.84,338.89
1524,16633794,2023-02-08,113.42,452.31
1525,16633794,2023-02-09,89.39,541.7
1526,16633794,2023-02-10,86.39,628.09
1527,16633794,2023-02-13,61.69,689.78
1528,16676577,2023-01-31,,407.24
1529,16676577,2023-02-01,77.41,484.65
1530,16676577,2023-02-04,-77.7,406.95
1531,16676577,2023-02-06,-1436.4,-1029.45
1532,16676577,2023-02-09,-105.57,-1135.02
1533,16676577,2023-02-10,-103.59,-1238.6100000000001
1534,16927652,2023-01-31,,637.58
1535,16927652,2023-02-01,-14.22,623.36
1536,16927652,2023-02-04,153.96,777.32
1537,16927652,2023-02-05,122.62,899.94
1538,16977372,2023-01-31,,675.5
1539,16977372,2023-02-01,-181.11,494.39
1540,16977372,2023-02-08,195.9,690.29
1541,16977372,2023-02-10,-89.47,600.8199999999999
1542,16977372,2023-02-14,302.9,903.72
1543,16984772,2023-01-31,,823.43
1544,16984772,2023-02-02,1351.2,2174.63
1545,16984772,2023-02-05,-76.23,2098.4
1546,16984772,2023-02-05,-113.3,1985.1
1547,16984772,2023-02-05,-179.34,1805.7599999999998
1548,16984772,2023-02-07,151.91,1957.6699999999998
1549,16984772,2023-02-07,62.17,2019.84
1550,16984772,2023-02-07,-93.07,1926.77
1551,16984772,2023-02-08,-209.9,1716.87
1552,16984772,2023-02-10,-93.29,1623.58
1553,17024652,2023-01-31,,918.84
1554,17024652,2023-02-02,101.39,1020.23
1555,17024652,2023-02-07,11.35,1031.58
1556,17024652,2023-02-09,1558.7,2590.2799999999997
1557,17024652,2023-02-13,30.37,2620.65
1558,17039422,2023-01-31,,941.44
1559,17039422,2023-02-02,124.23,1065.67
1560,17039422,2023-02-03,-199.09,866.58
1561,17039422,2023-02-03,-208.56,658.02
1562,17039422,2023-02-06,-1053.5,-395.48
1563,17051223,2023-01-31,,558.16
1564,17051223,2023-02-08,125.79,683.9499999999999
1565,17051223,2023-02-08,-61.41,622.54
1566,17085651,2023-01-31,,945.51
1567,17085651,2023-02-05,119.48,1064.99
1568,17085651,2023-02-08,-81.34,983.65
1569,17085651,2023-02-11,-1168.2,-184.55000000000007
1570,17085651,2023-02-11,-1635.6,-1820.15
1571,17085651,2023-02-12,-159.82,-1979.97
1572,17085651,2023-02-14,-1583.4,-3563.37
1573,17138963,2023-01-31,,131.95
1574,17138963,2023-02-01,-1500.7,-1368.75
1575,17138963,2023-02-05,110.72,-1258.03
1576,17138963,2023-02-06,58.79,-1199.24
1577,17138963,2023-02-08,-35.48,-1234.72
1578,17138963,2023-02-14,63.85,-1170.87
1579,17144855,2023-01-31,,355.14
1580,17144855,2023-02-01,182.36,537.5
1581,17144855,2023-02-01,112.98,650.48
1582,17144855,2023-02-02,-51.28,599.2
1583,17144855,2023-02-02,-96.07,503.13
1584,17144855,2023-02-03,51.41,554.54
1585,17144855,2023-02-04,129.7,684.24
1586,17144855,2023-02-06,-104.58,579.66
1587,17144855,2023-02-09,-140.26,439.40000000000003
1588,17144855,2023-02-13,-59.04,380.36
1589,17144855,2023-02-13,-165.67,214.69000000000005
1590,17191420,2023-01-31,,717.28
1591,17191420,2023-02-01,130.78,848.06
1592,17191420,2023-02-02,-98.15,749.91
1593,17191420,2023-02-14,118.21,868.12
1594,17228160,2023-01-31,,567.87
1595,17228160,2023-02-01,-105.61,462.26
1596,17228160,2023-02-01,-780.9,-318.64
1597,17228160,2023-02-02,1556.9,1238.2600000000002
1598,17228160,2023-02-02,-54.57,1183.6900000000003
1599,17228160,2023-02-05,179.42,1363.1100000000001
1600,17228160,2023-02-05,123.79,1486.9000000000003
1601,17228160,2023-02-08,-35.2,1451.7000000000003
1602,17228160,2023-02-10,-190.65,1261.0500000000002
1603,17228160,2023-02-11,-200.58,1060.4700000000003
1604,17264146,2023-01-31,,345.33
1605,17264146,2023-02-07,171.45,516.78
1606,17264146,2023-02-10,-38.88,477.9
1607,17264146,2023-02-11,-151.65,326.25
1608,17264146,2023-02-12,-76.94,249.30999999999997
1609,17264146,2023-02-14,58.68,307.98999999999995
1610,17264146,2023-02-14,-163.39,144.6
1611,17284705,2023-01-31,,145.59
1612,17284705,2023-02-01,-81.56,64.03
1613,17284705,2023-02-03,-138.68,-74.65
1614,17284705,2023-02-04,-66.05,-140.7
1615,17284705,2023-02-10,-47.4,-188.1
1616,17284705,2023-02-11,157.96,-30.139999999999986
1617,17284705,2023-02-11,62.52,32.38000000000002
1618,17284705,2023-02-13,12.26,44.640000000000015
1619,17301178,2023-01-31,,311.47
1620,17301178,2023-02-02,-120.32,191.15000000000003
1621,17301178,2023-02-03,152.95,344.1
1622,17301178,2023-02-07,106.77,450.87
1623,17301178,2023-02-07,-1147.4,-696.5300000000001
1624,17301178,2023-02-08,55.71,-640.82
1625,17301178,2023-02-10,-24.85,-665.6700000000001
1626,17301178,2023-02-13,-127.43,-793.1000000000001
1627,17434670,2023-01-31,,148.92
1628,17434670,2023-02-04,-99.5,49.41999999999999
1629,17434670,2023-02-05,44.51,93.92999999999998
1630,17434670,2023-02-07,169.25,263.17999999999995
1631,17434670,2023-02-07,80.47,343.65
1632,17434670,2023-02-07,-48.65,295.0
1633,17434670,2023-02-10,-705.9,-410.9
1634,17434670,2023-02-10,-737.2,-1148.1
1635,17434670,2023-02-11,215.83,-932.27
1636,17434670,2023-02-12,139.56,-792.71
1637,17434670,2023-02-12,43.72,-748.99
1638,17434670,2023-02-14,106.21,-642.78
1639,17469776,2023-01-31,,443.18
1640,17469776,2023-02-05,89.23,532.41
1641,17469776,2023-02-05,-94.95,437.46000000000004
1642,17469776,2023-02-07,60.73,498.19
1643,17469776,2023-02-08,-61.39,436.8
1644,17469776,2023-02-12,76.6,513.4
1645,17483941,2023-01-31,,483.81
1646,17483941,2023-02-01,48.78,532.59
1647,17483941,2023-02-01,-110.45,422.14
1648,17483941,2023-02-01,-164.06,258.08
1649,17483941,2023-02-02,102.4,360.48
1650,17483941,2023-02-03,120.86,481.34
1651,17483941,2023-02-03,76.66,558.0
1652,17483941,2023-02-05,-161.01,396.99
1653,17483941,2023-02-08,145.66,542.65
1654,17483941,2023-02-11,9.21,551.86
1655,17533114,2023-01-31,,274.53
1656,17533114,2023-02-05,-94.53,179.99999999999997
1657,17533114,2023-02-07,-35.98,144.01999999999998
1658,17533114,2023-02-08,105.32,249.33999999999997
1659,17533114,2023-02-13,-123.27,126.06999999999998
1660,17533114,2023-02-14,-133.43,-7.360000000000028
1661,17534364,2023-01-31,,758.41
1662,17534364,2023-02-05,-120.48,637.93
1663,17534364,2023-02-08,42.56,680.49
1664,17534364,2023-02-10,-153.84,526.65
1665,17534364,2023-02-11,102.43,629.0799999999999
1666,17534364,2023-02-14,-59.8,569.28
1667,17543122,2023-01-31,,681.64
1668,17543122,2023-02-04,-48.4,633.24
1669,17543122,2023-02-05,-37.98,595.26
1670,17543122,2023-02-05,-135.04,460.22
1671,17543122,2023-02-05,-193.92,266.3
1672,17543122,2023-02-06,-19.45,246.85000000000002
1673,17543122,2023-02-08,118.77,365.62
1674,17543122,2023-02-10,-149.61,216.01
1675,17543122,2023-02-13,183.79,399.79999999999995
1676,17644586,2023-01-31,,222.45
1677,17644586,2023-02-01,92.85,315.29999999999995
1678,17644586,2023-02-01,-148.34,166.95999999999998
1679,17644586,2023-02-02,-122.21,44.749999999999986
1680,17644586,2023-02-03,146.39,191.14
1681,17644586,2023-02-04,109.76,300.9
1682,17644586,2023-02-09,50.02,350.92
1683,17644586,2023-02-11,125.33,476.25
1684,17644586,2023-02-13,110.34,586.59
1685,17648252,2023-01-31,,75.02
1686,17648252,2023-02-01,646.2,721.22
1687,17648252,2023-02-01,-570.3,150.92000000000007
1688,17648252,2023-02-05,124.83,275.75000000000006
1689,17648252,2023-02-05,-18.13,257.62000000000006
1690,17648252,2023-02-06,95.31,352.93000000000006
1691,17648252,2023-02-06,-84.46,268.4700000000001
1692,17648252,2023-02-13,132.3,400.7700000000001
1693,17648252,2023-02-14,553.6,954.3700000000001
1694,17669623,2023-01-31,,163.19
1695,17669623,2023-02-05,142.97,306.15999999999997
1696,17669623,2023-02-07,171.17,477.33
1697,17669623,2023-02-09,-125.94,351.39
1698,17669623,2023-02-14,106.34,457.73
1699,17669623,2023-02-14,-64.22,393.51
1700,17692892,2023-01-31,,457.79
1701,17692892,2023-02-03,22.26,480.05
1702,17692892,2023-02-03,-88.94,391.11
1703,17692892,2023-02-06,-45.55,345.56000000000006
1704,17692892,2023-02-09,174.92,520.48
1705,17722231,2023-01-31,,944.22
1706,17722231,2023-02-01,-67.01,877.21
1707,17722231,2023-02-02,22.39,899.6
1708,17722231,2023-02-06,-462.2,437.40000000000003
1709,17722231,2023-02-09,105.04,542.44
1710,17749893,2023-01-31,,889.45
1711,17749893,2023-02-01,176.41,1065.8600000000001
1712,17749893,2023-02-01,-143.83,922.03
1713,17749893,2023-02-07,-211.2,710.83
1714,17749893,2023-02-12,-28.42,682.4100000000001
1715,17749893,2023-02-12,-1267.9,-585.49
1716,17749893,2023-02-13,90.8,-494.69
1717,17749893,2023-02-13,-88.79,-583.48
1718,17810734,2023-01-31,,348.22
1719,17810734,2023-02-09,-138.8,209.42000000000002
1720,17840180,2023-01-31,,557.56
1721,17840180,2023-02-01,0.96,558.52
1722,17840180,2023-02-04,124.14,682.66
1723,17840180,2023-02-14,-81.15,601.51
1724,17868317,2023-01-31,,706.58
1725,17868317,2023-02-01,-172.78,533.8000000000001
1726,17868317,2023-02-07,-52.36,481.44000000000005
1727,17868317,2023-02-09,72.19,553.63
1728,17868317,2023-02-13,124.33,677.96
1729,17868317,2023-02-14,110.14,788.1
1730,17881363,2023-01-31,,415.27
1731,17881363,2023-02-02,-46.77,368.5
1732,17881363,2023-02-03,-64.03,304.46999999999997
1733,17881363,2023-02-04,22.38,326.84999999999997
1734,17881363,2023-02-05,125.17,452.02
1735,17881363,2023-02-13,-817.7,-365.68000000000006
1736,17925406,2023-01-31,,393.37
1737,17925406,2023-02-02,160.62,553.99
1738,17925406,2023-02-03,-51.41,502.58000000000004
1739,17925406,2023-02-06,109.52,612.1
1740,17925406,2023-02-06,-81.99,530.11
1741,17925406,2023-02-08,87.59,617.7
1742,17925406,2023-02-10,-74.72,542.98
1743,17925406,2023-02-13,112.38,655.36
1744,17925406,2023-02-14,116.9,772.26
1745,17933377,2023-01-31,,189.05
1746,17933377,2023-02-02,95.27,284.32
1747,17933377,2023-02-07,145.52,429.84000000000003
1748,17933377,2023-02-07,24.33,454.17
1749,17933377,2023-02-08,-109.29,344.88
1750,17938672,2023-01-31,,904.99
1751,17938672,2023-02-01,102.95,1007.94
1752,17938672,2023-02-02,-93.88,914.0600000000001
1753,17938672,2023-02-07,-46.29,867.77
1754,17938672,2023-02-08,39.85,907.62
1755,17938672,2023-02-11,129.67,1037.29
1756,17938672,2023-02-11,77.84,1115.13
1757,17939571,2023-01-31,,396.93
1758,17939571,2023-02-02,68.63,465.56
1759,17939571,2023-02-07,149.48,615.04
1760,17939571,2023-02-07,108.09,723.13
1761,17939571,2023-02-07,-53.14,669.99
1762,17939571,2023-02-09,-43.87,626.12
1763,17939571,2023-02-12,78.98,705.1
1764,17939571,2023-02-12,77.02,782.12
1765,17939571,2023-02-12,50.65,832.77
1766,17983851,2023-01-31,,849.24
1767,17983851,2023-02-01,160.4,1009.64
1768,17983851,2023-02-02,794.9,1804.54
1769,17983851,2023-02-02,200.43,2004.97
1770,17983851,2023-02-04,-26.48,1978.49
1771,17983851,2023-02-06,-154.69,1823.8
1772,17983851,2023-02-07,99.73,1923.53
1773,17983851,2023-02-09,-67.11,1856.42
1774,17983851,2023-02-12,89.62,1946.04
1775,17983851,2023-02-12,37.05,1983.09
1776,17983851,2023-02-12,-76.82,1906.27
1777,18046225,2023-01-31,,205.83
1778,18046225,2023-02-03,-96.51,109.32000000000001
1779,18046225,2023-02-07,151.4,260.72
1780,18046225,2023-02-10,63.32,324.04
1781,18052851,2023-01-31,,672.09
1782,18052851,2023-02-02,-177.51,494.58000000000004
1783,18052851,2023-02-08,-115.63,378.95000000000005
1784,18052851,2023-02-13,48.19,427.14000000000004
1785,18052851,2023-02-14,159.03,586.1700000000001
1786,18095448,2023-01-31,,73.28
1787,18095448,2023-02-03,159.69,232.97
1788,18095448,2023-02-03,-164.36,68.60999999999999
1789,18095448,2023-02-05,92.4,161.01
1790,18095448,2023-02-12,797.7,958.71
1791,18095448,2023-02-12,16.68,975.39
1792,18133554,2023-01-31,,733.1
1793,18133554,2023-02-02,-114.29,618.8100000000001
1794,18133554,2023-02-03,-168.82,449.99
1795,18133554,2023-02-06,676.7,1126.69
1796,18133554,2023-02-06,100.05,1226.74
1797,18133554,2023-02-07,1277.4,2504.1400000000003
1798,18133554,2023-02-07,207.86,2712.0
1799,18133554,2023-02-07,109.2,2821.2000000000003
1800,18133554,2023-02-09,176.85,2998.05
1801,18133554,2023-02-09,118.62,3116.67
1802,18133554,2023-02-10,-75.3,3041.3700000000003
1803,18133554,2023-02-11,1104.0,4145.37
1804,18133554,2023-02-11,107.81,4253.18
1805,18133554,2023-02-14,-18.54,4234.64
1806,18179400,2023-01-31,,768.78
1807,18179400,2023-02-03,18.62,787.4
1808,18179400,2023-02-06,-131.6,655.8
1809,18179400,2023-02-08,-197.96,457.84
1810,18179400,2023-02-11,560.2,1018.04
1811,18185362,2023-01-31,,609.36
1812,18185362,2023-02-02,-117.9,491.46000000000004
1813,18185362,2023-02-04,124.08,615.54
1814,18185362,2023-02-11,-10.99,604.55
1815,18185362,2023-02-12,-1955.6,-1351.05
1816,18185362,2023-02-14,91.78,-1259.27
1817,18198770,2023-01-31,,108.23
1818,18198770,2023-02-02,76.14,184.37
1819,18198770,2023-02-04,146.89,331.26
1820,18198770,2023-02-14,-44.96,286.3
1821,18305932,2023-01-31,,834.42
1822,18305932,2023-02-08,-129.7,704.72
1823,18305932,2023-02-11,-120.95,583.77
1824,18305932,2023-02-14,79.12,662.89
1825,18305932,2023-02-14,-18.23,644.66
1826,18308848,2023-01-31,,570.65
1827,18308848,2023-02-07,147.36,718.01
1828,18308848,2023-02-14,-27.68,690.33
1829,18346988,2023-01-31,,450.36
1830,18346988,2023-02-02,-131.15,319.21000000000004
1831,18346988,2023-02-03,-36.94,282.27
1832,18346988,2023-02-04,-436.5,-154.23000000000002
1833,18346988,2023-02-07,-856.5,-1010.73
1834,18346988,2023-02-14,-73.19,-1083.92
1835,18348734,2023-01-31,,579.93
1836,18348734,2023-02-01,-147.58,432.3499999999999
1837,18348734,2023-02-02,-950.2,-517.8500000000001
1838,18348734,2023-02-06,-111.94,-629.7900000000002
1839,18348734,2023-02-06,-152.83,-782.6200000000001
1840,18348734,2023-02-07,-211.77,-994.3900000000001
1841,18348734,2023-02-08,-56.83,-1051.2200000000003
1842,18348734,2023-02-08,-68.73,-1119.9500000000003
1843,18348734,2023-02-08,-1032.4,-2152.3500000000004
1844,18348734,2023-02-09,1045.1,-1107.2500000000005
1845,18348734,2023-02-09,-76.46,-1183.7100000000005
1846,18348734,2023-02-11,148.74,-1034.9700000000005
1847,18348734,2023-02-11,-1669.7,-2704.6700000000005
1848,18348734,2023-02-13,-98.15,-2802.8200000000006
1849,18348734,2023-02-14,2010.0,-792.8200000000006
1850,18447548,2023-01-31,,574.24
1851,18447548,2023-02-01,99.41,673.65
1852,18447548,2023-02-08,-180.39,493.26
1853,18447548,2023-02-10,133.0,626.26
1854,18447548,2023-02-10,-88.61,537.65
1855,18447548,2023-02-12,44.09,581.74
1856,18447548,2023-02-13,75.56,657.3000000000001
1857,18447548,2023-02-13,-104.27,553.03
1858,18447548,2023-02-13,-1370.8,-817.77
1859,18447548,2023-02-14,-101.91,-919.68
1860,18451683,2023-01-31,,501.75
1861,18451683,2023-02-03,157.43,659.1800000000001
1862,18451683,2023-02-03,102.01,761.19
1863,18451683,2023-02-05,112.34,873.53
1864,18451683,2023-02-05,-103.38,770.15
1865,18451683,2023-02-06,-56.08,714.07
1866,18451683,2023-02-06,-159.49,554.58
1867,18451683,2023-02-10,143.3,697.88
1868,18451683,2023-02-11,-65.22,632.6600000000001
1869,18451683,2023-02-12,-985.9,-353.24
1870,18451683,2023-02-13,62.08,-291.16
1871,18517970,2023-01-31,,709.95
1872,18517970,2023-02-02,142.95,852.9000000000001
1873,18517970,2023-02-03,-510.1,342.8
1874,18517970,2023-02-04,127.73,470.53000000000003
1875,18517970,2023-02-08,-31.2,439.33000000000004
1876,18517970,2023-02-09,54.57,493.90000000000003
1877,18517970,2023-02-10,95.98,589.88
1878,18517970,2023-02-12,-92.12,497.76
1879,18517970,2023-02-14,-91.78,405.98
1880,18563743,2023-01-31,,649.46
1881,18563743,2023-02-04,34.82,684.2800000000001
1882,18563743,2023-02-07,-124.7,559.58
1883,18563743,2023-02-09,-36.49,523.09
1884,18563743,2023-02-11,137.26,660.35
1885,18563743,2023-02-12,-58.63,601.72
1886,18563743,2023-02-12,-102.95,498.77
1887,18582171,2023-01-31,,732.99
1888,18582171,2023-02-03,-109.86,623.13
1889,18582171,2023-02-05,122.01,745.14
1890,18582171,2023-02-06,105.34,850.48
1891,18582171,2023-02-09,136.48,986.96
1892,18582171,2023-02-11,72.82,1059.78
1893,18582171,2023-02-11,-147.31,912.47
1894,18582171,2023-02-13,123.86,1036.33
1895,18582171,2023-02-14,45.9,1082.23
1896,18582171,2023-02-14,-85.38,996.85
1897,18584434,2023-01-31,,877.81
1898,18584434,2023-02-02,-103.88,773.93
1899,18584434,2023-02-03,-94.83,679.0999999999999
1900,18584434,2023-02-05,78.62,757.7199999999999
1901,18584434,2023-02-05,-122.62,635.0999999999999
1902,18584434,2023-02-08,-96.34,538.76
1903,18645136,2023-01-31,,554.87
1904,18645136,2023-02-01,120.09,674.96
1905,18645136,2023-02-03,111.0,785.96
1906,18645136,2023-02-04,199.43,985.39
1907,18645136,2023-02-05,-2.25,983.14
1908,18645136,2023-02-13,61.15,1044.29
1909,18645136,2023-02-14,-116.52,927.77
1910,18685463,2023-01-31,,476.02
1911,18685463,2023-02-09,-37.65,438.37
1912,18685463,2023-02-10,73.39,511.76
1913,18685463,2023-02-14,118.69,630.45
1914,18685463,2023-02-14,80.0,710.45
1915,18718399,2023-01-31,,716.22
1916,18718399,2023-02-04,119.96,836.1800000000001
1917,18718399,2023-02-06,374.5,1210.68
1918,18718399,2023-02-10,1800.7,3011.38
1919,18850031,2023-01-31,,191.3
1920,18850031,2023-02-03,100.99,292.29
1921,18850031,2023-02-05,181.42,473.71
1922,18850031,2023-02-05,120.48,594.1899999999999
1923,18850031,2023-02-07,-171.4,422.78999999999996
1924,18850031,2023-02-11,172.5,595.29
1925,18850031,2023-02-11,-34.52,560.77
1926,18850031,2023-02-13,105.74,666.51
1927,18859451,2023-01-31,,441.04
1928,18859451,2023-02-02,-469.3,-28.25999999999999
1929,18859451,2023-02-06,110.47,82.21000000000001
1930,18859451,2023-02-06,-102.2,-19.989999999999995
1931,18859451,2023-02-13,46.16,26.17
1932,18859451,2023-02-14,92.17,118.34
1933,18899132,2023-01-31,,244.46
1934,18899132,2023-02-05,-69.58,174.88
1935,18899132,2023-02-06,97.34,272.22
1936,18899132,2023-02-08,-63.18,209.04000000000002
1937,18928638,2023-01-31,,150.95
1938,18928638,2023-02-02,-162.41,-11.460000000000008
1939,18928638,2023-02-02,-192.77,-204.23000000000002
1940,18928638,2023-02-10,-184.75,-388.98
1941,19001745,2023-01-31,,507.55
1942,19001745,2023-02-03,76.42,583.97
1943,19001745,2023-02-04,55.54,639.51
1944,19001745,2023-02-10,344.3,983.81
1945,19001745,2023-02-10,99.66,1083.47
1946,19001745,2023-02-11,-173.15,910.3199999999999
1947,19001745,2023-02-13,-82.89,827.43
1948,19001745,2023-02-14,102.06,929.49
1949,19001745,2023-02-14,-181.24,748.25
1950,19094015,2023-01-31,,548.65
1951,19094015,2023-02-01,74.43,623.0799999999999
1952,19094015,2023-02-02,-224.1,398.98
1953,19094015,2023-02-06,-186.65,212.32999999999998
1954,19094015,2023-02-06,-1695.0,-1482.67
1955,19094015,2023-02-12,1761.1,278.42999999999984
1956,19094015,2023-02-13,-767.3,-488.8700000000001
1957,19154395,2023-01-31,,274.06
1958,19154395,2023-02-01,456.2,730.26
1959,19154395,2023-02-01,173.96,904.22
1960,19154395,2023-02-05,185.3,1089.52
1961,19154395,2023-02-05,-25.75,1063.77
1962,19154395,2023-02-06,-23.13,1040.64
1963,19160862,2023-01-31,,211.53
1964,19160862,2023-02-02,-110.38,101.15
1965,19160862,2023-02-11,-137.25,-36.099999999999994
1966,19201987,2023-01-31,,624.55
1967,19201987,2023-02-04,-54.37,570.18
1968,19201987,2023-02-04,-107.38,462.79999999999995
1969,19201987,2023-02-06,-140.78,322.02
1970,19201987,2023-02-09,80.63,402.65
1971,19201987,2023-02-11,-62.24,340.40999999999997
1972,19216744,2023-01-31,,123.53
1973,19216744,2023-02-03,79.86,203.39
1974,19220216,2023-01-31,,628.89
1975,19220216,2023-02-04,50.19,679.0799999999999
1976,19220216,2023-02-04,-148.35,530.73
1977,19220216,2023-02-05,108.31,639.04
1978,19220216,2023-02-05,-71.33,567.71
1979,19220216,2023-02-06,833.9,1401.6100000000001
1980,19220216,2023-02-06,-162.13,1239.48
1981,19220216,2023-02-11,-102.26,1137.22
1982,19220216,2023-02-12,51.02,1188.24
1983,19220216,2023-02-13,187.8,1376.04
1984,19220216,2023-02-14,-190.15,1185.89
1985,19242274,2023-01-31,,65.28
1986,19242274,2023-02-01,116.71,181.99
1987,19242274,2023-02-01,-107.29,74.69999999999999
1988,19242274,2023-02-08,-94.16,-19.460000000000008
1989,19242274,2023-02-09,-32.83,-52.290000000000006
1990,19242274,2023-02-10,1324.9,1272.6100000000001
1991,19242274,2023-02-10,-98.85,1173.7600000000002
1992,19283264,2023-01-31,,301.31
1993,19283264,2023-02-07,-85.44,215.87
1994,19283264,2023-02-07,-126.94,88.93
1995,19283264,2023-02-10,103.62,192.55
1996,19283264,2023-02-10,-96.34,96.21000000000001
1997,19283264,2023-02-12,39.42,135.63
1998,19315124,2023-01-31,,447.16
1999,19315124,2023-02-11,64.7,511.86
2000,19315124,2023-02-11,-93.58,418.28000000000003
2001,19315124,2023-02-14,634.0,1052.28
2002,19315124,2023-02-14,-90.11,962.17
2003,19317267,2023-01-31,,51.87
2004,19317267,2023-02-03,-113.25,-61.38
2005,19317267,2023-02-14,1191.7,1130.32
2006,19317267,2023-02-14,33.66,1163.98
2007,19317267,2023-02-14,-198.2,965.78
2008,19334563,2023-01-31,,525.45
2009,19334563,2023-02-01,-774.6,-249.14999999999998
2010,19334563,2023-02-08,130.38,-118.76999999999998
2011,19334563,2023-02-12,41.59,-77.17999999999998
2012,19334563,2023-02-13,-107.17,-184.34999999999997
2013,19334563,2023-02-14,1773.6,1589.25
2014,19387921,2023-01-31,,927.28
2015,19387921,2023-02-01,-86.97,840.31
2016,19387921,2023-02-02,124.34,964.65
2017,19387921,2023-02-06,144.74,1109.3899999999999
2018,19387921,2023-02-11,-58.94,1050.45
2019,19387921,2023-02-14,162.9,1213.35
2020,19387921,2023-02-14,70.52,1283.87
2021,19387921,2023-02-14,-125.82,1158.05
2022,19429964,2023-01-31,,694.43
2023,19429964,2023-02-04,220.77,915.1999999999999
2024,19429964,2023-02-05,200.2,1115.3999999999999
2025,19429964,2023-02-08,-58.6,1056.8
2026,19429964,2023-02-13,202.54,1259.34
2027,19429964,2023-02-14,97.35,1356.69
2028,19432211,2023-01-31,,24.19
2029,19432211,2023-02-02,114.87,139.06
2030,19432211,2023-02-02,-124.78,14.280000000000001
2031,19432211,2023-02-07,-107.2,-92.92
2032,19432211,2023-02-08,76.6,-16.320000000000007
2033,19524427,2023-01-31,,579.16
2034,19524427,2023-02-03,-772.8,-193.64
2035,19524427,2023-02-06,151.44,-42.19999999999999
2036,19524427,2023-02-09,287.8,245.60000000000002
2037,19524427,2023-02-13,148.89,394.49
2038,19530097,2023-01-31,,960.21
2039,19530097,2023-02-05,44.78,1004.99
2040,19530097,2023-02-06,105.81,1110.8
2041,19530097,2023-02-10,79.86,1190.66
2042,19530097,2023-02-10,-100.23,1090.43
2043,19530097,2023-02-13,151.84,1242.27
2044,19559937,2023-01-31,,727.4
2045,19559937,2023-02-01,1500.7,2228.1
2046,19559937,2023-02-01,-86.72,2141.38
2047,19559937,2023-02-05,-114.03,2027.3500000000001
2048,19559937,2023-02-09,-50.41,1976.94
2049,19559937,2023-02-10,64.28,2041.2200000000003
2050,19559937,2023-02-10,-88.53,1952.69
2051,19559937,2023-02-11,-157.4,1795.2900000000002
2052,19559937,2023-02-12,1025.1,2820.3900000000003
2053,19574610,2023-01-31,,104.29
2054,19574610,2023-02-02,91.54,195.83
2055,19574610,2023-02-04,186.59,382.42
2056,19574610,2023-02-04,-133.61,248.81
2057,19574610,2023-02-05,815.7,1064.51
2058,19574610,2023-02-07,-186.15,878.36
2059,19574610,2023-02-10,-28.58,849.78
2060,19574610,2023-02-11,-182.68,667.0999999999999
2061,19574610,2023-02-13,68.69,735.79
2062,19574610,2023-02-13,-62.72,673.0699999999999
2063,19574610,2023-02-14,-77.33,595.74
2064,19647966,2023-01-31,,849.89
2065,19647966,2023-02-05,176.88,1026.77
2066,19647966,2023-02-08,128.8,1155.57
2067,19647966,2023-02-10,106.72,1262.29
2068,19647966,2023-02-12,164.29,1426.58
2069,19647966,2023-02-14,83.33,1509.91
2070,19647966,2023-02-14,-94.55,1415.36
2071,19686460,2023-01-31,,416.7
2072,19686460,2023-02-01,818.4,1235.1
2073,19686460,2023-02-07,115.39,1350.49
2074,19686460,2023-02-08,1379.8,2730.29
2075,19686460,2023-02-11,754.3,3484.59
2076,19686460,2023-02-14,-72.93,3411.66
2077,19705767,2023-01-31,,997.48
2078,19705767,2023-02-04,-134.22,863.26
2079,19705767,2023-02-08,-136.38,726.88
2080,19705767,2023-02-10,101.58,828.46
2081,19705767,2023-02-11,132.19,960.6500000000001
2082,19705767,2023-02-13,46.08,1006.73
2083,19705767,2023-02-14,-7.09,999.64
2084,19789505,2023-01-31,,893.9
2085,19789505,2023-02-01,1041.9,1935.8000000000002
2086,19789505,2023-02-04,44.55,1980.3500000000001
2087,19789505,2023-02-08,118.76,2099.11
2088,19789505,2023-02-08,-14.65,2084.46
2089,19789505,2023-02-10,40.02,2124.48
2090,19789505,2023-02-11,117.67,2242.15
2091,19789505,2023-02-13,-1665.4,576.75
2092,19836996,2023-01-31,,245.14
2093,19836996,2023-02-02,114.29,359.43
2094,19836996,2023-02-04,165.75,525.1800000000001
2095,19836996,2023-02-06,-104.32,420.86
2096,19836996,2023-02-07,-65.16,355.70000000000005
2097,19836996,2023-02-07,-1159.5,-803.8
2098,19876635,2023-01-31,,883.25
2099,19876635,2023-02-01,-81.16,802.09
2100,19876635,2023-02-01,-101.28,700.81
2101,19876635,2023-02-02,-236.79,464.02
2102,19876635,2023-02-03,128.62,592.64
2103,19876635,2023-02-03,-135.59,457.05
2104,19876635,2023-02-10,-128.06,328.99
2105,19876635,2023-02-11,147.81,476.8
2106,19876635,2023-02-14,-135.7,341.1
2107,19920990,2023-01-31,,70.95
2108,19920990,2023-02-03,-145.14,-74.18999999999998
2109,19920990,2023-02-07,-1370.6,-1444.79
2110,19920990,2023-02-08,-90.7,-1535.49
2111,19920990,2023-02-09,53.56,-1481.93
2112,19920990,2023-02-13,871.5,-610.43
2113,19920990,2023-02-14,38.18,-572.25
2114,19931073,2023-01-31,,404.96
2115,19931073,2023-02-13,40.02,444.97999999999996
2116,19956941,2023-01-31,,723.33
2117,19956941,2023-02-03,1121.6,1844.9299999999998
2118,19956941,2023-02-05,-173.68,1671.2499999999998
2119,19956941,2023-02-08,1010.6,2681.85
2120,19956941,2023-02-08,-133.65,2548.2
2121,19956941,2023-02-09,-69.39,2478.81
2122,19956941,2023-02-14,-69.01,2409.7999999999997
2123,19980716,2023-01-31,,432.98
2124,19980716,2023-02-02,1774.7,2207.6800000000003
2125,19980716,2023-02-02,-114.87,2092.81
2126,19980716,2023-02-03,-159.69,1933.1200000000001
2127,19980716,2023-02-07,20.07,1953.19
2128,19980716,2023-02-09,125.68,2078.87
2129,19980716,2023-02-09,114.01,2192.88
2130,19980716,2023-02-10,-682.2,1510.68
2131,19980716,2023-02-11,75.65,1586.3300000000002
2132,20015298,2023-01-31,,953.82
2133,20015298,2023-02-01,158.51,1112.33
2134,20015298,2023-02-08,42.88,1155.21
2135,20015298,2023-02-08,-128.42,1026.79
2136,20015298,2023-02-11,-590.6,436.19000000000005
2137,20015298,2023-02-13,-50.67,385.52000000000004
2138,20067958,2023-01-31,,38.05
2139,20067958,2023-02-07,122.02,160.07
2140,20067958,2023-02-07,85.23,245.3
2141,20067958,2023-02-08,974.3,1219.6
2142,20067958,2023-02-11,102.26,1321.86
2143,20067958,2023-02-12,94.36,1416.2199999999998
2144,20090784,2023-01-31,,482.62
2145,20090784,2023-02-03,12.53,495.15
2146,20090784,2023-02-04,1263.9,1759.0500000000002
2147,20090784,2023-02-09,85.8,1844.8500000000001
2148,20090784,2023-02-10,-8.29,1836.5600000000002
2149,20090784,2023-02-13,710.9,2547.46
2150,20117480,2023-01-31,,70.97
2151,20117480,2023-02-01,-86.68,-15.710000000000008
2152,20117480,2023-02-06,186.65,170.94
2153,20117480,2023-02-07,188.36,359.3
2154,20117480,2023-02-08,-154.2,205.10000000000002
2155,20117480,2023-02-11,75.16,280.26
2156,20129535,2023-01-31,,446.41
2157,20129535,2023-02-01,143.85,590.26
2158,20129535,2023-02-05,172.62,762.88
2159,20129535,2023-02-06,45.01,807.89
2160,20129535,2023-02-07,6.03,813.9200000000001
2161,20129535,2023-02-10,-99.74,714.1800000000001
2162,20129535,2023-02-11,-30.14,684.04
2163,20129535,2023-02-13,113.24,797.28
2164,20176338,2023-01-31,,289.57
2165,20176338,2023-02-01,-100.02,189.55
2166,20176338,2023-02-04,-186.95,2.6000000000000227
2167,20176338,2023-02-05,108.33,110.93000000000002
2168,20176338,2023-02-05,62.88,173.81000000000003
2169,20176338,2023-02-08,96.42,270.23
2170,20176338,2023-02-09,188.14,458.37
2171,20176338,2023-02-10,-121.7,336.67
2172,20242626,2023-01-31,,701.08
2173,20242626,2023-02-03,85.48,786.5600000000001
2174,20242626,2023-02-09,82.05,868.61
2175,20248053,2023-01-31,,565.28
2176,20248053,2023-02-02,-77.43,487.84999999999997
2177,20248053,2023-02-03,127.48,615.3299999999999
2178,20248053,2023-02-04,110.05,725.38
2179,20248053,2023-02-11,-179.27,546.1099999999999
2180,20248053,2023-02-14,-114.98,431.12999999999994
2181,20263437,2023-01-31,,789.09
2182,20263437,2023-02-04,141.31,930.4000000000001
2183,20263437,2023-02-05,-41.33,889.07
2184,20263437,2023-02-05,-99.42,789.6500000000001
2185,20263437,2023-02-08,107.41,897.0600000000001
2186,20263437,2023-02-12,48.67,945.73
2187,20280759,2023-01-31,,838.7
2188,20280759,2023-02-03,-66.37,772.33
2189,20280759,2023-02-04,-110.37,661.96
2190,20280759,2023-02-12,118.8,780.76
2191,20280759,2023-02-12,-66.4,714.36
2192,20280759,2023-02-12,-110.26,604.1
2193,20280759,2023-02-13,110.74,714.84
2194,20287993,2023-01-31,,616.17
2195,20287993,2023-02-03,125.34,741.51
2196,20287993,2023-02-04,614.0,1355.51
2197,20287993,2023-02-06,876.5,2232.01
2198,20287993,2023-02-07,-756.5,1475.51
2199,20287993,2023-02-09,81.5,1557.01
2200,20287993,2023-02-13,203.37,1760.38
2201,20287993,2023-02-13,-91.78,1668.6
2202,20316429,2023-01-31,,697.84
2203,20316429,2023-02-02,-94.92,602.9200000000001
2204,20316429,2023-02-09,-166.7,436.22
2205,20345467,2023-01-31,,852.5
2206,20345467,2023-02-01,-72.35,780.15
2207,20345467,2023-02-02,-100.36,679.79
2208,20345467,2023-02-05,115.08,794.87
2209,20345467,2023-02-08,154.63,949.5
2210,20345467,2023-02-09,-154.98,794.52
2211,20345467,2023-02-14,102.53,897.05
2212,20369153,2023-01-31,,293.78
2213,20369153,2023-02-01,387.9,681.68
2214,20369153,2023-02-03,142.86,824.54
2215,20369153,2023-02-04,-111.47,713.0699999999999
2216,20369153,2023-02-05,-144.17,568.9
2217,20369153,2023-02-07,605.2,1174.1
2218,20369153,2023-02-07,-979.3,194.80000000000007
2219,20369153,2023-02-11,-59.3,135.50000000000006
2220,20369153,2023-02-11,-132.19,3.310000000000059
2221,20369153,2023-02-11,-146.56,-143.24999999999994
2222,20372310,2023-01-31,,366.41
2223,20372310,2023-02-02,-123.8,242.61
2224,20372310,2023-02-05,142.33,384.94000000000005
2225,20372310,2023-02-05,-104.74,280.20000000000005
2226,20372310,2023-02-10,-26.87,253.33000000000007
2227,20372310,2023-02-10,-74.87,178.46000000000004
2228,20372310,2023-02-10,-144.36,34.10000000000002
2229,20372310,2023-02-11,123.03,157.13000000000002
2230,20372310,2023-02-11,-1293.9,-1136.77
2231,20413037,2023-01-31,,235.79
2232,20413037,2023-02-02,98.09,333.88
2233,20413037,2023-02-02,-93.56,240.32
2234,20413037,2023-02-02,-119.55,120.77
2235,20413037,2023-02-07,65.9,186.67000000000002
2236,20413037,2023-02-11,121.47,308.14
2237,20413037,2023-02-11,-48.78,259.36
2238,20413037,2023-02-14,-56.12,203.24
2239,20425065,2023-01-31,,866.77
2240,20425065,2023-02-02,-62.78,803.99
2241,20425065,2023-02-04,-165.75,638.24
2242,20425065,2023-02-14,-2134.6,-1496.36
2243,20464830,2023-01-31,,181.25
2244,20464830,2023-02-03,-166.13,15.120000000000005
2245,20464830,2023-02-04,121.04,136.16000000000003
2246,20464830,2023-02-08,159.45,295.61
2247,20632572,2023-01-31,,286.44
2248,20632572,2023-02-02,-20.11,266.33
2249,20632572,2023-02-06,16.08,282.40999999999997
2250,20632572,2023-02-12,175.32,457.73
2251,20704613,2023-01-31,,71.59
2252,20704613,2023-02-01,97.11,168.7
2253,20704613,2023-02-06,-11.61,157.09
2254,20704613,2023-02-07,93.91,251.0
2255,20704613,2023-02-08,30.57,281.57
2256,20704613,2023-02-09,130.36,411.93
2257,20704613,2023-02-10,-200.96,210.97
2258,20704613,2023-02-11,20.99,231.96
2259,20704613,2023-02-13,-154.81,77.15
2260,20705548,2023-01-31,,184.81
2261,20705548,2023-02-02,2269.2,2454.0099999999998
2262,20705548,2023-02-03,208.56,2662.5699999999997
2263,20705548,2023-02-04,-125.11,2537.4599999999996
2264,20705548,2023-02-14,67.36,2604.8199999999997
2265,20705548,2023-02-14,46.61,2651.43
2266,20705548,2023-02-14,-30.74,2620.6899999999996
2267,20720894,2023-01-31,,243.42
2268,20720894,2023-02-06,462.2,705.62
2269,20720894,2023-02-06,179.82,885.4399999999999
2270,20720894,2023-02-11,-107.81,777.6299999999999
2271,20838578,2023-01-31,,620.7
2272,20838578,2023-02-09,-55.87,564.83
2273,20838578,2023-02-10,-96.87,467.96000000000004
2274,20838578,2023-02-12,56.96,524.9200000000001
2275,20849721,2023-01-31,,740.52
2276,20849721,2023-02-06,70.55,811.0699999999999
2277,20849721,2023-02-06,19.45,830.52
2278,20849721,2023-02-07,197.62,1028.1399999999999
2279,20849721,2023-02-08,-71.98,956.16
2280,20849721,2023-02-13,117.42,1073.58
2281,20851460,2023-01-31,,931.67
2282,20851460,2023-02-03,124.8,1056.47
2283,20851460,2023-02-10,-147.03,909.4399999999999
2284,20878023,2023-01-31,,648.19
2285,20878023,2023-02-04,-149.2,498.99000000000007
2286,20878023,2023-02-06,-103.53,395.46000000000004
2287,20878023,2023-02-06,-125.2,270.26000000000005
2288,20878023,2023-02-08,124.5,394.76000000000005
2289,20878023,2023-02-08,-107.64,287.12000000000006
2290,20878023,2023-02-10,-63.58,223.54000000000008
2291,20878023,2023-02-13,-26.71,196.83000000000007
2292,20908067,2023-01-31,,607.53
2293,20908067,2023-02-05,179.9,787.43
2294,20908067,2023-02-06,-202.05,585.38
2295,20908067,2023-02-11,-119.75,465.63
2296,20908067,2023-02-14,-2138.0,-1672.37
2297,20991411,2023-01-31,,572.64
2298,20991411,2023-02-06,-111.33,461.31
2299,20991411,2023-02-09,41.77,503.08
2300,20991411,2023-02-10,-114.86,388.22
2301,20992354,2023-01-31,,87.26
2302,20992354,2023-02-01,-82.18,5.079999999999998
2303,20992354,2023-02-03,-5.14,-0.060000000000001386
2304,20992354,2023-02-04,129.11,129.05
2305,20992354,2023-02-08,-191.5,-62.44999999999999
2306,20992354,2023-02-09,-35.39,-97.83999999999999
2307,20992354,2023-02-12,52.16,-45.67999999999999
2308,20992354,2023-02-13,157.55,111.87000000000002
2309,20992354,2023-02-13,-99.13,12.740000000000023
2310,21001872,2023-01-31,,31.76
2311,21001872,2023-02-09,12.23,43.99
2312,21001872,2023-02-10,-106.72,-62.73
2313,21001872,2023-02-12,-98.65,-161.38
2314,21001872,2023-02-14,101.69,-59.69
2315,21032760,2023-01-31,,541.33
2316,21032760,2023-02-01,-637.1,-95.76999999999998
2317,21032760,2023-02-03,94.5,-1.2699999999999818
2318,21032760,2023-02-03,-51.58,-52.84999999999998
2319,21032760,2023-02-04,127.8,74.95000000000002
2320,21032760,2023-02-09,78.9,153.85000000000002
2321,21032760,2023-02-09,-993.4,-839.55
2322,21032760,2023-02-10,-932.3,-1771.85
2323,21032760,2023-02-11,33.32,-1738.53
2324,21032760,2023-02-11,-1161.1,-2899.63
2325,21032760,2023-02-13,161.21,-2738.42
2326,21047777,2023-01-31,,699.12
2327,21047777,2023-02-03,40.55,739.67
2328,21047777,2023-02-04,31.07,770.74
2329,21047777,2023-02-05,-128.94,641.8
2330,21047777,2023-02-06,92.39,734.19
2331,21047777,2023-02-07,137.57,871.76
2332,21047777,2023-02-08,163.05,1034.81
2333,21047777,2023-02-08,-14.52,1020.29
2334,21047777,2023-02-12,-90.28,930.01
2335,21142911,2023-01-31,,714.89
2336,21142911,2023-02-01,-103.99,610.9
2337,21142911,2023-02-02,-156.5,454.4
2338,21142911,2023-02-06,80.92,535.3199999999999
2339,21142911,2023-02-10,160.6,695.92
2340,21142911,2023-02-10,-52.02,643.9
2341,21142911,2023-02-10,-86.61,557.29
2342,21293955,2023-01-31,,232.88
2343,21293955,2023-02-05,1110.7,1343.58
2344,21293955,2023-02-08,85.9,1429.4800000000002
2345,21293955,2023-02-10,624.8,2054.28
2346,21314767,2023-01-31,,438.19
2347,21314767,2023-02-01,-33.36,404.83
2348,21314767,2023-02-01,-130.93,273.9
2349,21314767,2023-02-07,-143.04,130.85999999999999
2350,21314767,2023-02-11,-134.72,-3.8600000000000136
2351,21314767,2023-02-12,-103.79,-107.65000000000002
2352,21314767,2023-02-12,-1486.8,-1594.45
2353,21368735,2023-01-31,,281.87
2354,21368735,2023-02-01,-145.77,136.1
2355,21368735,2023-02-02,-786.6,-650.5
2356,21368735,2023-02-03,40.33,-610.17
2357,21368735,2023-02-04,-73.7,-683.87
2358,21368735,2023-02-05,-49.85,-733.72
2359,21368735,2023-02-06,63.43,-670.29
2360,21368735,2023-02-13,118.83,-551.46
2361,21392412,2023-01-31,,708.46
2362,21392412,2023-02-02,117.9,826.36
2363,21392412,2023-02-02,-192.68,633.6800000000001
2364,21392412,2023-02-04,1367.4,2001.0800000000002
2365,21392412,2023-02-04,-101.75,1899.3300000000002
2366,21392412,2023-02-12,122.81,2022.14
2367,21392412,2023-02-14,-120.31,1901.8300000000002
2368,21464772,2023-01-31,,719.8
2369,21464772,2023-02-04,81.91,801.7099999999999
2370,21464772,2023-02-08,52.3,854.01
2371,21464772,2023-02-12,181.41,1035.42
2372,21464772,2023-02-12,125.47,1160.8899999999999
2373,21475060,2023-01-31,,354.98
2374,21475060,2023-02-06,39.83,394.81
2375,21475060,2023-02-06,-431.9,-37.089999999999975
2376,21475060,2023-02-10,-117.25,-154.33999999999997
2377,21475060,2023-02-12,-1061.5,-1215.84
2378,21475060,2023-02-13,158.29,-1057.55
2379,21475060,2023-02-14,25.28,-1032.27
2380,21515934,2023-01-31,,543.38
2381,21515934,2023-02-01,-126.75,416.63
2382,21515934,2023-02-02,599.3,1015.93
2383,21515934,2023-02-02,-212.6,803.3299999999999
2384,21515934,2023-02-03,-70.29,733.04
2385,21515934,2023-02-11,-100.88,632.16
2386,21515934,2023-02-14,77.69,709.8499999999999
2387,21550631,2023-01-31,,84.96
2388,21550631,2023-02-03,-182.35,-97.39
2389,21550631,2023-02-04,119.53,22.14
2390,21550631,2023-02-08,-88.85,-66.71
2391,21550631,2023-02-11,110.41,43.7
2392,21558805,2023-01-31,,586.63
2393,21558805,2023-02-02,68.41,655.04
2394,21558805,2023-02-05,2160.7,2815.74
2395,21558805,2023-02-07,1434.3,4250.04
2396,21558805,2023-02-10,113.82,4363.86
2397,21558805,2023-02-12,934.0,5297.86
2398,21558805,2023-02-13,126.07,5423.929999999999
2399,21558805,2023-02-13,-117.42,5306.509999999999
2400,21601747,2023-01-31,,410.62
2401,21601747,2023-02-01,-58.18,352.44
2402,21601747,2023-02-06,22.99,375.43
2403,21601747,2023-02-08,597.4,972.8299999999999
2404,21601747,2023-02-10,103.91,1076.74
2405,21601747,2023-02-14,-140.0,936.74
2406,21618665,2023-01-31,,291.59
2407,21618665,2023-02-01,-223.94,67.64999999999998
2408,21618665,2023-02-02,89.87,157.51999999999998
2409,21618665,2023-02-02,-175.73,-18.210000000000008
2410,21618665,2023-02-04,101.39,83.17999999999999
2411,21618665,2023-02-05,63.96,147.14
2412,21618665,2023-02-05,-142.33,4.809999999999974
2413,21618665,2023-02-06,184.01,188.81999999999996
2414,21618665,2023-02-06,-65.05,123.76999999999997
2415,21618665,2023-02-07,-171.64,-47.87000000000002
2416,21618665,2023-02-09,96.36,48.48999999999998
2417,21618665,2023-02-13,-104.51,-56.020000000000024
2418,21618665,2023-02-13,-148.17,-204.19
2419,21646418,2023-01-31,,909.55
2420,21646418,2023-02-04,123.43,1032.98
2421,21646418,2023-02-06,-74.78,958.1999999999999
2422,21646418,2023-02-09,64.47,1022.67
2423,21655728,2023-01-31,,761.31
2424,21655728,2023-02-11,56.37,817.68
2425,21655728,2023-02-11,-106.02,711.66
2426,21675999,2023-01-31,,893.27
2427,21675999,2023-02-01,109.32,1002.5899999999999
2428,21675999,2023-02-04,-598.4,404.19000000000005
2429,21675999,2023-02-09,158.66,562.85
2430,21675999,2023-02-10,-32.99,529.86
2431,21675999,2023-02-11,65.4,595.26
2432,21675999,2023-02-11,56.7,651.96
2433,21694967,2023-01-31,,90.13
2434,21694967,2023-02-02,1019.5,1109.63
2435,21694967,2023-02-02,133.67,1243.3
2436,21694967,2023-02-02,-616.7,626.5999999999999
2437,21694967,2023-02-03,-33.4,593.1999999999999
2438,21694967,2023-02-06,-1042.0,-448.80000000000007
2439,21694967,2023-02-07,1808.5,1359.6999999999998
2440,21694967,2023-02-08,-159.45,1200.2499999999998
2441,21694967,2023-02-09,12.69,1212.9399999999998
2442,21705004,2023-01-31,,496.88
2443,21705004,2023-02-08,103.7,600.58
2444,21705004,2023-02-13,124.45,725.03
2445,21705004,2023-02-13,-48.19,676.84
2446,21711501,2023-01-31,,126.63
2447,21711501,2023-02-01,126.36,252.99
2448,21711501,2023-02-03,-1882.4,-1629.41
2449,21711501,2023-02-04,-126.27,-1755.68
2450,21716351,2023-01-31,,800.95
2451,21716351,2023-02-02,111.91,912.86
2452,21716351,2023-02-05,219.27,1132.13
2453,21716351,2023-02-08,33.32,1165.45
2454,21716351,2023-02-12,1499.6,2665.05
2455,21719977,2023-01-31,,758.81
2456,21719977,2023-02-05,138.9,897.7099999999999
2457,21719977,2023-02-06,-155.92,741.79
2458,21719977,2023-02-06,-180.89,560.9
2459,21719977,2023-02-10,739.5,1300.4
2460,21719977,2023-02-12,39.77,1340.17
2461,21719977,2023-02-13,-1121.3,218.87000000000012
2462,21728352,2023-01-31,,733.87
2463,21728352,2023-02-02,-91.84,642.03
2464,21728352,2023-02-04,120.38,762.41
2465,21728352,2023-02-08,-117.08,645.33
2466,21728352,2023-02-10,66.94,712.27
2467,21728352,2023-02-12,151.06,863.3299999999999
2468,21728352,2023-02-12,-103.32,760.01
2469,21728352,2023-02-13,51.57,811.58
2470,21749252,2023-01-31,,646.27
2471,21749252,2023-02-01,50.95,697.22
2472,21749252,2023-02-02,-165.3,531.92
2473,21749252,2023-02-03,126.76,658.68
2474,21749252,2023-02-07,144.5,803.18
2475,21749252,2023-02-08,-110.15,693.03
2476,21749252,2023-02-10,-156.28,536.75
2477,21749252,2023-02-10,-1098.2,-561.45
2478,21749252,2023-02-13,53.28,-508.1700000000001
2479,21750371,2023-01-31,,329.19
2480,21750371,2023-02-05,-88.55,240.64
2481,21750371,2023-02-06,131.96,372.6
2482,21750371,2023-02-10,72.23,444.83000000000004
2483,21816770,2023-01-31,,693.8
2484,21816770,2023-02-03,182.35,876.15
2485,21816770,2023-02-03,141.05,1017.1999999999999
2486,21816770,2023-02-03,-56.86,960.3399999999999
2487,21816770,2023-02-05,74.16,1034.5
2488,21816770,2023-02-09,-144.14,890.3599999999999
2489,21816770,2023-02-10,114.24,1004.5999999999999
2490,21844169,2023-01-31,,463.51
2491,21844169,2023-02-01,-3.04,460.46999999999997
2492,21844169,2023-02-04,-139.28,321.19
2493,21844169,2023-02-06,104.66,425.85
2494,21844169,2023-02-06,-103.37,322.48
2495,21844169,2023-02-07,-89.6,232.88
2496,21844169,2023-02-08,103.37,336.25
2497,21844169,2023-02-09,67.11,403.36
2498,21844169,2023-02-11,-124.08,279.28
2499,21844169,2023-02-12,-108.81,170.47
2500,21844651,2023-01-31,,525.16
2501,21844651,2023-02-03,104.89,630.05
2502,21844651,2023-02-03,-37.02,593.03
2503,21844651,2023-02-04,73.5,666.53
2504,21844651,2023-02-04,45.51,712.04
2505,21844651,2023-02-13,43.53,755.5699999999999
2506,21881168,2023-01-31,,950.62
2507,21881168,2023-02-04,27.77,978.39
2508,21881168,2023-02-04,-78.39,900.0
2509,21881168,2023-02-04,-153.28,746.72
2510,21881168,2023-02-06,31.91,778.63
2511,21881168,2023-02-06,-185.73,592.9
2512,21881168,2023-02-10,121.44,714.34
2513,21881168,2023-02-10,-882.0,-167.65999999999997
2514,21881168,2023-02-14,-78.92,-246.57999999999998
2515,21898016,2023-01-31,,117.42
2516,21898016,2023-02-09,113.15,230.57
2517,21918195,2023-01-31,,510.33
2518,21918195,2023-02-02,-120.93,389.4
2519,21918195,2023-02-08,-105.35,284.04999999999995
2520,21918195,2023-02-14,-150.77,133.27999999999997
2521,21966927,2023-01-31,,511.1
2522,21966927,2023-02-02,88.29,599.39
2523,21966927,2023-02-05,75.94,675.33
2524,21966927,2023-02-06,-27.72,647.61
2525,21966927,2023-02-10,69.88,717.49
2526,22027757,2023-01-31,,438.85
2527,22027757,2023-02-01,-20.11,418.74
2528,22027757,2023-02-01,-102.21,316.53000000000003
2529,22027757,2023-02-01,-215.02,101.51000000000002
2530,22027757,2023-02-05,-505.0,-403.49
2531,22027757,2023-02-06,13.61,-389.88
2532,22035411,2023-01-31,,9.55
2533,22035411,2023-02-02,1028.8,1038.35
2534,22035411,2023-02-02,122.21,1160.56
2535,22035411,2023-02-02,37.84,1198.3999999999999
2536,22035411,2023-02-06,47.53,1245.9299999999998
2537,22035411,2023-02-07,-132.14,1113.79
2538,22035411,2023-02-09,-15.37,1098.4199999999998
2539,22035411,2023-02-10,97.29,1195.7099999999998
2540,22035411,2023-02-11,-85.02,1110.6899999999998
2541,22054113,2023-01-31,,364.66
2542,22054113,2023-02-01,33.36,398.02000000000004
2543,22054113,2023-02-03,-66.09,331.93
2544,22054113,2023-02-04,57.96,389.89000000000004
2545,22054113,2023-02-09,137.79,527.6800000000001
2546,22054113,2023-02-11,43.78,571.46
2547,22054113,2023-02-11,-109.76,461.7
2548,22063978,2023-01-31,,387.01
2549,22063978,2023-02-01,95.21,482.21999999999997
2550,22063978,2023-02-01,-989.3,-507.08
2551,22063978,2023-02-02,50.71,-456.37
2552,22063978,2023-02-02,39.13,-417.24
2553,22063978,2023-02-10,108.81,-308.42999999999995
2554,22099256,2023-01-31,,523.78
2555,22099256,2023-02-02,-131.8,391.97999999999996
2556,22099256,2023-02-04,-87.13,304.84999999999997
2557,22099256,2023-02-06,-127.87,176.97999999999996
2558,22099256,2023-02-06,-1003.2,-826.22
2559,22099256,2023-02-09,85.88,-740.34
2560,22099256,2023-02-14,1401.8,661.4599999999999
2561,22137086,2023-01-31,,410.35
2562,22137086,2023-02-04,2122.7,2533.0499999999997
2563,22137086,2023-02-05,-115.53,2417.5199999999995
2564,22137086,2023-02-07,-32.26,2385.2599999999998
2565,22137086,2023-02-08,83.33,2468.5899999999997
2566,22137086,2023-02-08,-69.06,2399.5299999999997
2567,22137086,2023-02-08,-1368.6,1030.9299999999998
2568,22137086,2023-02-09,-1288.6,-257.6700000000001
2569,22137086,2023-02-11,41.86,-215.81000000000006
2570,22268314,2023-01-31,,153.05
2571,22268314,2023-02-01,-160.38,-7.329999999999984
2572,22268314,2023-02-05,-65.31,-72.63999999999999
2573,22268314,2023-02-09,-155.69,-228.32999999999998
2574,22268314,2023-02-10,13.9,-214.42999999999998
2575,22268314,2023-02-11,-37.8,-252.23
2576,22268314,2023-02-13,-14.32,-266.54999999999995
2577,22292682,2023-01-31,,874.32
2578,22292682,2023-02-01,-130.44,743.8800000000001
2579,22292682,2023-02-05,159.07,902.95
2580,22292682,2023-02-05,-201.75,701.2
2581,22292682,2023-02-06,122.96,824.1600000000001
2582,22292682,2023-02-07,103.74,927.9000000000001
2583,22292682,2023-02-11,23.58,951.48
2584,22292682,2023-02-12,66.05,1017.53
2585,22298371,2023-01-31,,891.16
2586,22298371,2023-02-01,-107.18,783.98
2587,22298371,2023-02-05,-219.27,564.7099999999999
2588,22298371,2023-02-07,86.22,650.93
2589,22298371,2023-02-12,-151.34,499.5899999999999
2590,22341160,2023-01-31,,61.07
2591,22341160,2023-02-02,-699.9,-638.8299999999999
2592,22374612,2023-01-31,,554.31
2593,22374612,2023-02-03,46.33,600.64
2594,22374612,2023-02-05,-1110.7,-510.06000000000006
2595,22374612,2023-02-07,-134.55,-644.6100000000001
2596,22374612,2023-02-08,-189.92,-834.5300000000001
2597,22374612,2023-02-11,1742.7,908.17
2598,22374612,2023-02-12,-91.9,816.27
2599,22374612,2023-02-14,-735.5,80.76999999999998
2600,22391508,2023-01-31,,91.32
2601,22391508,2023-02-01,12.31,103.63
2602,22391508,2023-02-02,94.69,198.32
2603,22391508,2023-02-07,-71.61,126.71
2604,22393008,2023-01-31,,753.5
2605,22393008,2023-02-07,-1806.9,-1053.4
2606,22393008,2023-02-09,1260.0,206.5999999999999
2607,22393008,2023-02-09,-146.1,60.499999999999915
2608,22393008,2023-02-10,1526.7,1587.2
2609,22393008,2023-02-13,-99.8,1487.4
2610,22403299,2023-01-31,,702.95
2611,22403299,2023-02-03,774.8,1477.75
2612,22403299,2023-02-03,-101.53,1376.22
2613,22403299,2023-02-04,90.13,1466.35
2614,22403299,2023-02-04,-95.64,1370.71
2615,22403299,2023-02-05,-57.79,1312.92
2616,22403299,2023-02-08,167.11,1480.03
2617,22403299,2023-02-09,735.1,2215.13
2618,22403299,2023-02-09,142.44,2357.57
2619,22403299,2023-02-09,-88.39,2269.18
2620,22404690,2023-01-31,,726.06
2621,22404690,2023-02-08,-13.32,712.7399999999999
2622,22404690,2023-02-12,934.7,1647.44
2623,22404690,2023-02-14,-126.71,1520.73
2624,22412680,2023-01-31,,637.99
2625,22412680,2023-02-02,-82.9,555.09
2626,22412680,2023-02-03,-84.5,470.59000000000003
2627,22412680,2023-02-08,154.46,625.05
2628,22412680,2023-02-09,119.51,744.5600000000001
2629,22412680,2023-02-09,35.39,779.95
2630,22412680,2023-02-09,-167.25,612.7
2631,22412680,2023-02-10,85.16,697.86
2632,22412680,2023-02-10,77.1,774.96
2633,22412680,2023-02-14,104.53,879.49
2634,22412680,2023-02-14,-38.12,841.37
2635,22412680,2023-02-14,-68.51,772.86
2636,22483300,2023-01-31,,763.23
2637,22483300,2023-02-05,-52.34,710.89
2638,22483300,2023-02-07,-140.12,570.77
2639,22483300,2023-02-09,-112.76,458.01
2640,22483300,2023-02-10,85.13,543.14
2641,22683382,2023-01-31,,987.13
2642,22683382,2023-02-01,-92.35,894.78
2643,22683382,2023-02-02,31.64,926.42
2644,22683382,2023-02-06,-110.76,815.66
2645,22683382,2023-02-07,-104.64,711.02
2646,22683382,2023-02-09,-142.61,568.41
2647,22696687,2023-01-31,,133.52
2648,22696687,2023-02-03,153.0,286.52
2649,22696687,2023-02-08,-79.86,206.66000000000003
2650,22696687,2023-02-10,-62.31,144.35000000000002
2651,22696687,2023-02-10,-89.12,55.230000000000004
2652,22696687,2023-02-12,1061.5,1116.73
2653,22696687,2023-02-12,61.36,1178.09
2654,22696687,2023-02-12,-38.42,1139.67
2655,22696687,2023-02-14,-61.16,1078.51
2656,22730750,2023-01-31,,473.56
2657,22730750,2023-02-01,20.11,493.67
2658,22730750,2023-02-01,13.37,507.04
2659,22730750,2023-02-04,-95.05,411.99
2660,22730750,2023-02-05,128.78,540.77
2661,22730750,2023-02-07,-104.16,436.61
2662,22730750,2023-02-11,132.96,569.57
2663,22730750,2023-02-12,195.95,765.52
2664,22730750,2023-02-12,-198.2,567.32
2665,22799719,2023-01-31,,481.26
2666,22799719,2023-02-03,51.58,532.84
2667,22799719,2023-02-03,-133.85,398.99
2668,22799719,2023-02-06,170.43,569.4200000000001
2669,22799719,2023-02-06,75.9,645.32
2670,22799719,2023-02-07,-44.02,601.3000000000001
2671,22799719,2023-02-11,26.87,628.1700000000001
2672,22799719,2023-02-12,-57.33,570.84
2673,22799719,2023-02-13,38.78,609.62
2674,22799719,2023-02-13,-180.81,428.81
2675,22799719,2023-02-14,53.79,482.6
2676,22830156,2023-01-31,,596.06
2677,22830156,2023-02-02,634.2,1230.26
2678,22830156,2023-02-04,-109.5,1120.76
2679,22830156,2023-02-10,1987.3,3108.06
2680,22830156,2023-02-12,-1153.9,1954.1599999999999
2681,22830156,2023-02-13,-30.92,1923.2399999999998
2682,22830156,2023-02-14,-170.57,1752.6699999999998
2683,22833010,2023-01-31,,645.79
2684,22833010,2023-02-01,-58.0,587.79
2685,22833010,2023-02-03,-132.53,455.26
2686,22833010,2023-02-04,-139.7,315.55999999999995
2687,22833010,2023-02-06,110.76,426.32
2688,22833010,2023-02-08,-163.93,262.39
2689,22846221,2023-01-31,,868.2
2690,22846221,2023-02-01,-179.6,688.6
2691,22846221,2023-02-02,1106.9,1795.5
2692,22846221,2023-02-06,126.83,1922.33
2693,22846221,2023-02-09,12.71,1935.04
2694,22846221,2023-02-10,-144.27,1790.77
2695,22884864,2023-01-31,,521.87
2696,22884864,2023-02-02,108.51,630.38
2697,22884864,2023-02-05,-122.01,508.37
2698,22884864,2023-02-06,-137.14,371.23
2699,22884864,2023-02-06,-182.28,188.95000000000002
2700,22888798,2023-01-31,,326.4
2701,22888798,2023-02-05,39.31,365.71
2702,22888798,2023-02-06,75.81,441.52
2703,22888798,2023-02-07,71.14,512.66
2704,22888798,2023-02-08,107.64,620.3
2705,22888798,2023-02-08,-53.66,566.64
2706,22951653,2023-01-31,,414.64
2707,22951653,2023-02-01,17.61,432.25
2708,22951653,2023-02-02,181.62,613.87
2709,22951653,2023-02-08,-13.16,600.71
2710,22951653,2023-02-12,-14.26,586.45
2711,22951653,2023-02-12,-111.6,474.85
2712,22951653,2023-02-13,84.66,559.51
2713,23030554,2023-01-31,,196.97
2714,23030554,2023-02-03,148.95,345.91999999999996
2715,23030554,2023-02-06,-147.34,198.57999999999998
2716,23030554,2023-02-10,-67.6,130.98
2717,23030554,2023-02-11,-87.57,43.41
2718,23032852,2023-01-31,,475.21
2719,23032852,2023-02-02,832.5,1307.71
2720,23032852,2023-02-04,75.94,1383.65
2721,23032852,2023-02-07,140.72,1524.3700000000001
2722,23032852,2023-02-09,780.7,2305.07
2723,23032852,2023-02-09,-155.34,2149.73
2724,23032852,2023-02-10,-156.63,1993.1000000000001
2725,23045208,2023-01-31,,359.49
2726,23045208,2023-02-02,62.04,421.53000000000003
2727,23045208,2023-02-02,-794.9,-373.36999999999995
2728,23045208,2023-02-02,-1157.4,-1530.77
2729,23045208,2023-02-13,-118.67,-1649.44
2730,23093541,2023-01-31,,326.05
2731,23093541,2023-02-04,-55.7,270.35
2732,23093541,2023-02-05,-96.95,173.4
2733,23093541,2023-02-05,-110.12,63.28
2734,23093541,2023-02-10,86.54,149.82
2735,23124345,2023-01-31,,595.61
2736,23124345,2023-02-03,215.09,810.7
2737,23124345,2023-02-04,126.27,936.97
2738,23124345,2023-02-12,130.79,1067.76
2739,23141588,2023-01-31,,281.28
2740,23141588,2023-02-02,-1824.3,-1543.02
2741,23141588,2023-02-14,-64.58,-1607.6
2742,23231848,2023-01-31,,27.12
2743,23231848,2023-02-02,-112.23,-85.11
2744,23231848,2023-02-04,-89.51,-174.62
2745,23231848,2023-02-04,-292.64,-467.26
2746,23231848,2023-02-04,-1454.9,-1922.16
2747,23231848,2023-02-06,-97.52,-2019.68
2748,23231848,2023-02-09,140.03,-1879.65
2749,23231848,2023-02-11,-95.68,-1975.3300000000002
2750,23231848,2023-02-12,-481.2,-2456.53
2751,23231848,2023-02-13,-134.36,-2590.8900000000003
2752,23231848,2023-02-14,37.37,-2553.52
2753,23269253,2023-01-31,,324.56
2754,23269253,2023-02-01,899.8,1224.36
2755,23269253,2023-02-07,-151.91,1072.4499999999998
2756,23269253,2023-02-08,35.48,1107.9299999999998
2757,23269253,2023-02-10,-72.21,1035.7199999999998
2758,23269253,2023-02-13,-34.3,1001.42
2759,23269253,2023-02-14,-98.34,903.0799999999999
2760,23271383,2023-01-31,,633.3
2761,23271383,2023-02-03,-101.42,531.88
2762,23271383,2023-02-05,174.13,706.01
2763,23271383,2023-02-06,1176.9,1882.91
2764,23271383,2023-02-07,138.63,2021.54
2765,23271383,2023-02-09,157.69,2179.23
2766,23271383,2023-02-09,4.61,2183.84
2767,23271383,2023-02-09,-134.0,2049.84
2768,23271383,2023-02-11,-11.69,2038.15
2769,23271383,2023-02-14,118.38,2156.53
2770,23289647,2023-01-31,,522.8
2771,23289647,2023-02-03,56.86,579.66
2772,23289647,2023-02-07,-87.03,492.62999999999994
2773,23289647,2023-02-07,-125.71,366.91999999999996
2774,23289647,2023-02-10,170.55,537.47
2775,23289647,2023-02-10,-154.12,383.34999999999997
2776,23295106,2023-01-31,,340.16
2777,23295106,2023-02-01,89.15,429.31000000000006
2778,23295106,2023-02-02,103.88,533.19
2779,23295106,2023-02-04,72.72,605.9100000000001
2780,23295106,2023-02-06,-106.03,499.88
2781,23295106,2023-02-11,37.8,537.6800000000001
2782,23295106,2023-02-13,-110.4,427.28000000000003
2783,23295106,2023-02-14,1338.4,1765.68
2784,23310842,2023-01-31,,78.85
2785,23310842,2023-02-02,91.54,170.39
2786,23310842,2023-02-02,-176.64,-6.25
2787,23310842,2023-02-05,12.08,5.83
2788,23310842,2023-02-05,-135.39,-129.55999999999997
2789,23310842,2023-02-06,-90.98,-220.53999999999996
2790,23310842,2023-02-06,-878.3,-1098.84
2791,23310842,2023-02-09,103.84,-994.9999999999999
2792,23310842,2023-02-12,-128.4,-1123.3999999999999
2793,23321929,2023-01-31,,408.3
2794,23321929,2023-02-04,123.51,531.8100000000001
2795,23321929,2023-02-11,-114.34,417.47
2796,23321929,2023-02-13,47.15,464.62
2797,23321929,2023-02-13,-214.61,250.01
2798,23325248,2023-01-31,,49.31
2799,23325248,2023-02-02,-137.59,-88.28
2800,23325248,2023-02-09,-182.37,-270.65
2801,23333877,2023-01-31,,648.46
2802,23333877,2023-02-01,-123.23,525.23
2803,23333877,2023-02-06,103.53,628.76
2804,23333877,2023-02-06,78.08,706.84
2805,23333877,2023-02-09,166.64,873.48
2806,23333877,2023-02-10,386.8,1260.28
2807,23333877,2023-02-11,85.02,1345.3
2808,23333877,2023-02-12,-93.16,1252.14
2809,23333877,2023-02-14,-153.66,1098.48
2810,23369902,2023-01-31,,716.79
2811,23369902,2023-02-01,129.91,846.6999999999999
2812,23369902,2023-02-05,165.04,1011.74
2813,23369902,2023-02-05,118.28,1130.02
2814,23369902,2023-02-08,-124.8,1005.2199999999999
2815,23369902,2023-02-11,-111.88,893.3399999999999
2816,23369902,2023-02-13,144.46,1037.8
2817,23369902,2023-02-13,-183.79,854.01
2818,23415061,2023-01-31,,71.2
2819,23415061,2023-02-01,-102.1,-30.89999999999999
2820,23415061,2023-02-03,90.48,59.58000000000001
2821,23415061,2023-02-04,1702.7,1762.28
2822,23415061,2023-02-04,-123.51,1638.77
2823,23415061,2023-02-10,1220.5,2859.27
2824,23445508,2023-01-31,,373.43
2825,23445508,2023-02-04,54.57,428.0
2826,23445508,2023-02-07,-85.73,342.27
2827,23445508,2023-02-09,-652.0,-309.73
2828,23445508,2023-02-11,-82.15,-391.88
2829,23445508,2023-02-13,169.23,-222.65000000000003
2830,23445508,2023-02-13,23.17,-199.48000000000002
2831,23445508,2023-02-13,-48.38,-247.86000000000004
2832,23479459,2023-01-31,,176.23
2833,23479459,2023-02-02,121.53,297.76
2834,23479459,2023-02-02,-117.71,180.05
2835,23479459,2023-02-05,128.65,308.7
2836,23479459,2023-02-05,-133.57,175.13
2837,23479459,2023-02-06,50.86,225.99
2838,23479459,2023-02-09,43.87,269.86
2839,23490922,2023-01-31,,934.35
2840,23490922,2023-02-06,-76.95,857.4
2841,23490922,2023-02-06,-132.91,724.49
2842,23490922,2023-02-07,78.1,802.59
2843,23490922,2023-02-10,75.99,878.58
2844,23498368,2023-01-31,,474.93
2845,23498368,2023-02-01,101.12,576.05
2846,23498368,2023-02-06,107.32,683.37
2847,23498368,2023-02-06,-159.06,524.31
2848,23498368,2023-02-07,109.39,633.7
2849,23498368,2023-02-11,92.54,726.24
2850,23498368,2023-02-12,98.68,824.9200000000001
2851,23498368,2023-02-12,11.42,836.34
2852,23498368,2023-02-13,-90.8,745.54
2853,23501735,2023-01-31,,562.17
2854,23501735,2023-02-06,107.54,669.7099999999999
2855,23501735,2023-02-08,-150.5,519.21
2856,23501735,2023-02-09,-42.25,476.96
2857,23501735,2023-02-10,-48.91,428.04999999999995
2858,23501735,2023-02-11,-75.76,352.28999999999996
2859,23501735,2023-02-12,142.78,495.07
2860,23501735,2023-02-12,-89.44,405.63
2861,23501735,2023-02-12,-124.17,281.46
2862,23580422,2023-01-31,,716.05
2863,23580422,2023-02-12,-67.25,648.8
2864,23698615,2023-01-31,,316.68
2865,23698615,2023-02-02,89.17,405.85
2866,23698615,2023-02-05,114.48,520.33
2867,23698615,2023-02-12,-98.68,421.65
2868,23736501,2023-01-31,,831.27
2869,23736501,2023-02-04,192.0,1023.27
2870,23736501,2023-02-04,-157.68,865.5899999999999
2871,23736501,2023-02-07,-74.77,790.8199999999999
2872,23736501,2023-02-09,182.37,973.19
2873,23736501,2023-02-09,57.19,1030.38
2874,23736501,2023-02-09,-36.06,994.3199999999999
2875,23736501,2023-02-10,-206.97,787.35
2876,23736501,2023-02-11,-42.47,744.88
2877,23736501,2023-02-14,85.48,830.36
2878,23775829,2023-01-31,,771.57
2879,23775829,2023-02-02,91.57,863.1400000000001
2880,23775829,2023-02-02,65.53,928.6700000000001
2881,23775829,2023-02-03,-28.47,900.2
2882,23775829,2023-02-03,-65.94,834.26
2883,23775829,2023-02-12,-104.51,729.75
2884,23775829,2023-02-13,101.49,831.24
2885,23815822,2023-01-31,,835.0
2886,23815822,2023-02-03,1882.4,2717.4
2887,23815822,2023-02-03,-96.94,2620.46
2888,23815822,2023-02-05,-110.97,2509.4900000000002
2889,23815822,2023-02-13,-17.83,2491.6600000000003
2890,23865100,2023-01-31,,201.44
2891,23865100,2023-02-02,-52.86,148.57999999999998
2892,23865100,2023-02-05,-140.22,8.360000000000014
2893,23865100,2023-02-06,65.05,73.41000000000001
2894,23865100,2023-02-07,86.46,159.87
2895,23865100,2023-02-08,134.88,294.75
2896,23865100,2023-02-08,83.2,377.95
2897,23865100,2023-02-09,64.55,442.5
2898,23865100,2023-02-13,17.92,460.42
2899,23865100,2023-02-14,67.55,527.97
2900,23920423,2023-01-31,,221.15
2901,23920423,2023-02-03,-48.23,172.92000000000002
2902,23920423,2023-02-03,-72.77,100.15
2903,23920423,2023-02-05,96.05,196.2
2904,23920423,2023-02-05,-63.21,132.99
2905,23920423,2023-02-08,38.77,171.76
2906,23920423,2023-02-08,12.95,184.71
2907,23920423,2023-02-08,-161.43,23.28
2908,23920423,2023-02-11,141.71,164.99
2909,23931414,2023-01-31,,126.7
2910,23931414,2023-02-03,-32.07,94.63
2911,23931414,2023-02-10,-123.72,-29.090000000000003
2912,23931414,2023-02-14,101.76,72.67
2913,23932793,2023-01-31,,962.8
2914,23932793,2023-02-13,-510.4,452.4
2915,23932793,2023-02-14,-34.96,417.44
2916,23935849,2023-01-31,,888.11
2917,23935849,2023-02-11,103.93,992.04
2918,23935849,2023-02-12,191.46,1183.5
2919,23935849,2023-02-14,42.9,1226.4
2920,23942646,2023-01-31,,517.93
2921,23942646,2023-02-01,82.42,600.3499999999999
2922,23942646,2023-02-04,-104.07,496.28
2923,23942646,2023-02-06,-102.01,394.27
2924,23942646,2023-02-07,105.09,499.35999999999996
2925,23942646,2023-02-09,57.45,556.81
2926,23959928,2023-01-31,,878.83
2927,23959928,2023-02-03,1569.4,2448.23
2928,23959928,2023-02-04,-3.48,2444.75
2929,23959928,2023-02-07,-69.6,2375.15
2930,23959928,2023-02-14,41.12,2416.27
2931,23962863,2023-01-31,,307.07
2932,23962863,2023-02-01,-599.8,-292.72999999999996
2933,23962863,2023-02-03,-43.61,-336.34
2934,23962863,2023-02-04,-535.8,-872.1399999999999
2935,23962863,2023-02-05,171.75,-700.3899999999999
2936,23962863,2023-02-07,-1676.4,-2376.79
2937,23962863,2023-02-11,84.36,-2292.43
2938,23962863,2023-02-13,123.27,-2169.16
2939,23962863,2023-02-13,-92.64,-2261.8
2940,23971753,2023-01-31,,170.77
2941,23971753,2023-02-02,-169.64,1.1300000000000239
2942,23971753,2023-02-03,110.05,111.18000000000002
2943,23971753,2023-02-08,175.97,287.15000000000003
2944,23971753,2023-02-08,-37.07,250.08
2945,23971753,2023-02-08,-120.67,129.41
2946,23971753,2023-02-09,-142.67,-13.259999999999991
2947,23971753,2023-02-09,-1658.0,-1671.26
2948,23971753,2023-02-10,-48.54,-1719.8
2949,23971753,2023-02-14,123.69,-1596.11
2950,23971753,2023-02-14,-194.38,-1790.49
2951,24010877,2023-01-31,,652.95
2952,24010877,2023-02-01,107.29,760.24
2953,24010877,2023-02-02,-89.17,671.07
2954,24010877,2023-02-05,-154.98,516.09
2955,24010877,2023-02-10,139.65,655.74
2956,24010877,2023-02-10,12.48,668.22
2957,24010877,2023-02-10,-25.31,642.9100000000001
2958,24010877,2023-02-11,122.96,765.8700000000001
2959,24010877,2023-02-12,-110.81,655.0600000000001
2960,24051672,2023-01-31,,429.37
2961,24051672,2023-02-02,-111.58,317.79
2962,24051672,2023-02-03,-122.53,195.26
2963,24051672,2023-02-03,-208.28,-13.019999999999982
2964,24051672,2023-02-06,50.67,37.65000000000002
2965,24051672,2023-02-06,-1069.9,-1032.25
2966,24051672,2023-02-08,122.65,-909.6
2967,24051672,2023-02-08,13.16,-896.4399999999999
2968,24076677,2023-01-31,,494.74
2969,24076677,2023-02-04,142.92,637.66
2970,24076677,2023-02-04,-162.79,474.87
2971,24076677,2023-02-09,59.74,534.61
2972,24076677,2023-02-12,120.78,655.39
2973,24085667,2023-01-31,,249.1
2974,24085667,2023-02-01,78.1,327.2
2975,24085667,2023-02-03,-39.9,287.3
2976,24085667,2023-02-07,97.64,384.94
2977,24085667,2023-02-11,72.76,457.7
2978,24085667,2023-02-12,140.52,598.22
2979,24085667,2023-02-13,-102.35,495.87
2980,24085667,2023-02-14,130.66,626.53
2981,24113784,2023-01-31,,47.67
2982,24113784,2023-02-03,-965.4,-917.73
2983,24113784,2023-02-04,175.99,-741.74
2984,24113784,2023-02-04,-1026.7,-1768.44
2985,24113784,2023-02-09,37.53,-1730.91
2986,24113784,2023-02-10,131.38,-1599.53
2987,24113784,2023-02-10,98.69,-1500.8400000000001
2988,24113784,2023-02-10,-55.38,-1556.22
2989,24113784,2023-02-11,-666.5,-2222.7200000000003
2990,24113784,2023-02-13,77.23,-2145.4900000000002
2991,24113784,2023-02-13,-0.22,-2145.71
2992,24113784,2023-02-13,-76.07,-2221.78
2993,24122572,2023-01-31,,924.02
2994,24122572,2023-02-03,-78.28,845.74
2995,24122572,2023-02-04,362.7,1208.44
2996,24122572,2023-02-04,160.27,1368.71
2997,24122572,2023-02-06,149.41,1518.12
2998,24122572,2023-02-09,-168.03,1350.09
2999,24122572,2023-02-11,86.77,1436.86
3000,24122572,2023-02-11,-141.75,1295.11
3001,24122572,2023-02-13,118.46,1413.57
3002,24122572,2023-02-13,97.77,1511.34
3003,24123707,2023-01-31,,327.69
3004,24123707,2023-02-02,120.26,447.95
3005,24123707,2023-02-09,1386.8,1834.75
3006,24125563,2023-01-31,,908.28
3007,24125563,2023-02-01,98.33,1006.61
3008,24125563,2023-02-06,-73.5,933.11
3009,24125563,2023-02-10,124.46,1057.57
3010,24125563,2023-02-11,89.5,1147.07
3011,24125563,2023-02-13,17.83,1164.8999999999999
3012,24149353,2023-01-31,,487.27
3013,24149353,2023-02-03,108.5,595.77
3014,24149353,2023-02-06,163.65,759.42
3015,24149353,2023-02-06,38.61,798.03
3016,24149353,2023-02-06,-1201.1,-403.06999999999994
3017,24150990,2023-01-31,,365.31
3018,24150990,2023-02-02,111.58,476.89
3019,24150990,2023-02-04,134.81,611.7
3020,24150990,2023-02-04,-47.39,564.31
3021,24150990,2023-02-05,-84.05,480.26
3022,24150990,2023-02-06,82.1,562.36
3023,24150990,2023-02-13,-185.87,376.49
3024,24150990,2023-02-14,91.7,468.19
3025,24178466,2023-01-31,,330.91
3026,24178466,2023-02-06,79.47,410.38
3027,24178466,2023-02-06,-114.81,295.57000000000005
3028,24178466,2023-02-08,-87.59,207.98000000000002
3029,24178466,2023-02-14,-96.17,111.81000000000002
3030,24184530,2023-01-31,,37.87
3031,24184530,2023-02-02,-83.33,-45.46
3032,24184530,2023-02-08,-1360.9,-1406.3600000000001
3033,24184530,2023-02-11,-175.16,-1581.5200000000002
3034,24184530,2023-02-12,143.0,-1438.5200000000002
3035,24198488,2023-01-31,,578.35
3036,24198488,2023-02-02,-168.98,409.37
3037,24198488,2023-02-05,133.57,542.94
3038,24198488,2023-02-05,94.38,637.32
3039,24198488,2023-02-05,83.59,720.9100000000001
3040,24198488,2023-02-09,-86.86,634.0500000000001
3041,24198488,2023-02-13,134.6,768.6500000000001
3042,24250015,2023-01-31,,592.59
3043,24250015,2023-02-01,132.46,725.0500000000001
3044,24250015,2023-02-10,84.84,809.8900000000001
3045,24250015,2023-02-10,-871.2,-61.309999999999945
3046,24250015,2023-02-11,107.86,46.550000000000054
3047,24250015,2023-02-11,-115.25,-68.69999999999995
3048,24250015,2023-02-12,1354.4,1285.7
3049,24285988,2023-01-31,,783.9
3050,24285988,2023-02-02,158.28,942.18
3051,24285988,2023-02-04,-58.09,884.0899999999999
3052,24285988,2023-02-05,963.3,1847.3899999999999
3053,24285988,2023-02-06,99.14,1946.53
3054,24285988,2023-02-06,-149.08,1797.4499999999998
3055,24285988,2023-02-14,-114.54,1682.9099999999999
3056,24285988,2023-02-14,-178.04,1504.87
3057,24298516,2023-01-31,,768.69
3058,24298516,2023-02-01,-74.43,694.26
3059,24298516,2023-02-03,177.23,871.49
3060,24298516,2023-02-09,146.1,1017.59
3061,24298516,2023-02-09,63.75,1081.3400000000001
3062,24299977,2023-01-31,,199.33
3063,24299977,2023-02-01,-13.37,185.96
3064,24299977,2023-02-01,-62.95,123.01000000000002
3065,24299977,2023-02-01,-88.99,34.02000000000001
3066,24299977,2023-02-01,-218.14,-184.11999999999998
3067,24299977,2023-02-02,114.88,-69.23999999999998
3068,24299977,2023-02-04,78.83,9.590000000000018
3069,24299977,2023-02-06,-177.63,-168.03999999999996
3070,24299977,2023-02-08,-88.44,-256.47999999999996
3071,24299977,2023-02-10,-139.51,-395.98999999999995
3072,24299977,2023-02-11,-102.84,-498.8299999999999
3073,24299977,2023-02-13,118.4,-380.42999999999995
3074,24299977,2023-02-13,-168.68,-549.1099999999999
3075,24308337,2023-01-31,,764.57
3076,24308337,2023-02-02,-79.25,685.32
3077,24308337,2023-02-03,-123.6,561.72
3078,24308337,2023-02-03,-886.6,-324.88
3079,24308337,2023-02-07,-1653.3,-1978.1799999999998
3080,24308337,2023-02-09,148.45,-1829.73
3081,24308337,2023-02-11,148.81,-1680.92
3082,24308337,2023-02-12,-146.05,-1826.97
3083,24308337,2023-02-13,959.6,-867.3700000000001
3084,24370240,2023-01-31,,608.64
3085,24370240,2023-02-01,-45.7,562.9399999999999
3086,24370240,2023-02-02,113.03,675.97
3087,24370240,2023-02-06,-137.34,538.63
3088,24370240,2023-02-07,-39.54,499.09
3089,24370240,2023-02-08,1245.5,1744.59
3090,24370240,2023-02-09,88.73,1833.32
3091,24370240,2023-02-13,153.62,1986.94
3092,24370240,2023-02-13,136.9,2123.84
3093,24370240,2023-02-14,63.74,2187.58
3094,24382889,2023-01-31,,14.23
3095,24382889,2023-02-04,68.76,82.99000000000001
3096,24382889,2023-02-06,69.68,152.67000000000002
3097,24382889,2023-02-12,68.37,221.04000000000002
3098,24382889,2023-02-13,-46.32,174.72000000000003
3099,24406166,2023-01-31,,746.97
3100,24406166,2023-02-09,132.48,879.45
3101,24406166,2023-02-09,96.52,975.97
3102,24406166,2023-02-10,149.61,1125.58
3103,24406166,2023-02-11,-103.18,1022.4000000000001
3104,24434457,2023-01-31,,385.3
3105,24434457,2023-02-03,2128.4,2513.7000000000003
3106,24434457,2023-02-10,-129.11,2384.59
3107,24462859,2023-01-31,,646.0
3108,24462859,2023-02-03,91.66,737.66
3109,24462859,2023-02-04,100.94,838.6
3110,24462859,2023-02-06,43.35,881.95
3111,24462859,2023-02-07,-120.64,761.31
3112,24462859,2023-02-08,136.38,897.69
3113,24462859,2023-02-09,-1855.5,-957.81
3114,24462859,2023-02-12,-20.21,-978.02
3115,24510213,2023-01-31,,142.59
3116,24510213,2023-02-10,-133.0,9.590000000000003
3117,24510213,2023-02-14,56.12,65.71000000000001
3118,24513968,2023-01-31,,306.35
3119,24513968,2023-02-01,1277.2,1583.5500000000002
3120,24513968,2023-02-03,-110.56,1472.99
3121,24513968,2023-02-07,-111.37,1361.62
3122,24513968,2023-02-13,80.72,1442.34
3123,24516638,2023-01-31,,426.16
3124,24516638,2023-02-04,-80.86,345.3
3125,24516638,2023-02-09,121.34,466.64000000000004
3126,24516638,2023-02-11,-26.95,439.69000000000005
3127,24516638,2023-02-14,124.79,564.48
3128,24516638,2023-02-14,117.24,681.72
3129,24519138,2023-01-31,,58.15
3130,24519138,2023-02-01,-123.96,-65.81
3131,24519138,2023-02-04,119.74,53.93000000000001
3132,24519138,2023-02-06,-742.3,-688.3699999999999
3133,24519138,2023-02-10,39.7,-648.6699999999998
3134,24519138,2023-02-11,887.8,239.1300000000001
3135,24519138,2023-02-13,166.98,406.1100000000001
3136,24519138,2023-02-13,-52.77,353.3400000000001
3137,24519138,2023-02-13,-139.83,213.51000000000008
3138,24519138,2023-02-14,126.36,339.87000000000006
3139,24519138,2023-02-14,-156.38,183.49000000000007
3140,24529850,2023-01-31,,800.79
3141,24529850,2023-02-03,105.07,905.8599999999999
3142,24529850,2023-02-07,-103.43,802.43
3143,24529850,2023-02-08,135.88,938.31
3144,24529850,2023-02-08,-2283.2,-1344.8899999999999
3145,24529850,2023-02-09,-62.59,-1407.4799999999998
3146,24529850,2023-02-09,-103.19,-1510.6699999999998
3147,24529850,2023-02-09,-136.3,-1646.9699999999998
3148,24529850,2023-02-09,-196.64,-1843.61
3149,24529850,2023-02-11,-122.71,-1966.32
3150,24529850,2023-02-14,665.3,-1301.02
3151,24529850,2023-02-14,-79.12,-1380.1399999999999
3152,24531428,2023-01-31,,565.21
3153,24531428,2023-02-03,-80.5,484.71000000000004
3154,24531428,2023-02-11,49.15,533.86
3155,24531428,2023-02-12,-89.04,444.82000000000005
3156,24533829,2023-01-31,,190.8
3157,24533829,2023-02-01,118.62,309.42
3158,24533829,2023-02-02,-180.4,129.02
3159,24533829,2023-02-09,-105.21,23.810000000000016
3160,24533829,2023-02-11,-56.69,-32.87999999999998
3161,24533829,2023-02-14,-52.36,-85.23999999999998
3162,24533935,2023-01-31,,808.99
3163,24533935,2023-02-02,-13.68,795.3100000000001
3164,24533935,2023-02-06,59.42,854.73
3165,24533935,2023-02-06,-114.86,739.87
3166,24533935,2023-02-07,118.19,858.06
3167,24533935,2023-02-11,95.27,953.33
3168,24533935,2023-02-12,-37.35,915.98
3169,24533935,2023-02-14,139.74,1055.72
3170,24533935,2023-02-14,85.15,1140.87
3171,24539679,2023-01-31,,768.68
3172,24539679,2023-02-02,950.2,1718.88
3173,24539679,2023-02-02,-22.39,1696.49
3174,24539679,2023-02-05,58.5,1754.99
3175,24539679,2023-02-07,1151.1,2906.09
3176,24539679,2023-02-09,-127.72,2778.37
3177,24539679,2023-02-10,-114.72,2663.65
3178,24539679,2023-02-11,-35.03,2628.62
3179,24539679,2023-02-14,104.91,2733.5299999999997
3180,24539679,2023-02-14,-68.67,2664.86
3181,24539679,2023-02-14,-125.94,2538.92
3182,24577383,2023-01-31,,911.96
3183,24577383,2023-02-02,88.1,1000.0600000000001
3184,24577383,2023-02-08,-152.99,847.07
3185,24577383,2023-02-11,120.57,967.64
3186,24577383,2023-02-11,49.94,1017.58
3187,24577383,2023-02-14,131.53,1149.1100000000001
3188,24577383,2023-02-14,-1191.7,-42.590000000000146
3189,24638469,2023-01-31,,968.27
3190,24638469,2023-02-01,-209.89,758.38
3191,24638469,2023-02-11,-127.49,630.89
3192,24669065,2023-01-31,,574.3
3193,24669065,2023-02-09,87.21,661.51
3194,24669065,2023-02-11,-65.05,596.4599999999999
3195,24669065,2023-02-11,-74.61,521.8499999999999
3196,24669065,2023-02-14,-162.09,359.75999999999993
3197,24715803,2023-01-31,,684.75
3198,24715803,2023-02-06,131.6,816.35
3199,24715803,2023-02-10,88.61,904.96
3200,24715803,2023-02-10,-85.88,819.08
3201,24715803,2023-02-13,-117.96,701.12
3202,24715803,2023-02-14,-80.46,620.66
3203,24725325,2023-01-31,,567.17
3204,24725325,2023-02-04,-27.77,539.4
3205,24725325,2023-02-06,-78.29,461.10999999999996
3206,24725325,2023-02-06,-143.3,317.80999999999995
3207,24725325,2023-02-08,-150.55,167.25999999999993
3208,24725325,2023-02-09,129.85,297.1099999999999
3209,24725325,2023-02-12,-11.42,285.68999999999994
3210,24725325,2023-02-12,-139.56,146.12999999999994
3211,24796881,2023-01-31,,943.93
3212,24796881,2023-02-06,111.33,1055.26
3213,24796881,2023-02-08,89.09,1144.35
3214,24796881,2023-02-09,125.13,1269.48
3215,24796881,2023-02-10,-89.61,1179.87
3216,24796881,2023-02-14,142.18,1322.05
3217,24796881,2023-02-14,122.9,1444.95
3218,24796881,2023-02-14,-52.73,1392.22
3219,24826358,2023-01-31,,923.46
3220,24826358,2023-02-06,-113.2,810.26
3221,24826358,2023-02-08,123.43,933.69
3222,24826358,2023-02-08,-151.47,782.22
3223,24826358,2023-02-09,-107.86,674.36
3224,24826358,2023-02-09,-170.19,504.17
3225,24826358,2023-02-10,355.2,859.37
3226,24826358,2023-02-14,72.61,931.98
3227,24849103,2023-01-31,,381.36
3228,24849103,2023-02-01,-83.41,297.95000000000005
3229,24849103,2023-02-02,-104.28,193.67000000000002
3230,24849103,2023-02-05,-174.13,19.54000000000002
3231,24849103,2023-02-10,143.73,163.27
3232,24849103,2023-02-11,-185.47,-22.19999999999999
3233,24849103,2023-02-12,-77.02,-99.21999999999998
3234,24849103,2023-02-13,125.61,26.390000000000015
3235,24849103,2023-02-13,-142.2,-115.80999999999997
3236,24849103,2023-02-14,18.23,-97.57999999999997
3237,24859951,2023-01-31,,950.69
3238,24859951,2023-02-08,-204.91,745.7800000000001
3239,24859951,2023-02-09,-58.69,687.09
3240,24859951,2023-02-13,-74.74,612.35
3241,24860683,2023-01-31,,982.97
3242,24860683,2023-02-01,-114.22,868.75
3243,24860683,2023-02-06,163.9,1032.65
3244,24860683,2023-02-06,-8.35,1024.3
3245,24860683,2023-02-08,-941.0,83.30000000000007
3246,24860683,2023-02-09,108.36,191.66000000000008
3247,24860683,2023-02-10,92.9,284.56000000000006
3248,24860683,2023-02-10,83.94,368.50000000000006
3249,24976861,2023-01-31,,982.53
3250,24976861,2023-02-01,91.95,1074.48
3251,24976861,2023-02-02,190.68,1265.1599999999999
3252,24976861,2023-02-04,-64.92,1200.24
3253,24976861,2023-02-04,-133.05,1067.19
3254,24976861,2023-02-06,110.9,1178.09
3255,24976861,2023-02-06,104.1,1282.19
3256,24976861,2023-02-10,145.54,1427.73
3257,24976861,2023-02-11,105.42,1533.1499999999999
3258,24976861,2023-02-14,34.07,1567.22
3259,24999129,2023-01-31,,750.61
3260,24999129,2023-02-03,-179.75,570.86
3261,24999129,2023-02-05,173.68,744.54
3262,24999129,2023-02-09,-38.13,706.41
3263,24999129,2023-02-09,-75.79,630.62
3264,24999129,2023-02-13,70.3,700.92
3265,24999129,2023-02-13,-731.4,-30.480000000000018
3266,25004339,2023-01-31,,120.44
3267,25004339,2023-02-03,79.25,199.69
3268,25004339,2023-02-03,-131.18,68.50999999999999
3269,25004339,2023-02-05,102.38,170.89
3270,25004339,2023-02-05,56.51,227.39999999999998
3271,25004339,2023-02-07,92.13,319.53
3272,25004339,2023-02-14,79.28,398.80999999999995
3273,25004339,2023-02-14,-89.42,309.39
3274,25006771,2023-01-31,,600.16
3275,25006771,2023-02-01,2027.7,2627.86
3276,25006771,2023-02-01,143.83,2771.69
3277,25006771,2023-02-01,-94.29,2677.4
3278,25006771,2023-02-03,119.1,2796.5
3279,25006771,2023-02-04,105.81,2902.31
3280,25006771,2023-02-04,95.64,2997.95
3281,25006771,2023-02-12,2147.9,5145.85
3282,25033680,2023-01-31,,639.47
3283,25033680,2023-02-01,-615.8,23.670000000000073
3284,25033680,2023-02-02,82.11,105.78000000000007
3285,25033680,2023-02-02,-412.3,-306.5199999999999
3286,25033680,2023-02-07,-78.73,-385.24999999999994
3287,25033680,2023-02-08,-169.4,-554.6499999999999
3288,25033680,2023-02-09,-120.08,-674.7299999999999
3289,25033680,2023-02-10,142.57,-532.1599999999999
3290,25099734,2023-01-31,,872.31
3291,25099734,2023-02-02,-177.88,694.43
3292,25099734,2023-02-03,-117.86,576.5699999999999
3293,25099734,2023-02-03,-124.18,452.38999999999993
3294,25099734,2023-02-04,-39.71,412.67999999999995
3295,25099734,2023-02-05,193.92,606.5999999999999
3296,25099734,2023-02-09,-155.22,451.37999999999994
3297,25099734,2023-02-14,-38.18,413.19999999999993
3298,25110012,2023-01-31,,300.03
3299,25110012,2023-02-01,103.35,403.38
3300,25110012,2023-02-06,-104.85,298.53
3301,25110012,2023-02-08,-129.86,168.66999999999996
3302,25110012,2023-02-09,6.19,174.85999999999996
3303,25110012,2023-02-09,-118.7,56.159999999999954
3304,25110012,2023-02-13,-53.93,2.2299999999999542
3305,25110012,2023-02-13,-104.02,-101.79000000000005
3306,25133996,2023-01-31,,419.22
3307,25133996,2023-02-04,130.57,549.79
3308,25133996,2023-02-04,-103.33,446.46000000000004
3309,25133996,2023-02-07,-174.77,271.69
3310,25133996,2023-02-08,-34.38,237.31
3311,25133996,2023-02-11,107.4,344.71000000000004
3312,25133996,2023-02-12,-68.8,275.91
3313,25133996,2023-02-14,-42.13,233.78
3314,25146667,2023-01-31,,534.11
3315,25146667,2023-02-01,-830.7,-296.59000000000003
3316,25146667,2023-02-10,99.46,-197.13000000000005
3317,25146667,2023-02-11,41.23,-155.90000000000003
3318,25146667,2023-02-12,105.79,-50.11000000000004
3319,25146667,2023-02-13,229.21,179.09999999999997
3320,25146667,2023-02-14,129.18,308.28
3321,25146667,2023-02-14,0.73,309.01
3322,25146667,2023-02-14,-201.77,107.23999999999995
3323,25240031,2023-01-31,,520.29
3324,25240031,2023-02-02,140.31,660.5999999999999
3325,25240031,2023-02-03,125.77,786.37
3326,25240031,2023-02-08,-57.72,728.65
3327,25240031,2023-02-09,-175.48,553.17
3328,25269707,2023-01-31,,770.38
3329,25269707,2023-02-04,110.37,880.75
3330,25269707,2023-02-04,-88.89,791.86
3331,25269707,2023-02-04,-131.28,660.5799999999999
3332,25269707,2023-02-08,67.93,728.51
3333,25269707,2023-02-13,97.59,826.1
3334,25281513,2023-01-31,,618.78
3335,25281513,2023-02-02,78.21,696.99
3336,25281513,2023-02-05,-99.57,597.42
3337,25310962,2023-01-31,,376.9
3338,25310962,2023-02-01,98.74,475.64
3339,25310962,2023-02-02,-58.7,416.93999999999994
3340,25310962,2023-02-05,-134.95,281.99
3341,25310962,2023-02-06,-222.12,59.869999999999976
3342,25318205,2023-01-31,,582.9
3343,25318205,2023-02-03,-140.51,442.39
3344,25318205,2023-02-07,-97.67,344.71999999999997
3345,25318205,2023-02-07,-161.73,182.99
3346,25318205,2023-02-10,90.09,273.08000000000004
3347,25318205,2023-02-13,105.4,378.48
3348,25406407,2023-01-31,,394.05
3349,25406407,2023-02-01,56.06,450.11
3350,25406407,2023-02-03,-158.72,291.39
3351,25406407,2023-02-05,-226.81,64.58000000000001
3352,25406407,2023-02-06,140.67,205.25
3353,25406407,2023-02-07,120.62,325.87
3354,25406407,2023-02-09,165.96,491.83000000000004
3355,25406407,2023-02-10,-29.92,461.91
3356,25406407,2023-02-10,-174.95,286.96000000000004
3357,25406407,2023-02-11,66.62,353.58000000000004
3358,25406407,2023-02-11,-218.81,134.77000000000004
3359,25412464,2023-01-31,,203.46
3360,25412464,2023-02-02,107.62,311.08000000000004
3361,25412464,2023-02-03,-87.6,223.48000000000002
3362,25412464,2023-02-04,191.64,415.12
3363,25412464,2023-02-04,82.87,497.99
3364,25412464,2023-02-05,-90.59,407.4
3365,25412464,2023-02-07,96.86,504.26
3366,25412464,2023-02-09,-38.42,465.84000000000003
3367,25412464,2023-02-13,-106.97,358.87
3368,25439304,2023-01-31,,890.08
3369,25439304,2023-02-01,-126.4,763.6800000000001
3370,25439304,2023-02-05,-159.54,604.1400000000001
3371,25504032,2023-01-31,,838.81
3372,25504032,2023-02-02,-89.88,748.93
3373,25504032,2023-02-02,-147.42,601.51
3374,25504032,2023-02-06,-133.47,468.03999999999996
3375,25510430,2023-01-31,,110.66
3376,25510430,2023-02-03,159.23,269.89
3377,25510430,2023-02-04,-74.75,195.14
3378,25510430,2023-02-06,1359.0,1554.1399999999999
3379,25510430,2023-02-06,-79.47,1474.6699999999998
3380,25510430,2023-02-09,145.58,1620.25
3381,25510430,2023-02-09,-87.21,1533.04
3382,25510430,2023-02-09,-143.27,1389.77
3383,25510430,2023-02-10,92.86,1482.6299999999999
3384,25510430,2023-02-11,59.3,1541.9299999999998
3385,25522226,2023-01-31,,428.21
3386,25522226,2023-02-02,92.61,520.8199999999999
3387,25522226,2023-02-04,1410.9,1931.72
3388,25522226,2023-02-06,-161.37,1770.35
3389,25522226,2023-02-07,70.76,1841.1100000000001
3390,25522226,2023-02-10,111.11,1952.22
3391,25522226,2023-02-11,158.64,2110.86
3392,25522226,2023-02-11,99.57,2210.43
3393,25584693,2023-01-31,,793.42
3394,25584693,2023-02-06,308.7,1102.12
3395,25584693,2023-02-06,96.19,1198.31
3396,25584693,2023-02-07,142.6,1340.9099999999999
3397,25584693,2023-02-08,693.4,2034.31
3398,25584693,2023-02-09,-184.91,1849.3999999999999
3399,25584693,2023-02-13,193.1,2042.5
3400,25584693,2023-02-13,145.19,2187.69
3401,25584693,2023-02-13,-98.45,2089.24
3402,25584693,2023-02-14,117.12,2206.36
3403,25596483,2023-01-31,,595.87
3404,25596483,2023-02-02,-160.62,435.25
3405,25596483,2023-02-05,80.23,515.48
3406,25596483,2023-02-07,171.64,687.12
3407,25596483,2023-02-10,105.35,792.47
3408,25628234,2023-01-31,,808.37
3409,25628234,2023-02-02,57.66,866.03
3410,25628234,2023-02-02,-92.36,773.67
3411,25628234,2023-02-07,43.31,816.98
3412,25628234,2023-02-09,68.25,885.23
3413,25628234,2023-02-09,-159.54,725.69
3414,25628234,2023-02-12,140.22,865.91
3415,25628234,2023-02-12,67.6,933.51
3416,25636885,2023-01-31,,755.58
3417,25636885,2023-02-02,412.3,1167.88
3418,25636885,2023-02-02,20.11,1187.99
3419,25636885,2023-02-08,93.01,1281.0
3420,25636885,2023-02-08,92.86,1373.8600000000001
3421,25636885,2023-02-10,151.75,1525.6100000000001
3422,25636885,2023-02-10,-1048.2,477.4100000000001
3423,25636885,2023-02-12,-77.54,399.87000000000006
3424,25636885,2023-02-13,-140.3,259.57000000000005
3425,25677428,2023-01-31,,307.44
3426,25677428,2023-02-03,-56.35,251.09
3427,25677428,2023-02-07,114.28,365.37
3428,25677428,2023-02-12,-1601.3,-1235.9299999999998
3429,25678043,2023-01-31,,49.06
3430,25678043,2023-02-06,-71.4,-22.340000000000003
3431,25678043,2023-02-06,-133.66,-156.0
3432,25678043,2023-02-08,2283.2,2127.2
3433,25678043,2023-02-10,-34.35,2092.85
3434,25678043,2023-02-11,-110.5,1982.35
3435,25678043,2023-02-12,-180.46,1801.8899999999999
3436,25678043,2023-02-13,-384.8,1417.0899999999997
3437,25698177,2023-01-31,,923.38
3438,25698177,2023-02-03,131.18,1054.56
3439,25698177,2023-02-04,81.16,1135.72
3440,25698177,2023-02-04,55.58,1191.3
3441,25698177,2023-02-04,-124.06,1067.24
3442,25698177,2023-02-06,1524.9,2592.1400000000003
3443,25698177,2023-02-08,150.64,2742.78
3444,25698177,2023-02-09,892.4,3635.1800000000003
3445,25698177,2023-02-11,-182.11,3453.07
3446,25698177,2023-02-12,791.8,4244.87
3447,25698177,2023-02-12,124.17,4369.04
3448,25710768,2023-01-31,,968.16
3449,25737886,2023-01-31,,410.76
3450,25737886,2023-02-04,121.97,532.73
3451,25737886,2023-02-05,196.0,728.73
3452,25737886,2023-02-10,196.24,924.97
3453,25737886,2023-02-11,143.94,1068.91
3454,25737886,2023-02-11,65.05,1133.96
3455,25737886,2023-02-11,-122.96,1011.0
3456,25737886,2023-02-12,107.09,1118.09
3457,25737886,2023-02-12,-78.26,1039.83
3458,25737886,2023-02-14,119.1,1158.93
3459,25746852,2023-01-31,,320.7
3460,25746852,2023-02-01,-86.44,234.26
3461,25746852,2023-02-04,-91.22,143.04
3462,25746852,2023-02-08,49.64,192.68
3463,25746852,2023-02-10,-1524.4,-1331.72
3464,25746852,2023-02-12,156.13,-1175.5900000000001
3465,25746852,2023-02-13,77.91,-1097.68
3466,25746852,2023-02-14,-1485.7,-2583.38
3467,25768265,2023-01-31,,702.22
3468,25768265,2023-02-02,-1902.2,-1199.98
3469,25768265,2023-02-06,121.72,-1078.26
3470,25768265,2023-02-06,-1502.6,-2580.8599999999997
3471,25768265,2023-02-08,72.17,-2508.69
3472,25768265,2023-02-09,113.82,-2394.87
3473,25768265,2023-02-10,-82.0,-2476.87
3474,25768265,2023-02-14,-145.06,-2621.93
3475,25779398,2023-01-31,,967.13
3476,25779398,2023-02-02,-134.24,832.89
3477,25779398,2023-02-04,66.32,899.21
3478,25779398,2023-02-05,-100.05,799.16
3479,25779398,2023-02-11,1104.5,1903.6599999999999
3480,25779398,2023-02-11,-161.33,1742.33
3481,25787771,2023-01-31,,494.02
3482,25787771,2023-02-02,127.28,621.3
3483,25787771,2023-02-06,154.47,775.77
3484,25787771,2023-02-06,143.42,919.1899999999999
3485,25787771,2023-02-07,64.41,983.5999999999999
3486,25787771,2023-02-07,48.04,1031.6399999999999
3487,25787771,2023-02-07,-742.8,288.84000000000003
3488,25787771,2023-02-08,-117.36,171.48000000000002
3489,25787771,2023-02-09,74.98,246.46000000000004
3490,25787771,2023-02-10,1662.6,1909.06
3491,25787771,2023-02-10,150.3,2059.36
3492,25787771,2023-02-10,-128.96,1930.3999999999999
3493,25787771,2023-02-11,126.14,2056.54
3494,25787771,2023-02-13,154.81,2211.35
3495,25787771,2023-02-13,61.53,2272.88
3496,25807378,2023-01-31,,25.32
3497,25807378,2023-02-04,-120.85,-95.53
3498,25807378,2023-02-10,51.27,-44.26
3499,25893329,2023-01-31,,211.58
3500,25893329,2023-02-08,-218.9,-7.319999999999993
3501,25893329,2023-02-12,-176.03,-183.35
3502,25931435,2023-01-31,,127.08
3503,25931435,2023-02-01,-69.52,57.56
3504,25931435,2023-02-07,199.86,257.42
3505,25931435,2023-02-08,-111.03,146.39000000000001
3506,25939481,2023-01-31,,502.59
3507,25939481,2023-02-01,106.3,608.89
3508,25939481,2023-02-05,-101.46,507.42999999999995
3509,25939481,2023-02-10,52.02,559.4499999999999
3510,25941557,2023-01-31,,656.34
3511,25941557,2023-02-01,-61.87,594.47
3512,25941557,2023-02-01,-818.4,-223.92999999999995
3513,25941557,2023-02-02,34.56,-189.36999999999995
3514,25941557,2023-02-03,-96.63,-285.99999999999994
3515,25941557,2023-02-05,-37.99,-323.98999999999995
3516,25941557,2023-02-06,-100.34,-424.3299999999999
3517,25941557,2023-02-08,-130.43,-554.76
3518,25941557,2023-02-10,175.95,-378.80999999999995
3519,25941557,2023-02-10,69.68,-309.13
3520,25941557,2023-02-12,1601.3,1292.17
3521,25941557,2023-02-13,149.9,1442.07
3522,26008806,2023-01-31,,553.23
3523,26008806,2023-02-02,205.49,758.72
3524,26008806,2023-02-03,105.92,864.64
3525,26008806,2023-02-05,121.03,985.6700000000001
3526,26008806,2023-02-05,-168.21,817.46
3527,26008806,2023-02-06,72.35,889.8100000000001
3528,26023976,2023-01-31,,681.17
3529,26023976,2023-02-03,90.66,771.8299999999999
3530,26023976,2023-02-06,885.9,1657.73
3531,26070761,2023-01-31,,641.67
3532,26070761,2023-02-07,1076.8,1718.4699999999998
3533,26070761,2023-02-11,93.32,1811.79
3534,26070761,2023-02-13,105.17,1916.96
3535,26070761,2023-02-14,-103.89,1813.07
3536,26087369,2023-01-31,,653.2
3537,26087369,2023-02-01,-47.33,605.87
3538,26087369,2023-02-02,-130.93,474.94000000000005
3539,26087369,2023-02-10,-67.07,407.87000000000006
3540,26087369,2023-02-14,-72.4,335.47
3541,26101648,2023-01-31,,9.84
3542,26101648,2023-02-03,76.87,86.71000000000001
3543,26101648,2023-02-04,97.94,184.65
3544,26102798,2023-01-31,,104.08
3545,26102798,2023-02-03,-144.82,-40.739999999999995
3546,26102798,2023-02-04,-182.66,-223.39999999999998
3547,26102798,2023-02-05,-113.1,-336.5
3548,26102798,2023-02-07,-162.11,-498.61
3549,26102798,2023-02-09,-108.34,-606.95
3550,26102798,2023-02-10,-158.38,-765.33
3551,26102798,2023-02-12,108.99,-656.34
3552,26102798,2023-02-14,-58.63,-714.97
3553,26102798,2023-02-14,-63.34,-778.3100000000001
3554,26102798,2023-02-14,-156.56,-934.87
3555,26109213,2023-01-31,,698.97
3556,26109213,2023-02-02,-1586.6,-887.6299999999999
3557,26109213,2023-02-05,1315.1,427.47
3558,26109213,2023-02-05,-26.93,400.54
3559,26109213,2023-02-06,55.84,456.38000000000005
3560,26109213,2023-02-06,-73.4,382.98
3561,26109213,2023-02-08,104.18,487.16
3562,26109213,2023-02-09,109.32,596.48
3563,26109213,2023-02-09,-105.79,490.69
3564,26109213,2023-02-12,81.37,572.0600000000001
3565,26109213,2023-02-13,-193.1,378.96000000000004
3566,26115121,2023-01-31,,466.67
3567,26115121,2023-02-03,144.61,611.28
3568,26115121,2023-02-03,-84.79,526.49
3569,26115121,2023-02-14,97.12,623.61
3570,26118463,2023-01-31,,981.0
3571,26118463,2023-02-01,127.46,1108.46
3572,26118463,2023-02-03,-104.95,1003.51
3573,26118463,2023-02-12,-96.4,907.11
3574,26248782,2023-01-31,,70.58
3575,26248782,2023-02-02,-130.23,-59.64999999999999
3576,26248782,2023-02-06,71.52,11.870000000000005
3577,26248782,2023-02-11,-28.34,-16.469999999999995
3578,26248782,2023-02-13,-138.97,-155.44
3579,26375186,2023-01-31,,804.02
3580,26375186,2023-02-06,168.93,972.95
3581,26375186,2023-02-06,97.54,1070.49
3582,26375186,2023-02-06,46.31,1116.8
3583,26375186,2023-02-06,-154.75,962.05
3584,26375186,2023-02-07,125.96,1088.01
3585,26375186,2023-02-08,167.59,1255.6
3586,26375186,2023-02-10,-73.99,1181.6100000000001
3587,26375186,2023-02-11,-135.38,1046.23
3588,26375186,2023-02-14,1650.9,2697.13
3589,26432558,2023-01-31,,465.32
3590,26432558,2023-02-01,189.07,654.39
3591,26432558,2023-02-01,28.95,683.34
3592,26432558,2023-02-01,27.36,710.6999999999999
3593,26432558,2023-02-01,-32.75,677.95
3594,26432558,2023-02-03,169.95,847.9
3595,26432558,2023-02-04,-139.51,708.39
3596,26432558,2023-02-06,1543.0,2251.39
3597,26432558,2023-02-06,25.86,2277.25
3598,26432558,2023-02-07,-1121.9,1155.3499999999997
3599,26506201,2023-01-31,,592.7
3600,26506201,2023-02-05,159.54,752.24
3601,26506201,2023-02-05,-43.28,708.96
3602,26506201,2023-02-07,135.69,844.6500000000001
3603,26506201,2023-02-09,8.38,853.0300000000001
3604,26506201,2023-02-11,-1215.8,-362.76999999999987
3605,26522255,2023-01-31,,283.67
3606,26522255,2023-02-02,-56.84,226.83
3607,26522255,2023-02-08,-1127.1,-900.2699999999999
3608,26522255,2023-02-13,-1085.6,-1985.87
3609,26522255,2023-02-14,-120.06,-2105.93
3610,26522255,2023-02-14,-129.25,-2235.18
3611,26528251,2023-01-31,,539.97
3612,26528251,2023-02-11,-108.59,431.38
3613,26528251,2023-02-13,-155.36,276.02
3614,26528251,2023-02-14,102.55,378.57
3615,26632358,2023-01-31,,384.64
3616,26632358,2023-02-01,182.19,566.8299999999999
3617,26632358,2023-02-01,180.83,747.66
3618,26632358,2023-02-02,61.7,809.36
3619,26632358,2023-02-07,1029.9,1839.2600000000002
3620,26632358,2023-02-09,82.99,1922.2500000000002
3621,26632358,2023-02-11,-24.9,1897.3500000000001
3622,26632358,2023-02-13,1487.7,3385.05
3623,26643616,2023-01-31,,260.1
3624,26643616,2023-02-01,90.79,350.89000000000004
3625,26643616,2023-02-01,-137.72,213.17000000000002
3626,26643616,2023-02-05,-160.91,52.26000000000002
3627,26643616,2023-02-09,74.6,126.86000000000001
3628,26643616,2023-02-11,170.89,297.75
3629,26643616,2023-02-12,-121.86,175.89
3630,26643616,2023-02-14,129.29,305.18
3631,26669001,2023-01-31,,70.04
3632,26669001,2023-02-03,56.31,126.35000000000001
3633,26669001,2023-02-03,21.03,147.38
3634,26669001,2023-02-11,-142.29,5.090000000000032
3635,26669001,2023-02-11,-1318.1,-1313.0099999999998
3636,26669001,2023-02-14,-94.21,-1407.2199999999998
3637,26669001,2023-02-14,-634.0,-2041.2199999999998
3638,26675311,2023-01-31,,989.13
3639,26675311,2023-02-02,-114.88,874.25
3640,26675311,2023-02-07,-15.66,858.59
3641,26675311,2023-02-09,27.53,886.12
3642,26675311,2023-02-09,-155.29,730.83
3643,26675311,2023-02-11,-22.62,708.21
3644,26675311,2023-02-11,-41.86,666.35
3645,26675311,2023-02-11,-181.25,485.1
3646,26675311,2023-02-13,-124.33,360.77000000000004
3647,26675311,2023-02-14,-64.87,295.90000000000003
3648,26751921,2023-01-31,,800.07
3649,26751921,2023-02-14,132.36,932.4300000000001
3650,26751921,2023-02-14,127.34,1059.77
3651,26791907,2023-01-31,,266.27
3652,26791907,2023-02-01,-126.46,139.81
3653,26791907,2023-02-09,-624.2,-484.39000000000004
3654,26791907,2023-02-12,79.75,-404.64000000000004
3655,26791907,2023-02-13,-181.54,-586.1800000000001
3656,26793058,2023-01-31,,384.98
3657,26793058,2023-02-03,44.59,429.57000000000005
3658,26793058,2023-02-05,20.17,449.74
3659,26793058,2023-02-06,687.1,1136.8400000000001
3660,26793058,2023-02-08,-70.15,1066.69
3661,26863880,2023-01-31,,818.47
3662,26863880,2023-02-05,-88.7,729.77
3663,26863880,2023-02-05,-115.12,614.65
3664,26863880,2023-02-07,-102.54,512.11
3665,26863880,2023-02-08,946.2,1458.31
3666,26863880,2023-02-09,-107.47,1350.8400000000001
3667,26863880,2023-02-14,101.53,1452.3700000000001
3668,26863880,2023-02-14,76.32,1528.69
3669,26874415,2023-01-31,,19.62
3670,26874415,2023-02-02,-2269.2,-2249.58
3671,26874415,2023-02-03,-111.84,-2361.42
3672,26874415,2023-02-04,523.6,-1837.82
3673,26874415,2023-02-04,86.74,-1751.08
3674,26874415,2023-02-05,121.41,-1629.6699999999998
3675,26874415,2023-02-05,95.35,-1534.32
3676,26874415,2023-02-08,-52.99,-1587.31
3677,26874415,2023-02-11,99.56,-1487.75
3678,26884718,2023-01-31,,573.65
3679,26884718,2023-02-01,114.47,688.12
3680,26884718,2023-02-02,482.7,1170.82
3681,26884718,2023-02-03,-20.42,1150.3999999999999
3682,26884718,2023-02-03,-118.63,1031.77
3683,26884718,2023-02-04,150.38,1182.1499999999999
3684,26884718,2023-02-08,149.83,1331.98
3685,26884718,2023-02-10,-47.01,1284.97
3686,26884718,2023-02-11,146.56,1431.53
3687,26888158,2023-01-31,,473.02
3688,26888158,2023-02-02,70.88,543.9
3689,26888158,2023-02-02,-15.77,528.13
3690,26888158,2023-02-05,-1022.3,-494.16999999999996
3691,26888158,2023-02-12,179.93,-314.23999999999995
3692,26893181,2023-01-31,,957.43
3693,26893181,2023-02-01,116.66,1074.09
3694,26893181,2023-02-01,-65.9,1008.1899999999999
3695,26893181,2023-02-01,-169.18,839.01
3696,26893181,2023-02-03,-613.0,226.01
3697,26893181,2023-02-10,89.11,315.12
3698,26906533,2023-01-31,,312.58
3699,26906533,2023-02-05,104.74,417.32
3700,26906533,2023-02-05,-58.5,358.82
3701,26906533,2023-02-07,-34.65,324.16999999999996
3702,26906533,2023-02-08,13.32,337.49
3703,26906533,2023-02-10,-75.71,261.78
3704,26906533,2023-02-12,89.48,351.26
3705,26906533,2023-02-14,50.82,402.08
3706,26907311,2023-01-31,,842.69
3707,26907311,2023-02-05,103.21,945.9000000000001
3708,26907311,2023-02-05,-1195.0,-249.0999999999999
3709,26907311,2023-02-07,125.73,-123.3699999999999
3710,26907311,2023-02-07,-93.19,-216.5599999999999
3711,26907311,2023-02-09,-160.54,-377.0999999999999
3712,26907311,2023-02-10,61.2,-315.8999999999999
3713,26907311,2023-02-13,74.01,-241.8899999999999
3714,26953669,2023-01-31,,813.21
3715,26953669,2023-02-01,81.22,894.4300000000001
3716,26953669,2023-02-02,528.9,1423.33
3717,26953669,2023-02-03,-100.42,1322.91
3718,26953669,2023-02-09,75.79,1398.7
3719,26953669,2023-02-11,137.86,1536.56
3720,26958171,2023-01-31,,837.04
3721,26958171,2023-02-02,-116.1,720.9399999999999
3722,26958171,2023-02-05,9.05,729.99
3723,26958171,2023-02-07,-114.74,615.25
3724,26958171,2023-02-11,19.24,634.49
3725,26958171,2023-02-11,-23.0,611.49
3726,26964507,2023-01-31,,358.72
3727,26979446,2023-01-31,,149.65
3728,26979446,2023-02-01,18.27,167.92000000000002
3729,26979446,2023-02-03,214.53,382.45000000000005
3730,26979446,2023-02-07,133.96,516.4100000000001
3731,26979446,2023-02-11,-34.89,481.52000000000004
3732,26979446,2023-02-14,-70.4,411.12
3733,26985042,2023-01-31,,248.7
3734,26985042,2023-02-02,-116.25,132.45
3735,26985042,2023-02-03,228.59,361.03999999999996
3736,26985042,2023-02-03,-104.82,256.22
3737,26985042,2023-02-09,142.67,398.89
3738,26985042,2023-02-12,-54.1,344.78999999999996
3739,26985042,2023-02-14,124.19,468.98
3740,27010847,2023-01-31,,272.04
3741,27010847,2023-02-01,-249.75,22.29000000000002
3742,27010847,2023-02-02,126.94,149.23000000000002
3743,27010847,2023-02-02,20.72,169.95000000000002
3744,27010847,2023-02-02,-131.53,38.420000000000016
3745,27010847,2023-02-02,-182.71,-144.29
3746,27010847,2023-02-05,-298.3,-442.59000000000003
3747,27010847,2023-02-07,856.5,413.90999999999997
3748,27010847,2023-02-07,100.4,514.31
3749,27010847,2023-02-08,135.91,650.22
3750,27010847,2023-02-13,-163.33,486.89
3751,27010847,2023-02-14,133.67,620.56
3752,27010847,2023-02-14,-97.12,523.4399999999999
3753,27108454,2023-01-31,,423.96
3754,27108454,2023-02-02,106.6,530.56
3755,27108454,2023-02-03,15.35,545.91
3756,27108454,2023-02-08,98.0,643.91
3757,27108454,2023-02-09,1324.2,1968.1100000000001
3758,27108454,2023-02-14,69.99,2038.1
3759,27117946,2023-01-31,,342.03
3760,27117946,2023-02-05,20.31,362.34
3761,27117946,2023-02-07,-135.32,227.01999999999998
3762,27117946,2023-02-08,137.97,364.99
3763,27117946,2023-02-13,-91.43,273.55999999999995
3764,27170424,2023-01-31,,211.66
3765,27170424,2023-02-04,-150.79,60.870000000000005
3766,27170424,2023-02-09,-111.55,-50.67999999999999
3767,27170424,2023-02-10,140.57,89.89
3768,27170424,2023-02-10,-835.9,-746.01
3769,27193025,2023-01-31,,187.57
3770,27193025,2023-02-01,54.7,242.26999999999998
3771,27193025,2023-02-03,19.83,262.1
3772,27193025,2023-02-04,-104.24,157.86
3773,27193025,2023-02-05,118.39,276.25
3774,27193025,2023-02-06,-155.37,120.88
3775,27193025,2023-02-07,-166.29,-45.41
3776,27193025,2023-02-08,67.49,22.08
3777,27193025,2023-02-10,47.75,69.83
3778,27193025,2023-02-10,44.74,114.57
3779,27193025,2023-02-11,56.69,171.26
3780,27193025,2023-02-13,25.57,196.82999999999998
3781,27193470,2023-01-31,,479.57
3782,27193470,2023-02-02,-68.41,411.15999999999997
3783,27193470,2023-02-03,-82.41,328.75
3784,27193470,2023-02-04,105.89,434.64
3785,27193470,2023-02-06,1486.9,1921.54
3786,27193470,2023-02-06,-78.77,1842.77
3787,27193470,2023-02-07,480.0,2322.77
3788,27193470,2023-02-07,-116.86,2205.91
3789,27193470,2023-02-08,-117.53,2088.38
3790,27193470,2023-02-08,-139.22,1949.1599999999999
3791,27193470,2023-02-09,-118.46,1830.7
3792,27193470,2023-02-12,-142.98,1687.72
3793,27203821,2023-01-31,,256.57
3794,27203821,2023-02-03,-866.1,-609.53
3795,27203821,2023-02-07,1679.8,1070.2699999999998
3796,27203821,2023-02-07,152.23,1222.4999999999998
3797,27203821,2023-02-09,-177.2,1045.2999999999997
3798,27264533,2023-01-31,,254.28
3799,27264533,2023-02-03,95.29,349.57
3800,27264533,2023-02-07,64.08,413.65
3801,27264533,2023-02-08,85.29,498.94
3802,27305999,2023-01-31,,17.22
3803,27305999,2023-02-03,-117.17,-99.95
3804,27305999,2023-02-03,-185.02,-284.97
3805,27334998,2023-01-31,,817.28
3806,27334998,2023-02-05,100.57,917.8499999999999
3807,27334998,2023-02-05,-1.11,916.74
3808,27334998,2023-02-06,99.03,1015.77
3809,27334998,2023-02-07,-170.65,845.1199999999999
3810,27334998,2023-02-08,-130.38,714.74
3811,27356852,2023-01-31,,414.82
3812,27356852,2023-02-01,160.76,575.5799999999999
3813,27356852,2023-02-01,128.78,704.36
3814,27356852,2023-02-03,-99.42,604.9399999999999
3815,27356852,2023-02-04,381.6,986.54
3816,27356852,2023-02-04,-57.96,928.58
3817,27356852,2023-02-05,-116.94,811.64
3818,27356852,2023-02-10,1271.5,2083.14
3819,27356852,2023-02-12,-41.2,2041.9399999999998
3820,27356852,2023-02-12,-118.8,1923.1399999999999
3821,27357010,2023-01-31,,579.29
3822,27357010,2023-02-02,-120.26,459.03
3823,27357010,2023-02-06,90.59,549.62
3824,27357010,2023-02-06,-90.59,459.03
3825,27357010,2023-02-09,101.24,560.27
3826,27357010,2023-02-13,48.01,608.28
3827,27357010,2023-02-14,-122.47,485.80999999999995
3828,27382109,2023-01-31,,174.95
3829,27382109,2023-02-01,63.48,238.42999999999998
3830,27382109,2023-02-05,-858.4,-619.97
3831,27382109,2023-02-07,-45.83,-665.8000000000001
3832,27382109,2023-02-07,-60.4,-726.2
3833,27382109,2023-02-07,-136.09,-862.29
3834,27382109,2023-02-13,1188.4,326.1100000000001
3835,27382109,2023-02-14,-188.72,137.39000000000013
3836,27388260,2023-01-31,,39.64
3837,27388260,2023-02-04,137.7,177.33999999999997
3838,27388260,2023-02-07,135.14,312.47999999999996
3839,27388260,2023-02-07,-107.54,204.93999999999994
3840,27388260,2023-02-08,-107.42,97.51999999999995
3841,27388260,2023-02-09,30.61,128.12999999999994
3842,27388260,2023-02-11,-6.54,121.58999999999995
3843,27388260,2023-02-12,109.89,231.47999999999996
3844,27388260,2023-02-12,49.38,280.85999999999996
3845,27388260,2023-02-14,123.36,404.2199999999999
3846,27389680,2023-01-31,,815.68
3847,27389680,2023-02-02,327.6,1143.28
3848,27389680,2023-02-05,18.13,1161.41
3849,27389680,2023-02-08,-57.93,1103.48
3850,27389680,2023-02-08,-156.86,946.6199999999999
3851,27389680,2023-02-14,-82.48,864.14
3852,27415805,2023-01-31,,902.28
3853,27415805,2023-02-02,-94.5,807.78
3854,27415805,2023-02-03,43.72,851.5
3855,27415805,2023-02-06,-1107.9,-256.4000000000001
3856,27415805,2023-02-07,36.73,-219.6700000000001
3857,27415805,2023-02-09,125.11,-94.56000000000009
3858,27415805,2023-02-09,-30.61,-125.17000000000009
3859,27415805,2023-02-11,-172.32,-297.49000000000007
3860,27430568,2023-01-31,,450.45
3861,27430568,2023-02-01,-100.12,350.33
3862,27430568,2023-02-01,-186.45,163.88
3863,27430568,2023-02-02,-832.5,-668.62
3864,27430568,2023-02-03,173.67,-494.95000000000005
3865,27430568,2023-02-03,-107.8,-602.75
3866,27430568,2023-02-06,91.5,-511.25
3867,27430568,2023-02-09,230.97,-280.28000000000003
3868,27430568,2023-02-10,86.27,-194.01000000000005
3869,27430568,2023-02-11,-84.59,-278.6
3870,27430568,2023-02-11,-90.65,-369.25000000000006
3871,27430568,2023-02-12,-1025.1,-1394.35
3872,27580272,2023-01-31,,352.81
3873,27580272,2023-02-03,115.75,468.56
3874,27580272,2023-02-07,91.56,560.12
3875,27580272,2023-02-09,-64.46,495.66
3876,27582893,2023-01-31,,639.21
3877,27582893,2023-02-02,-98.09,541.12
3878,27582893,2023-02-03,-129.73,411.39000000000004
3879,27582893,2023-02-03,-146.33,265.06000000000006
3880,27582893,2023-02-05,-105.33,159.73000000000002
3881,27582893,2023-02-14,-66.56,93.17000000000003
3882,27585212,2023-01-31,,150.57
3883,27585212,2023-02-03,-101.07,49.5
3884,27585212,2023-02-08,76.59,126.09
3885,27589482,2023-01-31,,494.03
3886,27589482,2023-02-01,129.54,623.5699999999999
3887,27589482,2023-02-04,-24.15,599.42
3888,27589482,2023-02-06,102.35,701.77
3889,27589482,2023-02-09,-129.57,572.1999999999999
3890,27589482,2023-02-13,14.56,586.76
3891,27589482,2023-02-13,-81.27,505.48999999999995
3892,27596004,2023-01-31,,505.73
3893,27596004,2023-02-01,989.3,1495.03
3894,27596004,2023-02-01,172.77,1667.8
3895,27596004,2023-02-01,36.3,1704.1
3896,27596004,2023-02-06,193.24,1897.34
3897,27596004,2023-02-09,-88.16,1809.18
3898,27596004,2023-02-12,-1255.7,553.48
3899,27596004,2023-02-14,0.43,553.91
3900,27596004,2023-02-14,-259.3,294.61
3901,27600956,2023-01-31,,84.39
3902,27600956,2023-02-04,33.69,118.08
3903,27600956,2023-02-05,-104.27,13.810000000000002
3904,27600956,2023-02-08,105.35,119.16
3905,27600956,2023-02-10,109.1,228.26
3906,27600956,2023-02-12,197.29,425.54999999999995
3907,27600956,2023-02-12,16.56,442.10999999999996
3908,27600956,2023-02-12,-1268.1,-825.99
3909,27600956,2023-02-14,135.36,-690.63
3910,27625709,2023-01-31,,616.45
3911,27625709,2023-02-01,-77.61,538.84
3912,27625709,2023-02-04,-32.88,505.96000000000004
3913,27625709,2023-02-10,-4.42,501.54
3914,27625709,2023-02-11,131.8,633.34
3915,27625709,2023-02-14,128.39,761.73
3916,27625709,2023-02-14,-153.23,608.5
3917,27628187,2023-01-31,,344.63
3918,27628187,2023-02-02,-109.57,235.06
3919,27628187,2023-02-02,-148.04,87.02000000000001
3920,27628187,2023-02-03,-127.48,-40.459999999999994
3921,27628187,2023-02-07,87.52,47.06
3922,27713909,2023-01-31,,199.77
3923,27713909,2023-02-02,79.25,279.02
3924,27713909,2023-02-06,7.07,286.09000000000003
3925,27713909,2023-02-09,1160.0,1446.0900000000001
3926,27806002,2023-01-31,,565.08
3927,27806002,2023-02-07,27.75,592.83
3928,27806002,2023-02-08,233.36,826.19
3929,27806002,2023-02-14,-479.9,346.2900000000001
3930,27821800,2023-01-31,,322.23
3931,27821800,2023-02-06,-394.5,-72.26999999999998
3932,27821800,2023-02-10,-76.32,-148.58999999999997
3933,27821800,2023-02-13,58.62,-89.96999999999997
3934,27821800,2023-02-14,151.02,61.05000000000004
3935,27845045,2023-01-31,,136.91
3936,27845045,2023-02-01,80.9,217.81
3937,27845045,2023-02-08,117.08,334.89
3938,27845045,2023-02-14,-130.09,204.8
3939,27870202,2023-01-31,,286.17
3940,27870202,2023-02-03,111.04,397.21000000000004
3941,27870202,2023-02-07,1613.2,2010.41
3942,27870202,2023-02-08,13.55,2023.96
3943,27870202,2023-02-11,-17.89,2006.0700000000002
3944,27870202,2023-02-14,99.23,2105.3
3945,27985160,2023-01-31,,446.21
3946,27985160,2023-02-02,-744.2,-297.99000000000007
3947,27985160,2023-02-08,-132.6,-430.59000000000003
3948,27985160,2023-02-09,107.22,-323.37000000000006
3949,28053942,2023-01-31,,70.94
3950,28053942,2023-02-01,-1821.2,-1750.26
3951,28053942,2023-02-02,-132.84,-1883.1
3952,28053942,2023-02-05,-119.28,-2002.38
3953,28053942,2023-02-05,-841.2,-2843.58
3954,28053942,2023-02-06,-75.16,-2918.7400000000002
3955,28063272,2023-01-31,,252.41
3956,28063272,2023-02-04,155.57,407.98
3957,28063272,2023-02-06,202.05,610.03
3958,28063272,2023-02-07,194.01,804.04
3959,28063272,2023-02-08,967.3,1771.34
3960,28063272,2023-02-08,-125.91,1645.4299999999998
3961,28063272,2023-02-09,-105.86,1539.57
3962,28063272,2023-02-10,149.81,1689.3799999999999
3963,28063272,2023-02-10,-82.97,1606.4099999999999
3964,28063272,2023-02-10,-165.63,1440.78
3965,28063272,2023-02-14,-58.88,1381.8999999999999
3966,28142099,2023-01-31,,420.86
3967,28142099,2023-02-10,-1134.6,-713.7399999999999
3968,28222331,2023-01-31,,137.74
3969,28222331,2023-02-01,140.1,277.84000000000003
3970,28222331,2023-02-01,102.76,380.6
3971,28222331,2023-02-04,30.36,410.96000000000004
3972,28222331,2023-02-04,-67.93,343.03
3973,28222331,2023-02-07,49.81,392.84000000000003
3974,28240243,2023-01-31,,850.7
3975,28240243,2023-02-01,-122.07,728.6300000000001
3976,28240243,2023-02-08,-93.01,635.62
3977,28240243,2023-02-13,-175.32,460.30000000000007
3978,28247818,2023-01-31,,150.24
3979,28247818,2023-02-01,75.52,225.76
3980,28247818,2023-02-05,65.92,291.68
3981,28247818,2023-02-07,126.45,418.13
3982,28247818,2023-02-07,102.9,521.03
3983,28247818,2023-02-09,77.58,598.61
3984,28247818,2023-02-10,-107.08,491.53000000000003
3985,28247818,2023-02-11,65.22,556.75
3986,28247818,2023-02-11,29.76,586.51
3987,28247818,2023-02-12,119.93,706.44
3988,28247818,2023-02-12,-67.6,638.84
3989,28247818,2023-02-12,-127.0,511.84000000000003
3990,28251857,2023-01-31,,431.6
3991,28251857,2023-02-01,85.99,517.59
3992,28251857,2023-02-02,1501.3,2018.8899999999999
3993,28251857,2023-02-02,-90.38,1928.5100000000002
3994,28251857,2023-02-05,0.49,1929.0
3995,28251857,2023-02-05,-117.78,1811.22
3996,28251857,2023-02-06,180.89,1992.1100000000001
3997,28251857,2023-02-10,20.93,2013.04
3998,28251857,2023-02-10,-104.53,1908.51
3999,28254911,2023-01-31,,697.78
4000,28254911,2023-02-03,-16.2,681.5799999999999
4001,28254911,2023-02-04,888.9,1570.48
4002,28254911,2023-02-06,165.67,1736.1499999999999
4003,28254911,2023-02-06,-131.6,1604.55
4004,28254911,2023-02-07,-139.63,1464.9199999999998
4005,28254911,2023-02-08,90.88,1555.8
4006,28254911,2023-02-09,68.62,1624.4199999999998
4007,28254911,2023-02-11,633.2,2257.62
4008,28254911,2023-02-11,-89.22,2168.4
4009,28254911,2023-02-11,-122.35,2046.05
4010,28254911,2023-02-12,92.53,2138.58
4011,28254911,2023-02-12,-147.01,1991.57
4012,28254911,2023-02-14,-118.38,1873.1899999999998
4013,28362321,2023-01-31,,849.34
4014,28362321,2023-02-03,-77.07,772.27
4015,28362321,2023-02-05,76.11,848.38
4016,28362321,2023-02-07,59.08,907.46
4017,28362321,2023-02-08,44.34,951.8000000000001
4018,28362321,2023-02-10,849.7,1801.5
4019,28362321,2023-02-10,17.18,1818.68
4020,28362321,2023-02-10,-69.69,1748.9900000000002
4021,28362321,2023-02-12,-614.4,1134.5900000000001
4022,28380949,2023-01-31,,937.24
4023,28380949,2023-02-01,-131.58,805.66
4024,28380949,2023-02-04,-58.38,747.28
4025,28380949,2023-02-04,-1412.5,-665.22
4026,28380949,2023-02-05,-141.36,-806.58
4027,28380949,2023-02-07,17.39,-789.19
4028,28380949,2023-02-11,573.2,-215.99
4029,28429440,2023-01-31,,538.15
4030,28429440,2023-02-01,-57.95,480.2
4031,28429440,2023-02-03,-85.06,395.14
4032,28429440,2023-02-05,-471.4,-76.25999999999999
4033,28429440,2023-02-07,-86.22,-162.48
4034,28429440,2023-02-10,59.31,-103.16999999999999
4035,28429440,2023-02-11,-1096.1,-1199.27
4036,28429440,2023-02-12,180.17,-1019.1
4037,28548067,2023-01-31,,499.29
4038,28548067,2023-02-03,32.08,531.37
4039,28548067,2023-02-05,100.87,632.24
4040,28548067,2023-02-12,36.02,668.26
4041,28553155,2023-01-31,,147.09
4042,28553155,2023-02-01,-131.36,15.72999999999999
4043,28553155,2023-02-03,-106.67,-90.94000000000001
4044,28553155,2023-02-05,134.95,44.00999999999998
4045,28553155,2023-02-08,124.98,168.98999999999998
4046,28553155,2023-02-09,102.41,271.4
4047,28553155,2023-02-10,-76.15,195.24999999999997
4048,28553155,2023-02-13,-14.56,180.68999999999997
4049,28553155,2023-02-14,112.72,293.40999999999997
4050,28572979,2023-01-31,,156.38
4051,28572979,2023-02-02,130.23,286.61
4052,28572979,2023-02-02,-190.92,95.69
4053,28572979,2023-02-04,1026.7,1122.39
4054,28572979,2023-02-06,-210.36,912.0300000000001
4055,28572979,2023-02-09,-48.05,863.9800000000001
4056,28572979,2023-02-11,-168.92,695.0600000000002
4057,28572979,2023-02-12,66.4,761.4600000000002
4058,28595197,2023-01-31,,897.68
4059,28595197,2023-02-02,68.18,965.8599999999999
4060,28595197,2023-02-03,108.32,1074.1799999999998
4061,28595197,2023-02-04,-809.4,264.78
4062,28595197,2023-02-06,-34.09,230.68999999999997
4063,28595197,2023-02-07,-993.9,-763.21
4064,28595197,2023-02-09,-1606.6,-2369.81
4065,28606808,2023-01-31,,1.71
4066,28606808,2023-02-02,-41.88,-40.17
4067,28606808,2023-02-07,-59.08,-99.25
4068,28606808,2023-02-07,-71.01,-170.26
4069,28606808,2023-02-08,957.8,787.54
4070,28606808,2023-02-09,-139.7,647.8399999999999
4071,28629966,2023-01-31,,60.86
4072,28629966,2023-02-02,52.11,112.97
4073,28629966,2023-02-03,-55.02,57.949999999999996
4074,28629966,2023-02-04,72.49,130.44
4075,28629966,2023-02-04,8.63,139.07
4076,28629966,2023-02-05,108.31,247.38
4077,28629966,2023-02-07,-186.23,61.14999999999998
4078,28629966,2023-02-09,103.88,165.02999999999997
4079,28629966,2023-02-11,-59.3,105.72999999999998
4080,28629966,2023-02-12,98.2,203.92999999999998
4081,28629966,2023-02-13,126.46,330.39
4082,28629966,2023-02-13,-148.89,181.5
4083,28640713,2023-01-31,,204.33
4084,28640713,2023-02-01,-53.43,150.9
4085,28640713,2023-02-03,-111.46,39.440000000000026
4086,28640713,2023-02-05,-128.65,-89.20999999999998
4087,28640713,2023-02-06,157.18,67.97000000000003
4088,28640713,2023-02-06,93.75,161.72000000000003
4089,28640713,2023-02-06,27.94,189.66000000000003
4090,28640713,2023-02-06,-97.36,92.30000000000003
4091,28640713,2023-02-07,9.52,101.82000000000002
4092,28640713,2023-02-09,-86.0,15.820000000000022
4093,28640713,2023-02-13,-117.35,-101.52999999999997
4094,28652960,2023-01-31,,140.6
4095,28652960,2023-02-04,134.34,274.94
4096,28652960,2023-02-04,129.92,404.86
4097,28652960,2023-02-06,-91.86,313.0
4098,28652960,2023-02-09,214.76,527.76
4099,28652960,2023-02-09,-116.34,411.41999999999996
4100,28652960,2023-02-10,197.72,609.14
4101,28652960,2023-02-10,-30.02,579.12
4102,28652960,2023-02-11,130.89,710.01
4103,28652960,2023-02-12,66.67,776.68
4104,28652960,2023-02-13,96.41,873.0899999999999
4105,28652960,2023-02-13,-89.23,783.8599999999999
4106,28659160,2023-01-31,,115.6
4107,28659160,2023-02-01,-172.77,-57.170000000000016
4108,28659160,2023-02-02,-327.6,-384.77000000000004
4109,28659160,2023-02-06,-134.68,-519.45
4110,28659160,2023-02-07,98.93,-420.52000000000004
4111,28680375,2023-01-31,,337.2
4112,28680375,2023-02-02,84.65,421.85
4113,28680375,2023-02-13,-25.85,396.0
4114,28680375,2023-02-13,-152.92,243.08
4115,28680375,2023-02-14,-106.21,136.87
4116,28696496,2023-01-31,,150.57
4117,28696496,2023-02-02,58.23,208.79999999999998
4118,28696496,2023-02-08,-120.55,88.25
4119,28696496,2023-02-09,82.54,170.79000000000002
4120,28696496,2023-02-13,-93.53,77.26
4121,28696496,2023-02-13,-123.86,-46.599999999999994
4122,28696496,2023-02-14,148.05,101.45000000000002
4123,28738041,2023-01-31,,907.31
4124,28738041,2023-02-02,-48.35,858.9599999999999
4125,28738041,2023-02-07,1806.9,2665.86
4126,28738041,2023-02-09,96.94,2762.8
4127,28738041,2023-02-11,190.18,2952.98
4128,28738041,2023-02-12,-66.05,2886.9300000000003
4129,28738041,2023-02-13,-56.68,2830.25
4130,28738041,2023-02-14,-69.79,2760.46
4131,28743137,2023-01-31,,781.13
4132,28743137,2023-02-02,-118.55,662.58
4133,28743137,2023-02-13,111.36,773.94
4134,28743137,2023-02-13,-64.85,709.09
4135,28745450,2023-01-31,,157.38
4136,28745450,2023-02-01,163.82,321.2
4137,28745450,2023-02-06,-77.81,243.39
4138,28745450,2023-02-09,113.5,356.89
4139,28745450,2023-02-09,47.96,404.84999999999997
4140,28745450,2023-02-12,-180.44,224.41
4141,28754062,2023-01-31,,16.41
4142,28781155,2023-01-31,,555.55
4143,28781155,2023-02-02,99.34,654.89
4144,28781155,2023-02-06,105.25,760.14
4145,28781155,2023-02-10,-67.41,692.73
4146,28781155,2023-02-11,34.81,727.54
4147,28781155,2023-02-11,-109.94,617.5999999999999
4148,28811285,2023-01-31,,813.63
4149,28811285,2023-02-03,-227.05,586.5799999999999
4150,28811285,2023-02-04,-86.15,500.42999999999995
4151,28811285,2023-02-08,-110.78,389.65
4152,28811285,2023-02-12,1534.6,1924.25
4153,28819175,2023-01-31,,414.48
4154,28819175,2023-02-01,-44.29,370.19
4155,28819175,2023-02-02,20.57,390.76
4156,28819175,2023-02-03,63.29,454.05
4157,28819175,2023-02-06,-178.95,275.1
4158,28819175,2023-02-09,-91.82,183.28000000000003
4159,28819175,2023-02-09,-363.8,-180.51999999999998
4160,28819175,2023-02-11,-155.49,-336.01
4161,28822117,2023-01-31,,204.79
4162,28822117,2023-02-01,-98.74,106.05
4163,28822117,2023-02-05,1022.3,1128.35
4164,28822117,2023-02-07,-43.86,1084.49
4165,28909144,2023-01-31,,263.97
4166,28909144,2023-02-04,32.88,296.85
4167,28909144,2023-02-04,32.51,329.36
4168,28909144,2023-02-05,-66.8,262.56000000000006
4169,28909144,2023-02-08,165.79,428.35
4170,28909144,2023-02-14,-30.0,398.35
4171,28911002,2023-01-31,,858.06
4172,28911002,2023-02-01,1139.7,1997.76
4173,28911002,2023-02-02,-137.03,1860.73
4174,28911002,2023-02-06,-122.69,1738.04
4175,28911002,2023-02-11,50.13,1788.17
4176,28911002,2023-02-11,-75.03,1713.1399999999999
4177,28969443,2023-01-31,,12.77
4178,28969443,2023-02-07,-485.9,-473.13
4179,28969443,2023-02-08,-79.06,-552.19
4180,28969443,2023-02-09,29.71,-522.48
4181,28969443,2023-02-14,-111.2,-633.6800000000001
4182,28976546,2023-01-31,,454.25
4183,28976546,2023-02-01,-128.83,325.41999999999996
4184,28976546,2023-02-05,59.2,384.62
4185,28976546,2023-02-06,-71.54,313.08
4186,28976546,2023-02-09,-48.6,264.47999999999996
4187,29000698,2023-01-31,,954.02
4188,29000698,2023-02-06,-97.54,856.48
4189,29000698,2023-02-07,44.98,901.4599999999999
4190,29000698,2023-02-11,16.59,918.05
4191,29000698,2023-02-12,191.61,1109.66
4192,29017229,2023-01-31,,950.07
4193,29017229,2023-02-02,95.2,1045.27
4194,29017229,2023-02-03,179.54,1224.81
4195,29017229,2023-02-03,-183.44,1041.3700000000001
4196,29017229,2023-02-04,1246.9,2288.2700000000004
4197,29017229,2023-02-06,-189.84,2098.4300000000003
4198,29017229,2023-02-14,71.88,2170.3100000000004
4199,29039134,2023-01-31,,218.26
4200,29039134,2023-02-05,115.1,333.36
4201,29039134,2023-02-08,245.8,579.16
4202,29039134,2023-02-11,82.76,661.92
4203,29039134,2023-02-12,1411.1,2073.02
4204,29039134,2023-02-12,97.82,2170.84
4205,29039134,2023-02-14,558.8,2729.64
4206,29039134,2023-02-14,104.64,2834.2799999999997
4207,29043142,2023-01-31,,210.89
4208,29043142,2023-02-09,-110.51,100.37999999999998
4209,29043142,2023-02-11,-114.61,-14.230000000000018
4210,29043142,2023-02-12,67.25,53.01999999999998
4211,29043142,2023-02-12,-141.01,-87.99000000000001
4212,29052260,2023-01-31,,639.05
4213,29052260,2023-02-03,132.95,772.0
4214,29052260,2023-02-05,89.52,861.52
4215,29052260,2023-02-10,117.25,978.77
4216,29061354,2023-01-31,,180.47
4217,29061354,2023-02-05,2.25,182.72
4218,29061354,2023-02-07,92.81,275.53
4219,29061354,2023-02-11,667.1,942.63
4220,29061354,2023-02-11,-54.28,888.35
4221,29074095,2023-01-31,,512.38
4222,29074095,2023-02-01,86.91,599.29
4223,29074095,2023-02-02,-924.0,-324.71000000000004
4224,29074095,2023-02-07,-164.85,-489.56000000000006
4225,29074095,2023-02-11,-87.14,-576.7
4226,29074095,2023-02-12,-110.14,-686.84
4227,29074095,2023-02-13,184.92,-501.9200000000001
4228,29074095,2023-02-13,-65.54,-567.46
4229,29222005,2023-01-31,,0.34
4230,29222005,2023-02-03,98.53,98.87
4231,29222005,2023-02-05,-109.63,-10.759999999999991
4232,29222005,2023-02-05,-119.42,-130.18
4233,29222005,2023-02-07,80.36,-49.81999999999999
4234,29222005,2023-02-12,94.0,44.18000000000001
4235,29238925,2023-01-31,,574.82
4236,29238925,2023-02-04,2.44,577.2600000000001
4237,29238925,2023-02-09,47.07,624.33
4238,29238925,2023-02-11,-887.8,-263.4699999999999
4239,29238925,2023-02-14,-956.2,-1219.67
4240,29288598,2023-01-31,,386.76
4241,29288598,2023-02-03,201.14,587.9
4242,29288598,2023-02-04,-84.15,503.75
4243,29288598,2023-02-06,74.62,578.37
4244,29288598,2023-02-07,109.13,687.5
4245,29288598,2023-02-08,265.04,952.54
4246,29288598,2023-02-11,-142.47,810.0699999999999
4247,29288598,2023-02-13,-137.35,672.72
4248,29288598,2023-02-14,1295.6,1968.32
4249,29288598,2023-02-14,143.6,2111.92
4250,29303323,2023-01-31,,525.6
4251,29303323,2023-02-02,-103.75,421.85
4252,29303323,2023-02-02,-143.82,278.03000000000003
4253,29303323,2023-02-03,136.61,414.64000000000004
4254,29303323,2023-02-04,136.51,551.1500000000001
4255,29303323,2023-02-09,1301.5,1852.65
4256,29303323,2023-02-09,-142.5,1710.15
4257,29303323,2023-02-13,185.87,1896.02
4258,29303323,2023-02-13,126.86,2022.88
4259,29358670,2023-01-31,,874.94
4260,29358670,2023-02-01,92.86,967.8000000000001
4261,29358670,2023-02-06,173.92,1141.72
4262,29358670,2023-02-08,-50.38,1091.34
4263,29358670,2023-02-08,-120.57,970.77
4264,29358670,2023-02-09,105.57,1076.3400000000001
4265,29358670,2023-02-09,-83.38,992.96
4266,29358670,2023-02-11,121.51,1114.47
4267,29358670,2023-02-11,86.69,1201.16
4268,29358670,2023-02-12,-1183.8,17.360000000000127
4269,29358670,2023-02-13,-56.85,-39.489999999999874
4270,29422349,2023-01-31,,623.61
4271,29422349,2023-02-08,91.11,714.72
4272,29422349,2023-02-10,144.27,858.99
4273,29422349,2023-02-13,-145.83,713.16
4274,29464742,2023-01-31,,557.11
4275,29464742,2023-02-02,86.31,643.4200000000001
4276,29464742,2023-02-07,211.77,855.19
4277,29464742,2023-02-08,-92.83,762.36
4278,29464742,2023-02-14,-147.24,615.12
4279,29473763,2023-01-31,,724.82
4280,29473763,2023-02-05,-80.66,644.1600000000001
4281,29473763,2023-02-08,144.06,788.22
4282,29473763,2023-02-14,-141.21,647.01
4283,29489865,2023-01-31,,854.53
4284,29489865,2023-02-03,-109.66,744.87
4285,29489865,2023-02-06,114.3,859.17
4286,29489865,2023-02-10,-169.47,689.7
4287,29489865,2023-02-11,29.25,718.95
4288,29489865,2023-02-11,-82.38,636.5699999999999
4289,29489865,2023-02-14,122.97,759.54
4290,29523226,2023-01-31,,807.56
4291,29523226,2023-02-01,102.6,910.16
4292,29523226,2023-02-03,68.85,979.01
4293,29523226,2023-02-03,-48.79,930.2199999999999
4294,29523226,2023-02-05,191.47,1121.69
4295,29523226,2023-02-05,-73.99,1047.7
4296,29523226,2023-02-05,-90.06,957.64
4297,29523226,2023-02-06,58.71,1016.3499999999999
4298,29523226,2023-02-06,-134.96,881.3899999999999
4299,29523226,2023-02-08,-83.33,798.06
4300,29523226,2023-02-09,254.92,1052.98
4301,29523226,2023-02-10,-83.94,969.04
4302,29523226,2023-02-13,63.08,1032.12
4303,29523226,2023-02-13,25.85,1057.9699999999998
4304,29527534,2023-01-31,,355.57
4305,29527534,2023-02-03,-122.97,232.6
4306,29527534,2023-02-04,99.39,331.99
4307,29527534,2023-02-10,-148.63,183.36
4308,29527534,2023-02-11,86.28,269.64
4309,29608056,2023-01-31,,248.43
4310,29608056,2023-02-03,61.91,310.34000000000003
4311,29608056,2023-02-03,-105.92,204.42000000000002
4312,29608056,2023-02-06,86.9,291.32
4313,29608056,2023-02-06,-115.19,176.13
4314,29608056,2023-02-07,-1610.4,-1434.27
4315,29608056,2023-02-11,-131.8,-1566.07
4316,29608056,2023-02-12,134.36,-1431.71
4317,29608056,2023-02-12,126.97,-1304.74
4318,29608056,2023-02-12,96.87,-1207.87
4319,29608056,2023-02-12,51.66,-1156.21
4320,29631870,2023-01-31,,694.99
4321,29631870,2023-02-02,1138.0,1832.99
4322,29631870,2023-02-02,78.61,1911.6
4323,29631870,2023-02-04,68.54,1980.14
4324,29631870,2023-02-04,-74.21,1905.93
4325,29631870,2023-02-12,113.45,2019.38
4326,29631870,2023-02-14,-90.07,1929.31
4327,29638033,2023-01-31,,537.95
4328,29638033,2023-02-01,-129.52,408.43000000000006
4329,29638033,2023-02-01,-1775.6,-1367.1699999999998
4330,29638033,2023-02-02,-1890.0,-3257.17
4331,29638033,2023-02-03,-103.79,-3360.96
4332,29638033,2023-02-08,-40.08,-3401.04
4333,29638033,2023-02-11,-89.5,-3490.54
4334,29638033,2023-02-12,122.32,-3368.22
4335,29638033,2023-02-14,-134.42,-3502.64
4336,29639626,2023-01-31,,985.7
4337,29639626,2023-02-04,-112.65,873.0500000000001
4338,29639626,2023-02-05,135.88,1008.9300000000001
4339,29639626,2023-02-06,-58.79,950.14
4340,29639626,2023-02-10,103.67,1053.81
4341,29639626,2023-02-10,-15.25,1038.56
4342,29639626,2023-02-13,41.85,1080.41
4343,29639626,2023-02-13,-163.71,916.7
4344,29705419,2023-01-31,,799.07
4345,29705419,2023-02-02,89.88,888.95
4346,29705419,2023-02-03,62.89,951.84
4347,29705419,2023-02-03,-749.7,202.14
4348,29705419,2023-02-06,149.08,351.22
4349,29705419,2023-02-08,133.54,484.76
4350,29705419,2023-02-09,-99.59,385.16999999999996
4351,29705419,2023-02-13,-105.96,279.21
4352,29878790,2023-01-31,,360.74
4353,29878790,2023-02-13,-94.19,266.55
4354,29887258,2023-01-31,,392.91
4355,29887258,2023-02-05,103.8,496.71000000000004
4356,29887258,2023-02-08,-17.63,479.08000000000004
4357,29887258,2023-02-13,-157.09,321.99
4358,29887258,2023-02-14,175.07,497.06
4359,29887258,2023-02-14,122.47,619.53
4360,29920698,2023-01-31,,922.07
4361,29920698,2023-02-02,-108.09,813.98
4362,29920698,2023-02-04,47.33,861.3100000000001
4363,29920698,2023-02-04,45.53,906.84
4364,29920698,2023-02-05,-1475.4,-568.5600000000001
4365,29920698,2023-02-08,77.84,-490.72
4366,29920698,2023-02-13,86.2,-404.52000000000004
4367,29958061,2023-01-31,,17.43
4368,29958061,2023-02-01,93.28,110.71000000000001
4369,29958061,2023-02-02,103.39,214.10000000000002
4370,29958061,2023-02-02,-28.3,185.8
4371,29958061,2023-02-03,167.61,353.41
4372,29958061,2023-02-04,115.56,468.97
4373,29958061,2023-02-07,183.11,652.08
4374,29958061,2023-02-08,-104.32,547.76
4375,29958061,2023-02-12,614.4,1162.16
4376,30030650,2023-01-31,,414.27
4377,30030650,2023-02-06,96.15,510.41999999999996
4378,30030650,2023-02-07,-99.74,410.68
4379,30030650,2023-02-08,140.45,551.13
4380,30030650,2023-02-08,79.57,630.7
4381,30030650,2023-02-13,-23.8,606.9
4382,30058030,2023-01-31,,39.21
4383,30058030,2023-02-02,-68.18,-28.970000000000006
4384,30058030,2023-02-03,106.54,77.57
4385,30058030,2023-02-12,89.64,167.21
4386,30058030,2023-02-12,37.7,204.91000000000003
4387,30058030,2023-02-14,69.27,274.18
4388,30058030,2023-02-14,-823.0,-548.8199999999999
4389,30093672,2023-01-31,,939.77
4390,30093672,2023-02-04,121.83,1061.6
4391,30093672,2023-02-05,62.74,1124.34
4392,30093672,2023-02-06,34.09,1158.43
4393,30093672,2023-02-06,-79.32,1079.11
4394,30093672,2023-02-08,-1002.0,77.11000000000001
4395,30093672,2023-02-09,7.12,84.23000000000002
4396,30093672,2023-02-10,-142.07,-57.839999999999975
4397,30093672,2023-02-11,108.41,50.57000000000002
4398,30093672,2023-02-12,-129.0,-78.42999999999998
4399,30110747,2023-01-31,,949.76
4400,30110747,2023-02-01,98.39,1048.15
4401,30110747,2023-02-03,-158.58,889.5699999999999
4402,30110747,2023-02-03,-225.89,663.6800000000001
4403,30110747,2023-02-06,70.1,733.78
4404,30110747,2023-02-07,69.34,803.12
4405,30110747,2023-02-10,-37.83,765.29
4406,30110747,2023-02-13,143.14,908.4300000000001
4407,30112323,2023-01-31,,519.73
4408,30112323,2023-02-01,99.68,619.4100000000001
4409,30112323,2023-02-01,38.91,658.32
4410,30112323,2023-02-01,-12.31,646.01
4411,30112323,2023-02-04,-136.46,509.55
4412,30112323,2023-02-07,-27.47,482.08000000000004
4413,30112323,2023-02-08,-1379.8,-897.7199999999999
4414,30112323,2023-02-09,1504.7,606.9800000000001
4415,30112323,2023-02-14,-117.3,489.6800000000001
4416,30196319,2023-01-31,,721.4
4417,30196319,2023-02-01,-32.39,689.01
4418,30196319,2023-02-06,125.2,814.21
4419,30196319,2023-02-09,-118.21,696.0
4420,30196319,2023-02-10,-95.98,600.02
4421,30227774,2023-01-31,,546.85
4422,30227774,2023-02-01,-99.3,447.55
4423,30227774,2023-02-05,46.86,494.41
4424,30227774,2023-02-09,89.75,584.1600000000001
4425,30227774,2023-02-11,-146.03,438.13
4426,30235398,2023-01-31,,973.95
4427,30235398,2023-02-02,54.94,1028.89
4428,30235398,2023-02-02,-122.38,906.51
4429,30235398,2023-02-13,-63.08,843.4300000000001
4430,30237685,2023-01-31,,751.93
4431,30237685,2023-02-06,-189.18,562.75
4432,30237685,2023-02-10,831.4,1394.1499999999999
4433,30237685,2023-02-12,95.25,1489.3999999999999
4434,30279114,2023-01-31,,951.13
4435,30279114,2023-02-01,144.31,1095.44
4436,30279114,2023-02-02,-231.9,863.54
4437,30279114,2023-02-08,-66.97,796.5699999999999
4438,30279114,2023-02-09,-210.8,585.77
4439,30312615,2023-01-31,,659.36
4440,30312615,2023-02-05,-1852.7,-1193.3400000000001
4441,30312615,2023-02-06,77.23,-1116.11
4442,30312615,2023-02-07,-116.04,-1232.1499999999999
4443,30312615,2023-02-12,443.1,-789.05
4444,30312615,2023-02-12,-158.57,-947.6199999999999
4445,30312615,2023-02-13,-136.9,-1084.52
4446,30324819,2023-01-31,,823.45
4447,30324819,2023-02-02,469.3,1292.75
4448,30324819,2023-02-03,157.15,1449.9
4449,30324819,2023-02-05,-130.7,1319.2
4450,30324819,2023-02-05,-141.51,1177.69
4451,30340808,2023-01-31,,895.41
4452,30340808,2023-02-03,-123.39,772.02
4453,30340808,2023-02-06,-64.83,707.1899999999999
4454,30340808,2023-02-07,-121.9,585.29
4455,30340808,2023-02-14,-1660.2,-1074.91
4456,30372316,2023-01-31,,189.39
4457,30372316,2023-02-02,-179.4,9.98999999999998
4458,30372316,2023-02-08,151.99,161.98
4459,30372316,2023-02-08,-78.98,82.99999999999999
4460,30372316,2023-02-09,1216.6,1299.6
4461,30372316,2023-02-09,-953.9,345.69999999999993
4462,30372316,2023-02-11,40.81,386.50999999999993
4463,30372316,2023-02-13,-102.23,284.2799999999999
4464,30372316,2023-02-14,-0.43,283.8499999999999
4465,30374840,2023-01-31,,564.42
4466,30374840,2023-02-03,-96.42,467.99999999999994
4467,30374840,2023-02-03,-1278.2,-810.2
4468,30374840,2023-02-07,204.81,-605.3900000000001
4469,30374840,2023-02-07,143.62,-461.77000000000004
4470,30374840,2023-02-08,107.7,-354.07000000000005
4471,30374840,2023-02-08,-38.13,-392.20000000000005
4472,30374840,2023-02-10,-1585.0,-1977.2
4473,30396291,2023-01-31,,803.37
4474,30396291,2023-02-03,199.09,1002.46
4475,30396291,2023-02-03,-610.8,391.6600000000001
4476,30396291,2023-02-06,-99.42,292.24000000000007
4477,30396291,2023-02-06,-100.05,192.19000000000008
4478,30409599,2023-01-31,,117.47
4479,30409599,2023-02-03,174.62,292.09000000000003
4480,30409599,2023-02-05,51.26,343.35
4481,30409599,2023-02-07,180.63,523.98
4482,30409599,2023-02-08,109.72,633.7
4483,30409599,2023-02-10,-28.25,605.45
4484,30409599,2023-02-14,867.5,1472.95
4485,30428666,2023-01-31,,393.33
4486,30428666,2023-02-04,-150.02,243.30999999999997
4487,30428666,2023-02-05,-29.05,214.25999999999996
4488,30428666,2023-02-07,-66.67,147.58999999999997
4489,30428666,2023-02-11,40.71,188.29999999999998
4490,30484027,2023-01-31,,272.71
4491,30484027,2023-02-01,127.65,400.36
4492,30484027,2023-02-03,-116.69,283.66999999999996
4493,30484027,2023-02-05,78.67,362.34
4494,30484027,2023-02-09,-10.45,351.89
4495,30484027,2023-02-12,-76.6,275.28999999999996
4496,30484027,2023-02-12,-127.83,147.45999999999998
4497,30511779,2023-01-31,,772.02
4498,30511779,2023-02-02,179.94,951.96
4499,30511779,2023-02-07,71.18,1023.14
4500,30511779,2023-02-08,106.87,1130.01
4501,30511779,2023-02-10,67.41,1197.42
4502,30511779,2023-02-11,114.77,1312.19
4503,30511779,2023-02-11,58.01,1370.2
4504,30518350,2023-01-31,,490.85
4505,30518350,2023-02-06,1498.3,1989.15
4506,30518350,2023-02-11,-19.24,1969.9099999999999
4507,30557885,2023-01-31,,615.82
4508,30557885,2023-02-05,-678.7,-62.879999999999995
4509,30565855,2023-01-31,,982.05
4510,30565855,2023-02-05,1292.8,2274.85
4511,30565855,2023-02-09,-51.68,2223.17
4512,30565855,2023-02-11,-121.33,2101.84
4513,30565855,2023-02-13,70.54,2172.38
4514,30565855,2023-02-14,483.2,2655.58
4515,30623117,2023-01-31,,266.92
4516,30623117,2023-02-04,-125.73,141.19
4517,30623117,2023-02-09,-1169.4,-1028.21
4518,30623117,2023-02-11,-38.74,-1066.95
4519,30623117,2023-02-11,-111.11,-1178.06
4520,30623117,2023-02-14,154.58,-1023.48
4521,30623117,2023-02-14,77.33,-946.15
4522,30623117,2023-02-14,-159.03,-1105.18
4523,30647433,2023-01-31,,632.2
4524,30647433,2023-02-02,-224.91,407.2900000000001
4525,30647433,2023-02-03,-474.7,-67.40999999999997
4526,30647433,2023-02-04,-15.32,-82.72999999999996
4527,30647433,2023-02-05,-100.81,-183.53999999999996
4528,30647433,2023-02-07,80.19,-103.34999999999997
4529,30647433,2023-02-07,-39.09,-142.43999999999997
4530,30647433,2023-02-10,104.39,-38.04999999999997
4531,30657838,2023-01-31,,468.82
4532,30657838,2023-02-01,2239.3,2708.1200000000003
4533,30657838,2023-02-01,-91.95,2616.1700000000005
4534,30657838,2023-02-03,-139.16,2477.01
4535,30657838,2023-02-04,124.06,2601.07
4536,30657838,2023-02-05,539.8,3140.8700000000003
4537,30657838,2023-02-05,-161.8,2979.07
4538,30657838,2023-02-06,90.98,3070.05
4539,30657838,2023-02-06,-52.94,3017.11
4540,30657838,2023-02-08,84.11,3101.2200000000003
4541,30657838,2023-02-09,69.33,3170.55
4542,30657838,2023-02-11,152.76,3323.3100000000004
4543,30671754,2023-01-31,,621.9
4544,30671754,2023-02-04,-133.3,488.59999999999997
4545,30671754,2023-02-07,5.07,493.66999999999996
4546,30672740,2023-01-31,,355.33
4547,30672740,2023-02-02,187.4,542.73
4548,30672740,2023-02-06,126.49,669.22
4549,30672740,2023-02-07,46.51,715.73
4550,30672740,2023-02-11,1949.6,2665.33
4551,30672740,2023-02-13,-106.6,2558.73
4552,30688447,2023-01-31,,555.31
4553,30688447,2023-02-03,-137.98,417.3299999999999
4554,30688447,2023-02-05,-160.67,256.65999999999997
4555,30688447,2023-02-06,81.99,338.65
4556,30688447,2023-02-10,-162.32,176.32999999999998
4557,30688447,2023-02-14,-101.76,74.56999999999998
4558,30718836,2023-01-31,,360.78
4559,30718836,2023-02-01,186.89,547.67
4560,30718836,2023-02-01,-76.9,470.77
4561,30718836,2023-02-03,-133.1,337.66999999999996
4562,30718836,2023-02-04,58.09,395.76
4563,30718836,2023-02-06,-110.26,285.49999999999994
4564,30718836,2023-02-07,-16.27,269.22999999999996
4565,30718836,2023-02-08,-1127.4,-858.1700000000001
4566,30718836,2023-02-09,51.68,-806.4900000000001
4567,30718836,2023-02-11,64.55,-741.94
4568,30718836,2023-02-13,-75.16,-817.1000000000001
4569,30723991,2023-01-31,,310.02
4570,30723991,2023-02-02,86.69,396.71
4571,30723991,2023-02-03,138.68,535.39
4572,30723991,2023-02-07,-95.78,439.61
4573,30758515,2023-01-31,,35.74
4574,30758515,2023-02-01,102.39,138.13
4575,30758515,2023-02-02,61.09,199.22000000000003
4576,30758515,2023-02-13,183.43,382.65000000000003
4577,30760024,2023-01-31,,766.43
4578,30760024,2023-02-02,-77.14,689.29
4579,30760024,2023-02-03,-38.61,650.68
4580,30760024,2023-02-09,83.26,733.9399999999999
4581,30791105,2023-01-31,,272.5
4582,30791105,2023-02-02,192.77,465.27
4583,30791105,2023-02-04,-113.62,351.65
4584,30791105,2023-02-06,102.01,453.66
4585,30791105,2023-02-06,-112.33,341.33000000000004
4586,30791105,2023-02-10,179.95,521.28
4587,30791105,2023-02-11,107.01,628.29
4588,30929422,2023-01-31,,161.53
4589,30929422,2023-02-01,-120.93,40.599999999999994
4590,30929422,2023-02-01,-159.64,-119.03999999999999
4591,30929422,2023-02-07,82.91,-36.129999999999995
4592,30929422,2023-02-08,-23.59,-59.72
4593,30929422,2023-02-08,-113.42,-173.14
4594,30929422,2023-02-11,-38.37,-211.51
4595,30929422,2023-02-12,-76.48,-287.99
4596,30929422,2023-02-13,-113.91,-401.9
4597,30970897,2023-01-31,,57.17
4598,30970897,2023-02-01,-141.6,-84.42999999999999
4599,30970897,2023-02-03,-110.54,-194.97
4600,30970897,2023-02-03,-115.62,-310.59000000000003
4601,30970897,2023-02-04,-116.66,-427.25
4602,30970897,2023-02-05,201.75,-225.5
4603,30970897,2023-02-07,-141.27,-366.77
4604,30970897,2023-02-09,-113.36,-480.13
4605,30970897,2023-02-09,-157.3,-637.4300000000001
4606,30970897,2023-02-12,27.9,-609.53
4607,30970897,2023-02-13,100.5,-509.03
4608,30977834,2023-01-31,,203.99
4609,30977834,2023-02-02,175.73,379.72
4610,30977834,2023-02-04,686.5,1066.22
4611,30977834,2023-02-04,-175.99,890.23
4612,30977834,2023-02-05,-35.3,854.9300000000001
4613,30977834,2023-02-07,-86.46,768.47
4614,30977834,2023-02-07,-87.82,680.6500000000001
4615,30977834,2023-02-10,67.29,747.94
4616,30977834,2023-02-12,45.23,793.1700000000001
4617,30979429,2023-01-31,,414.1
4618,30979429,2023-02-01,-70.34,343.76
4619,30979429,2023-02-02,-865.4,-521.64
4620,30979429,2023-02-03,866.1,344.46000000000004
4621,30979429,2023-02-05,104.27,448.73
4622,30979429,2023-02-09,-160.06,288.67
4623,30979429,2023-02-11,35.07,323.74
4624,30979429,2023-02-12,-78.65,245.09
4625,30990911,2023-01-31,,997.59
4626,30990911,2023-02-02,-144.05,853.54
4627,30990911,2023-02-04,170.56,1024.1
4628,30990911,2023-02-04,-173.9,850.2
4629,30990911,2023-02-07,-124.86,725.34
4630,30990911,2023-02-08,132.2,857.54
4631,30990911,2023-02-11,-106.4,751.14
4632,31026801,2023-01-31,,85.36
4633,31026801,2023-02-01,52.99,138.35
4634,31026801,2023-02-06,-99.14,39.21000000000001
4635,31026801,2023-02-07,-102.26,-63.05
4636,31026801,2023-02-08,-47.58,-110.63
4637,31026801,2023-02-11,-62.33,-172.95999999999998
4638,31131351,2023-01-31,,278.94
4639,31131351,2023-02-04,786.1,1065.04
4640,31131351,2023-02-04,262.0,1327.04
4641,31131351,2023-02-04,98.42,1425.46
4642,31131351,2023-02-06,29.95,1455.41
4643,31131351,2023-02-06,-1124.1,331.3100000000002
4644,31131351,2023-02-08,104.01,435.32000000000016
4645,31131351,2023-02-09,-158.52,276.8000000000002
4646,31131351,2023-02-12,-224.14,52.660000000000196
4647,31150830,2023-01-31,,36.16
4648,31150830,2023-02-01,-161.85,-125.69
4649,31150830,2023-02-02,128.71,3.0200000000000102
4650,31150830,2023-02-02,126.12,129.14000000000001
4651,31150830,2023-02-05,-61.68,67.46000000000001
4652,31150830,2023-02-06,52.31,119.77000000000001
4653,31150830,2023-02-07,-435.8,-316.03
4654,31150830,2023-02-09,-55.88,-371.91
4655,31150830,2023-02-09,-70.29,-442.20000000000005
4656,31150830,2023-02-11,-84.45,-526.6500000000001
4657,31158381,2023-01-31,,514.96
4658,31158381,2023-02-01,223.94,738.9000000000001
4659,31158381,2023-02-01,139.18,878.08
4660,31158381,2023-02-07,80.94,959.02
4661,31158381,2023-02-08,-132.45,826.57
4662,31158381,2023-02-13,-131.36,695.21
4663,31183587,2023-01-31,,725.0
4664,31183587,2023-02-02,-36.32,688.68
4665,31183587,2023-02-03,-19.31,669.37
4666,31183587,2023-02-05,1152.5,1821.87
4667,31183587,2023-02-08,-952.0,869.8699999999999
4668,31183587,2023-02-12,221.72,1091.59
4669,31183587,2023-02-12,112.63,1204.2199999999998
4670,31183587,2023-02-13,-76.49,1127.7299999999998
4671,31183587,2023-02-13,-117.77,1009.9599999999999
4672,31187024,2023-01-31,,950.41
4673,31187024,2023-02-02,-105.52,844.89
4674,31187024,2023-02-03,-49.39,795.5
4675,31187024,2023-02-04,-125.25,670.25
4676,31187024,2023-02-06,154.42,824.67
4677,31187024,2023-02-08,71.81,896.48
4678,31187024,2023-02-08,-537.9,358.5799999999999
4679,31187024,2023-02-10,782.2,1140.78
4680,31187024,2023-02-10,-163.18,977.5999999999999
4681,31263913,2023-01-31,,267.5
4682,31263913,2023-02-01,-48.78,218.72
4683,31263913,2023-02-02,-133.38,85.34
4684,31263913,2023-02-06,84.46,169.8
4685,31319183,2023-01-31,,407.92
4686,31319183,2023-02-06,-95.11,312.81
4687,31319183,2023-02-08,58.82,371.63
4688,31319183,2023-02-09,-151.22,220.41000000000003
4689,31319183,2023-02-10,60.41,280.82000000000005
4690,31319183,2023-02-12,104.9,385.72
4691,31319183,2023-02-12,-63.33,322.39000000000004
4692,31319183,2023-02-13,126.66,449.05
4693,31335654,2023-01-31,,217.33
4694,31335654,2023-02-02,125.99,343.32
4695,31335654,2023-02-07,146.82,490.14
4696,31335654,2023-02-10,88.62,578.76
4697,31335654,2023-02-10,87.63,666.39
4698,31335654,2023-02-12,1192.7,1859.0900000000001
4699,31367758,2023-01-31,,536.16
4700,31367758,2023-02-01,89.01,625.17
4701,31367758,2023-02-08,96.58,721.75
4702,31367758,2023-02-10,835.9,1557.65
4703,31367758,2023-02-13,107.55,1665.2
4704,31392168,2023-01-31,,615.42
4705,31392168,2023-02-05,-177.67,437.75
4706,31392168,2023-02-08,170.98,608.73
4707,31392168,2023-02-10,143.84,752.5699999999999
4708,31392168,2023-02-13,44.2,796.77
4709,31525756,2023-01-31,,363.68
4710,31525756,2023-02-01,81.02,444.7
4711,31525756,2023-02-07,146.76,591.46
4712,31525756,2023-02-12,-128.32,463.14
4713,31525756,2023-02-13,-41.85,421.28999999999996
4714,31525756,2023-02-13,-75.56,345.73
4715,31537778,2023-01-31,,335.19
4716,31537778,2023-02-01,-36.43,298.76
4717,31537778,2023-02-14,118.75,417.51
4718,31541158,2023-01-31,,215.94
4719,31541158,2023-02-07,-107.79,108.14999999999999
4720,31541158,2023-02-09,120.47,228.62
4721,31541158,2023-02-09,73.6,302.21999999999997
4722,31541158,2023-02-13,-110.17,192.04999999999998
4723,31557275,2023-01-31,,362.05
4724,31557275,2023-02-02,-162.35,199.70000000000002
4725,31557275,2023-02-05,-63.32,136.38000000000002
4726,31557275,2023-02-09,86.86,223.24
4727,31557275,2023-02-11,-166.3,56.94
4728,31557275,2023-02-14,59.81,116.75
4729,31589468,2023-01-31,,713.44
4730,31589468,2023-02-01,-78.07,635.3700000000001
4731,31589468,2023-02-01,-807.2,-171.82999999999993
4732,31589468,2023-02-03,117.46,-54.36999999999993
4733,31589468,2023-02-10,142.13,87.76000000000006
4734,31589468,2023-02-14,-77.69,10.070000000000064
4735,31594938,2023-01-31,,486.88
4736,31594938,2023-02-02,-72.9,413.98
4737,31594938,2023-02-02,-206.91,207.07
4738,31594938,2023-02-03,49.54,256.61
4739,31594938,2023-02-05,230.5,487.11
4740,31594938,2023-02-06,-77.22,409.89
4741,31594938,2023-02-06,-131.96,277.92999999999995
4742,31594938,2023-02-10,-47.87,230.05999999999997
4743,31594938,2023-02-14,-90.86,139.2
4744,31595213,2023-01-31,,418.35
4745,31595213,2023-02-02,184.44,602.79
4746,31595213,2023-02-03,-110.43,492.36
4747,31595213,2023-02-04,128.21,620.57
4748,31595213,2023-02-10,80.77,701.34
4749,31595213,2023-02-12,-122.61,578.73
4750,31595213,2023-02-14,172.38,751.11
4751,31661113,2023-01-31,,309.32
4752,31661113,2023-02-02,68.17,377.49
4753,31661113,2023-02-10,102.92,480.40999999999997
4754,31661113,2023-02-10,11.31,491.71999999999997
4755,31661113,2023-02-13,16.59,508.31
4756,31670977,2023-01-31,,385.42
4757,31670977,2023-02-02,-1520.8,-1135.3799999999999
4758,31670977,2023-02-04,133.3,-1002.0799999999999
4759,31670977,2023-02-08,10.05,-992.0299999999999
4760,31670977,2023-02-14,-87.61,-1079.6399999999999
4761,31680976,2023-01-31,,327.79
4762,31680976,2023-02-01,-82.09,245.70000000000002
4763,31680976,2023-02-05,-65.73,179.97000000000003
4764,31680976,2023-02-06,470.6,650.57
4765,31680976,2023-02-08,362.6,1013.1700000000001
4766,31680976,2023-02-10,-69.68,943.49
4767,31680976,2023-02-10,-115.98,827.5100000000001
4768,31680976,2023-02-11,-1125.0,-297.4899999999999
4769,31680976,2023-02-14,149.9,-147.5899999999999
4770,31689747,2023-01-31,,907.21
4771,31689747,2023-02-01,104.57,1011.78
4772,31689747,2023-02-02,-177.5,834.28
4773,31689747,2023-02-04,89.19,923.47
4774,31689747,2023-02-04,19.13,942.6
4775,31689747,2023-02-04,-41.77,900.83
4776,31689747,2023-02-06,-101.84,798.99
4777,31689747,2023-02-07,-107.26,691.73
4778,31689747,2023-02-09,171.71,863.44
4779,31693244,2023-01-31,,311.41
4780,31693244,2023-02-02,-145.85,165.56000000000003
4781,31693244,2023-02-03,49.16,214.72000000000003
4782,31693244,2023-02-08,-96.95,117.77000000000002
4783,31693244,2023-02-08,-710.3,-592.53
4784,31693244,2023-02-10,81.43,-511.09999999999997
4785,31693244,2023-02-13,-126.46,-637.56
4786,31693244,2023-02-13,-155.44,-793.0
4787,31693244,2023-02-14,-73.36,-866.3599999999999
4788,31759645,2023-01-31,,43.92
4789,31759645,2023-02-01,162.02,205.94
4790,31759645,2023-02-02,-482.7,-276.75999999999993
4791,31759645,2023-02-04,-104.15,-380.90999999999997
4792,31759645,2023-02-06,123.09,-257.81999999999994
4793,31759645,2023-02-06,57.88,-199.93999999999994
4794,31759645,2023-02-07,-169.21,-369.15
4795,31759645,2023-02-08,79.06,-290.0899999999999
4796,31759645,2023-02-08,-163.97,-454.05999999999995
4797,31759645,2023-02-09,-33.72,-487.78
4798,31759645,2023-02-09,-110.83,-598.6099999999999
4799,31759645,2023-02-10,-150.77,-749.3799999999999
4800,31770323,2023-01-31,,666.66
4801,31770323,2023-02-07,-74.35,592.31
4802,31770323,2023-02-07,-1002.5,-410.19000000000005
4803,31770323,2023-02-11,60.05,-350.14000000000004
4804,31770323,2023-02-12,147.45,-202.69000000000005
4805,31770323,2023-02-12,73.94,-128.75000000000006
4806,31770323,2023-02-13,109.06,-19.690000000000055
4807,31770323,2023-02-13,-181.51,-201.20000000000005
4808,31774984,2023-01-31,,964.57
4809,31774984,2023-02-01,127.57,1092.14
4810,31774984,2023-02-04,121.49,1213.63
4811,31774984,2023-02-08,164.7,1378.33
4812,31774984,2023-02-09,127.38,1505.71
4813,31774984,2023-02-09,-139.86,1365.85
4814,31774984,2023-02-11,139.2,1505.05
4815,31826534,2023-01-31,,541.64
4816,31826534,2023-02-02,-95.44,446.2
4817,31826534,2023-02-07,155.12,601.3199999999999
4818,31826534,2023-02-10,-104.86,496.46
4819,31826534,2023-02-11,-85.0,411.46
4820,31826534,2023-02-14,615.6,1027.06
4821,31830289,2023-01-31,,816.55
4822,31830289,2023-02-01,44.29,860.8399999999999
4823,31830289,2023-02-06,-154.47,706.3699999999999
4824,31830289,2023-02-14,201.77,908.14
4825,31873155,2023-01-31,,351.03
4826,31873155,2023-02-02,27.44,378.46999999999997
4827,31873155,2023-02-02,-123.2,255.26999999999998
4828,31873155,2023-02-04,214.78,470.04999999999995
4829,31873155,2023-02-06,-107.54,362.50999999999993
4830,31873155,2023-02-08,-176.94,185.56999999999994
4831,31873155,2023-02-11,111.88,297.44999999999993
4832,31873155,2023-02-12,-9.9,287.54999999999995
4833,31957459,2023-01-31,,758.69
4834,31957459,2023-02-01,98.52,857.21
4835,31957459,2023-02-03,89.23,946.44
4836,31957459,2023-02-03,67.03,1013.47
4837,31957459,2023-02-03,-113.46,900.0100000000001
4838,31957459,2023-02-06,-104.66,795.35
4839,31957459,2023-02-08,10.58,805.9300000000001
4840,31957459,2023-02-08,-92.54,713.3900000000001
4841,31957459,2023-02-10,-97.29,616.1
4842,31978646,2023-01-31,,393.51
4843,31978646,2023-02-05,-172.62,220.89
4844,31978646,2023-02-06,189.18,410.07
4845,31978646,2023-02-09,-50.02,360.05
4846,31978646,2023-02-10,89.99,450.03999999999996
4847,31978646,2023-02-11,112.56,562.6
4848,32019304,2023-01-31,,961.49
4849,32019304,2023-02-01,156.79,1118.28
4850,32019304,2023-02-01,-200.4,917.88
4851,32019304,2023-02-02,109.57,1027.45
4852,32019304,2023-02-08,83.96,1111.41
4853,32019304,2023-02-10,32.99,1144.4
4854,32019304,2023-02-11,-109.66,1034.74
4855,32019304,2023-02-13,98.9,1133.6399999999999
4856,32084810,2023-01-31,,610.7
4857,32084810,2023-02-02,-167.22,443.48
4858,32084810,2023-02-03,-124.8,318.68000000000006
4859,32084810,2023-02-05,-23.02,295.66
4860,32084810,2023-02-06,-16.67,278.99000000000007
4861,32084810,2023-02-08,-67.6,211.39000000000004
4862,32084810,2023-02-12,-67.02,144.37000000000006
4863,32092491,2023-01-31,,51.82
4864,32092491,2023-02-01,126.01,177.83
4865,32092491,2023-02-02,101.15,278.98
4866,32092491,2023-02-03,48.48,327.46
4867,32092491,2023-02-07,186.23,513.69
4868,32092491,2023-02-09,65.15,578.84
4869,32092491,2023-02-10,400.1,978.94
4870,32092491,2023-02-14,-137.92,841.0200000000001
4871,32092491,2023-02-14,-349.1,491.9200000000001
4872,32092491,2023-02-14,-1401.8,-909.8799999999999
4873,32109414,2023-01-31,,967.31
4874,32109414,2023-02-01,116.27,1083.58
4875,32109414,2023-02-05,-119.48,964.0999999999999
4876,32109414,2023-02-12,62.68,1026.78
4877,32109414,2023-02-13,-109.06,917.7199999999999
4878,32131123,2023-01-31,,758.69
4879,32131123,2023-02-04,16.51,775.2
4880,32131123,2023-02-10,-96.17,679.0300000000001
4881,32131123,2023-02-11,-132.94,546.09
4882,32192958,2023-01-31,,209.37
4883,32192958,2023-02-02,157.41,366.78
4884,32192958,2023-02-05,1625.6,1992.3799999999999
4885,32192958,2023-02-05,-139.75,1852.6299999999999
4886,32192958,2023-02-07,43.86,1896.4899999999998
4887,32192958,2023-02-11,148.04,2044.5299999999997
4888,32192958,2023-02-13,-52.19,1992.34
4889,32192958,2023-02-13,-1132.5,859.8399999999999
4890,32221529,2023-01-31,,887.75
4891,32221529,2023-02-06,120.6,1008.35
4892,32221529,2023-02-06,114.11,1122.46
4893,32221529,2023-02-07,120.64,1243.1
4894,32221529,2023-02-08,-48.19,1194.91
4895,32221529,2023-02-10,108.57,1303.48
4896,32221529,2023-02-11,45.67,1349.15
4897,32221529,2023-02-13,102.23,1451.38
4898,32221529,2023-02-13,-70.3,1381.08
4899,32221652,2023-01-31,,36.96
4900,32221652,2023-02-01,-1089.6,-1052.6399999999999
4901,32221652,2023-02-01,-1820.3,-2872.9399999999996
4902,32221652,2023-02-06,32.37,-2840.5699999999997
4903,32221652,2023-02-06,-92.29,-2932.8599999999997
4904,32221652,2023-02-07,591.2,-2341.66
4905,32221652,2023-02-08,-178.49,-2520.1499999999996
4906,32261620,2023-01-31,,55.43
4907,32261620,2023-02-01,787.2,842.63
4908,32261620,2023-02-02,179.4,1022.03
4909,32261620,2023-02-02,91.97,1114.0
4910,32261620,2023-02-03,126.64,1240.64
4911,32261620,2023-02-11,143.78,1384.42
4912,32261620,2023-02-13,-151.84,1232.58
4913,32261620,2023-02-13,-157.9,1074.68
4914,32275676,2023-01-31,,889.61
4915,32275676,2023-02-03,70.29,959.9
4916,32275676,2023-02-07,-173.35,786.55
4917,32275676,2023-02-09,119.17,905.72
4918,32275676,2023-02-14,70.03,975.75
4919,32308270,2023-01-31,,976.53
4920,32308270,2023-02-03,139.16,1115.69
4921,32308270,2023-02-05,-62.56,1053.1299999999999
4922,32308270,2023-02-09,11.67,1064.8
4923,32308270,2023-02-09,-1060.0,4.7999999999999545
4924,32312381,2023-01-31,,742.85
4925,32312381,2023-02-01,-96.77,646.08
4926,32312381,2023-02-11,134.09,780.1700000000001
4927,32312410,2023-01-31,,817.47
4928,32312410,2023-02-04,-89.58,727.89
4929,32370392,2023-01-31,,369.09
4930,32370392,2023-02-04,67.93,437.02
4931,32370392,2023-02-05,167.18,604.2
4932,32370392,2023-02-06,64.83,669.03
4933,32370392,2023-02-10,-133.46,535.5699999999999
4934,32370392,2023-02-12,-71.93,463.64
4935,32386770,2023-01-31,,639.45
4936,32386770,2023-02-01,-56.55,582.9000000000001
4937,32386770,2023-02-02,101.46,684.36
4938,32386770,2023-02-03,716.6,1400.96
4939,32386770,2023-02-03,-3.65,1397.31
4940,32386770,2023-02-05,1131.8,2529.1099999999997
4941,32386770,2023-02-06,72.25,2601.3599999999997
4942,32386770,2023-02-07,118.34,2719.7
4943,32386770,2023-02-07,-51.11,2668.5899999999997
4944,32386770,2023-02-11,178.01,2846.6
4945,32386770,2023-02-14,134.52,2981.12
4946,32390015,2023-01-31,,529.35
4947,32390015,2023-02-02,-147.44,381.91
4948,32390015,2023-02-04,-117.79,264.12
4949,32390015,2023-02-07,-83.34,180.78000000000003
4950,32390015,2023-02-08,-96.43,84.35000000000001
4951,32390015,2023-02-09,157.13,241.48000000000002
4952,32390015,2023-02-12,88.41,329.89
4953,32390015,2023-02-13,-80.09,249.8
4954,32390015,2023-02-13,-173.36,76.44
4955,32390015,2023-02-14,137.37,213.81
4956,32400822,2023-01-31,,987.34
4957,32400822,2023-02-08,-1808.4,-821.0600000000001
4958,32400822,2023-02-12,183.41,-637.6500000000001
4959,32400822,2023-02-14,-136.49,-774.1400000000001
4960,32408166,2023-01-31,,261.63
4961,32408166,2023-02-01,-65.12,196.51
4962,32408166,2023-02-01,-670.1,-473.59000000000003
4963,32408166,2023-02-02,62.78,-410.81000000000006
4964,32408166,2023-02-05,81.05,-329.76000000000005
4965,32408166,2023-02-05,-113.82,-443.58000000000004
4966,32408166,2023-02-06,-122.96,-566.54
4967,32408166,2023-02-11,173.97,-392.57000000000005
4968,32408166,2023-02-13,82.89,-309.68
4969,32424424,2023-01-31,,848.04
4970,32424424,2023-02-06,1751.6,2599.64
4971,32424424,2023-02-07,155.69,2755.33
4972,32424424,2023-02-08,-53.13,2702.2
4973,32424424,2023-02-08,-106.62,2595.58
4974,32424424,2023-02-12,-160.33,2435.25
4975,32424424,2023-02-13,91.78,2527.0299999999997
4976,32474004,2023-01-31,,509.41
4977,32474004,2023-02-05,-78.96,430.45000000000005
4978,32474004,2023-02-06,-116.91,313.54
4979,32474004,2023-02-08,4.84,318.38000000000005
4980,32474004,2023-02-09,106.38,424.76000000000005
4981,32476086,2023-01-31,,67.66
4982,32476086,2023-02-06,55.3,122.96
4983,32476086,2023-02-09,115.75,238.70999999999998
4984,32476086,2023-02-10,137.56,376.27
4985,32476086,2023-02-12,127.6,503.87
4986,32476086,2023-02-14,908.4,1412.27
4987,32597705,2023-01-31,,869.89
4988,32597705,2023-02-03,-125.04,744.85
4989,32597705,2023-02-03,-172.24,572.6099999999999
4990,32597705,2023-02-06,-76.6,496.01
4991,32597705,2023-02-08,175.42,671.43
4992,32597705,2023-02-12,-90.34,581.0899999999999
4993,32597705,2023-02-13,-111.43,469.65999999999997
4994,32641357,2023-01-31,,12.39
4995,32641357,2023-02-03,-16.93,-4.539999999999999
4996,32641357,2023-02-04,119.25,114.71000000000001
4997,32641357,2023-02-04,-94.62,20.090000000000003
4998,32641357,2023-02-08,-693.0,-672.91
4999,32641357,2023-02-09,-46.37,-719.28
5000,32679915,2023-01-31,,841.31
5001,32679915,2023-02-02,-161.91,679.4
5002,32679915,2023-02-03,-109.86,569.54
5003,32679915,2023-02-06,154.3,723.8399999999999
5004,32737909,2023-01-31,,744.1
5005,32737909,2023-02-01,99.52,843.62
5006,32737909,2023-02-02,140.27,983.8900000000001
5007,32737909,2023-02-03,37.02,1020.9100000000001
5008,32737909,2023-02-04,53.51,1074.42
5009,32737909,2023-02-07,-57.25,1017.1700000000001
5010,32737909,2023-02-09,112.93,1130.1000000000001
5011,32737909,2023-02-10,57.63,1187.73
5012,32737909,2023-02-13,-375.1,812.6300000000001
5013,32803222,2023-01-31,,827.92
5014,32803222,2023-02-01,-80.92,747.0
5015,32803222,2023-02-10,63.87,810.87
5016,32803222,2023-02-11,142.41,953.28
5017,32803222,2023-02-12,9.9,963.18
5018,32803222,2023-02-13,96.06,1059.24
5019,32803222,2023-02-14,56.66,1115.8999999999999
5020,32824719,2023-01-31,,502.37
5021,32824719,2023-02-01,-9.8,492.57
5022,32824719,2023-02-10,179.1,671.67
5023,32824719,2023-02-11,-110.41,561.26
5024,32888555,2023-01-31,,781.33
5025,32888555,2023-02-03,76.11,857.44
5026,32888555,2023-02-05,-74.16,783.2800000000001
5027,32888555,2023-02-06,1161.4,1944.6800000000003
5028,32888555,2023-02-06,-96.15,1848.5300000000002
5029,32888555,2023-02-09,-179.26,1669.2700000000002
5030,32888555,2023-02-11,-42.9,1626.3700000000003
5031,32888555,2023-02-12,169.36,1795.7300000000002
5032,32888555,2023-02-14,207.36,2003.0900000000004
5033,32930305,2023-01-31,,49.71
5034,32930305,2023-02-05,151.29,201.0
5035,32930305,2023-02-08,-209.73,-8.72999999999999
5036,32930305,2023-02-11,73.61,64.88000000000001
5037,32930305,2023-02-12,-183.73,-118.84999999999998
5038,32934183,2023-01-31,,917.81
5039,32934183,2023-02-03,-886.3,31.50999999999999
5040,32934183,2023-02-07,-65.97,-34.46000000000001
5041,32934183,2023-02-11,55.38,20.919999999999995
5042,32973728,2023-01-31,,321.03
5043,32973728,2023-02-06,54.71,375.73999999999995
5044,32973728,2023-02-08,-104.18,271.55999999999995
5045,32973728,2023-02-13,131.36,402.91999999999996
5046,32991596,2023-01-31,,755.92
5047,32991596,2023-02-01,166.48,922.4
5048,32991596,2023-02-05,65.54,987.9399999999999
5049,32991596,2023-02-07,162.11,1150.05
5050,32991596,2023-02-09,118.82,1268.87
5051,32991596,2023-02-11,1851.4,3120.27
5052,32991596,2023-02-11,-147.54,2972.73
5053,32991596,2023-02-11,-158.64,2814.09
5054,33014501,2023-01-31,,454.35
5055,33014501,2023-02-03,-68.85,385.5
5056,33014501,2023-02-03,-84.12,301.38
5057,33014501,2023-02-04,129.64,431.02
5058,33014501,2023-02-04,85.27,516.29
5059,33014501,2023-02-05,-80.26,436.03
5060,33014501,2023-02-09,77.66,513.69
5061,33014501,2023-02-13,152.83,666.52
5062,33014501,2023-02-13,-135.78,530.74
5063,33112628,2023-01-31,,879.2
5064,33112628,2023-02-02,196.6,1075.8
5065,33112628,2023-02-04,245.23,1321.03
5066,33112628,2023-02-05,133.1,1454.13
5067,33112628,2023-02-06,-75.81,1378.32
5068,33112628,2023-02-10,99.53,1477.85
5069,33112628,2023-02-11,-123.24,1354.6100000000001
5070,33112628,2023-02-12,84.07,1438.68
5071,33112628,2023-02-13,117.35,1556.03
5072,33116647,2023-01-31,,391.76
5073,33116647,2023-02-04,68.44,460.2
5074,33116647,2023-02-05,-60.9,399.3
5075,33116647,2023-02-06,-136.49,262.80999999999995
5076,33116647,2023-02-06,-1095.4,-832.5900000000001
5077,33116647,2023-02-09,78.1,-754.4900000000001
5078,33116647,2023-02-09,-58.09,-812.5800000000002
5079,33116647,2023-02-13,31.07,-781.5100000000001
5080,33116647,2023-02-14,-60.92,-842.4300000000002
5081,33159039,2023-01-31,,100.51
5082,33159039,2023-02-01,-240.2,-139.69
5083,33159039,2023-02-05,-126.51,-266.2
5084,33159039,2023-02-05,-143.3,-409.5
5085,33159039,2023-02-12,-94.36,-503.86
5086,33168725,2023-01-31,,211.44
5087,33168725,2023-02-01,88.65,300.09000000000003
5088,33168725,2023-02-03,-110.05,190.04000000000002
5089,33168725,2023-02-04,-262.0,-71.95999999999998
5090,33168725,2023-02-10,-99.53,-171.48999999999998
5091,33168725,2023-02-14,-123.42,-294.90999999999997
5092,33173974,2023-01-31,,94.47
5093,33173974,2023-02-02,88.57,183.04
5094,33173974,2023-02-04,51.84,234.88
5095,33173974,2023-02-05,-106.32,128.56
5096,33173974,2023-02-06,-98.92,29.64
5097,33173974,2023-02-07,134.59,164.23000000000002
5098,33173974,2023-02-08,-160.1,4.1299999999999955
5099,33173974,2023-02-10,162.36,166.49
5100,33173974,2023-02-13,69.55,236.04000000000002
5101,33173974,2023-02-13,-201.95,34.09000000000003
5102,33202593,2023-01-31,,329.25
5103,33202593,2023-02-09,-191.29,137.96
5104,33240853,2023-01-31,,985.46
5105,33240853,2023-02-01,-120.69,864.77
5106,33240853,2023-02-07,1429.1,2293.87
5107,33240853,2023-02-09,-938.3,1355.57
5108,33240853,2023-02-11,1318.1,2673.67
5109,33240853,2023-02-13,86.25,2759.92
5110,33240853,2023-02-14,-77.21,2682.71
5111,33259781,2023-01-31,,923.18
5112,33259781,2023-02-01,-93.43,829.75
5113,33259781,2023-02-05,65.57,895.3199999999999
5114,33259781,2023-02-07,66.88,962.1999999999999
5115,33259781,2023-02-08,-149.64,812.56
5116,33259781,2023-02-09,912.8,1725.36
5117,33259781,2023-02-10,-150.39,1574.9699999999998
5118,33259781,2023-02-12,841.7,2416.67
5119,33259781,2023-02-12,93.57,2510.24
5120,33259781,2023-02-14,66.29,2576.5299999999997
5121,33259781,2023-02-14,-87.23,2489.3
5122,33270307,2023-01-31,,38.51
5123,33270307,2023-02-02,-120.61,-82.1
5124,33270307,2023-02-04,32.62,-49.48000000000001
5125,33270307,2023-02-06,-116.99,-166.47
5126,33270307,2023-02-12,110.81,-55.66000000000001
5127,33270307,2023-02-14,1376.0,1320.34
5128,33348876,2023-01-31,,267.33
5129,33348876,2023-02-02,-40.94,226.39
5130,33348876,2023-02-05,60.35,286.74
5131,33348876,2023-02-07,111.26,398.0
5132,33348876,2023-02-07,99.21,497.21
5133,33348876,2023-02-08,-217.58,279.63
5134,33348876,2023-02-09,-153.45,126.18
5135,33351056,2023-01-31,,597.06
5136,33351056,2023-02-02,-142.28,454.78
5137,33351056,2023-02-03,769.3,1224.08
5138,33351056,2023-02-03,208.28,1432.36
5139,33351056,2023-02-03,179.13,1611.49
5140,33351056,2023-02-07,90.26,1701.75
5141,33351056,2023-02-10,-89.98,1611.77
5142,33351056,2023-02-13,84.2,1695.97
5143,33381880,2023-01-31,,682.27
5144,33381880,2023-02-04,58.31,740.5799999999999
5145,33381880,2023-02-04,-97.06,643.52
5146,33381880,2023-02-07,75.46,718.98
5147,33381880,2023-02-08,-168.29,550.69
5148,33381880,2023-02-11,-172.57,378.12
5149,33381880,2023-02-12,131.34,509.46000000000004
5150,33381880,2023-02-14,73.4,582.86
5151,33403100,2023-01-31,,270.23
5152,33403100,2023-02-11,-110.28,159.95000000000002
5153,33414190,2023-01-31,,204.38
5154,33414190,2023-02-04,63.54,267.92
5155,33414190,2023-02-07,-29.79,238.13
5156,33414190,2023-02-11,60.37,298.5
5157,33414190,2023-02-13,-150.38,148.12
5158,33424425,2023-01-31,,23.18
5159,33424425,2023-02-01,-54.7,-31.520000000000003
5160,33424425,2023-02-02,108.46,76.94
5161,33424425,2023-02-04,578.6,655.54
5162,33424425,2023-02-04,45.45,700.9900000000001
5163,33424425,2023-02-07,-39.59,661.4000000000001
5164,33424425,2023-02-13,76.04,737.44
5165,33470885,2023-01-31,,531.96
5166,33470885,2023-02-02,181.56,713.52
5167,33470885,2023-02-03,-75.66,637.86
5168,33470885,2023-02-03,-107.9,529.96
5169,33470885,2023-02-05,-70.44,459.52000000000004
5170,33470885,2023-02-07,1676.4,2135.92
5171,33470885,2023-02-12,-1071.4,1064.52
5172,33470885,2023-02-13,61.95,1126.47
5173,33470885,2023-02-14,145.06,1271.53
5174,33505838,2023-01-31,,76.39
5175,33505838,2023-02-05,54.53,130.92000000000002
5176,33505838,2023-02-06,135.81,266.73
5177,33505838,2023-02-07,-73.26,193.47000000000003
5178,33505838,2023-02-07,-77.96,115.51000000000002
5179,33505838,2023-02-08,87.34,202.85000000000002
5180,33505838,2023-02-14,-93.12,109.73000000000002
5181,33527603,2023-01-31,,413.42
5182,33527603,2023-02-10,-123.66,289.76
5183,33527603,2023-02-10,-504.8,-215.03999999999996
5184,33527603,2023-02-11,-95.27,-310.30999999999995
5185,33527603,2023-02-12,94.05,-216.25999999999996
5186,33527603,2023-02-13,1154.7,938.44
5187,33527759,2023-01-31,,245.55
5188,33527759,2023-02-06,-100.9,144.65
5189,33527759,2023-02-11,-792.4,-647.75
5190,33561341,2023-01-31,,749.16
5191,33561341,2023-02-01,102.31,851.47
5192,33561341,2023-02-05,17.25,868.72
5193,33561341,2023-02-09,114.45,983.17
5194,33632099,2023-01-31,,943.81
5195,33632099,2023-02-04,-1398.7,-454.8900000000001
5196,33632099,2023-02-05,-34.76,-489.6500000000001
5197,33632099,2023-02-10,88.72,-400.93000000000006
5198,33632099,2023-02-10,-83.51,-484.4400000000001
5199,33632099,2023-02-11,1991.3,1506.86
5200,33632099,2023-02-12,1955.6,3462.46
5201,33632099,2023-02-13,54.59,3517.0499999999997
5202,33632099,2023-02-13,-1370.1,2146.95
5203,33632099,2023-02-14,-57.83,2089.12
5204,33634912,2023-01-31,,888.99
5205,33634912,2023-02-02,-49.76,839.23
5206,33634912,2023-02-04,26.48,865.71
5207,33634912,2023-02-04,-109.08,756.63
5208,33634912,2023-02-06,11.61,768.24
5209,33634912,2023-02-10,-141.06,627.1800000000001
5210,33634912,2023-02-13,61.34,688.52
5211,33634912,2023-02-13,-118.83,569.69
5212,33634912,2023-02-13,-151.76,417.93
5213,33634912,2023-02-14,-163.34,254.59
5214,33749113,2023-01-31,,590.37
5215,33749113,2023-02-03,-144.98,445.39
5216,33749113,2023-02-05,-102.17,343.22
5217,33749113,2023-02-07,-122.02,221.20000000000002
5218,33749113,2023-02-12,126.93,348.13
5219,33749113,2023-02-12,-122.81,225.32000000000002
5220,33749812,2023-01-31,,121.02
5221,33749812,2023-02-02,50.83,171.85
5222,33749812,2023-02-03,-78.92,92.92999999999999
5223,33749812,2023-02-04,-39.76,53.169999999999995
5224,33749812,2023-02-04,-957.5,-904.33
5225,33749812,2023-02-05,110.07,-794.26
5226,33749812,2023-02-06,100.8,-693.46
5227,33750944,2023-01-31,,100.44
5228,33750944,2023-02-05,-138.66,-38.22
5229,33750944,2023-02-14,120.83,82.61
5230,33771855,2023-01-31,,886.78
5231,33771855,2023-02-01,153.65,1040.43
5232,33771855,2023-02-01,-527.1,513.3299999999999
5233,33771855,2023-02-05,-230.5,282.8299999999999
5234,33771855,2023-02-09,26.32,309.1499999999999
5235,33771855,2023-02-11,-203.67,105.47999999999993
5236,33771855,2023-02-13,45.56,151.03999999999994
5237,33806253,2023-01-31,,847.44
5238,33806253,2023-02-01,151.18,998.6200000000001
5239,33806253,2023-02-05,-144.63,853.99
5240,33806253,2023-02-06,-110.47,743.5200000000001
5241,33806253,2023-02-09,-87.02,656.5000000000001
5242,33806253,2023-02-10,139.76,796.26
5243,33832864,2023-01-31,,46.85
5244,33832864,2023-02-02,-109.28,-62.43
5245,33832864,2023-02-03,-128.62,-191.05
5246,33832864,2023-02-06,-1743.5,-1934.55
5247,33832864,2023-02-13,123.05,-1811.5
5248,33906740,2023-01-31,,820.46
5249,33906740,2023-02-01,-67.52,752.94
5250,33906740,2023-02-02,-701.1,51.84000000000003
5251,33906740,2023-02-04,-46.49,5.35000000000003
5252,33906740,2023-02-04,-62.69,-57.33999999999997
5253,33906740,2023-02-10,-747.3,-804.6399999999999
5254,33906740,2023-02-11,105.46,-699.1799999999998
5255,33906740,2023-02-12,-24.74,-723.9199999999998
5256,33906740,2023-02-14,147.38,-576.5399999999998
5257,33914941,2023-01-31,,665.9
5258,33914941,2023-02-01,-160.48,505.41999999999996
5259,33914941,2023-02-03,-105.07,400.35
5260,33914941,2023-02-05,-142.97,257.38
5261,33914941,2023-02-06,-54.05,203.32999999999998
5262,33915504,2023-01-31,,742.98
5263,33915504,2023-02-07,134.62,877.6
5264,33915504,2023-02-10,-712.2,165.39999999999998
5265,33915504,2023-02-11,1136.3,1301.6999999999998
5266,33915504,2023-02-11,-78.32,1223.38
5267,33915504,2023-02-12,-108.16,1115.22
5268,33915504,2023-02-13,124.44,1239.66
5269,33915504,2023-02-14,-50.82,1188.8400000000001
5270,33915504,2023-02-14,-2237.0,-1048.1599999999999
5271,33967237,2023-01-31,,324.8
5272,33967237,2023-02-01,142.15,466.95000000000005
5273,33967237,2023-02-03,152.86,619.8100000000001
5274,33967237,2023-02-04,108.21,728.02
5275,33967237,2023-02-04,-87.08,640.94
5276,33967237,2023-02-07,53.6,694.5400000000001
5277,33967237,2023-02-13,-65.9,628.64
5278,33967237,2023-02-14,-66.68,561.96
5279,34017695,2023-01-31,,672.46
5280,34017695,2023-02-01,79.2,751.6600000000001
5281,34017695,2023-02-04,-73.93,677.73
5282,34017695,2023-02-05,-36.56,641.1700000000001
5283,34017695,2023-02-07,-218.5,422.67
5284,34017695,2023-02-08,-67.49,355.18
5285,34017695,2023-02-13,148.43,503.61
5286,34017695,2023-02-13,-144.46,359.15
5287,34017695,2023-02-13,-1756.0,-1396.85
5288,34017695,2023-02-14,150.24,-1246.61
5289,34017695,2023-02-14,-2002.7,-3249.31
5290,34027487,2023-01-31,,54.87
5291,34027487,2023-02-02,-56.02,-1.1500000000000057
5292,34027487,2023-02-07,-192.3,-193.45000000000002
5293,34027487,2023-02-10,123.94,-69.51000000000002
5294,34027487,2023-02-11,-43.17,-112.68000000000002
5295,34027487,2023-02-12,57.16,-55.520000000000024
5296,34027487,2023-02-13,144.25,88.72999999999998
5297,34027487,2023-02-14,101.1,189.82999999999998
5298,34112514,2023-01-31,,974.1
5299,34112514,2023-02-12,-123.24,850.86
5300,34128127,2023-01-31,,275.83
5301,34128127,2023-02-01,88.1,363.92999999999995
5302,34128127,2023-02-05,841.2,1205.13
5303,34128127,2023-02-05,136.6,1341.73
5304,34128127,2023-02-10,15.25,1356.98
5305,34128127,2023-02-11,-45.02,1311.96
5306,34158235,2023-01-31,,50.76
5307,34158235,2023-02-02,95.52,146.28
5308,34158235,2023-02-03,-85.48,60.79999999999998
5309,34158235,2023-02-05,65.82,126.61999999999998
5310,34158235,2023-02-06,132.93,259.54999999999995
5311,34158235,2023-02-07,-43.24,216.30999999999997
5312,34158235,2023-02-08,-80.16,136.14999999999998
5313,34158235,2023-02-10,-81.26,54.88999999999997
5314,34158235,2023-02-13,-156.49,-101.60000000000004
5315,34158235,2023-02-14,-159.08,-260.68000000000006
5316,34158235,2023-02-14,-439.8,-700.48
5317,34190086,2023-01-31,,890.87
5318,34190086,2023-02-01,65.9,956.77
5319,34190086,2023-02-08,-144.06,812.71
5320,34190086,2023-02-13,69.63,882.34
5321,34190086,2023-02-13,-73.96,808.38
5322,34190086,2023-02-14,25.45,833.83
5323,34252525,2023-01-31,,107.18
5324,34252525,2023-02-02,-95.27,11.91000000000001
5325,34252525,2023-02-04,113.49,125.4
5326,34252525,2023-02-04,-244.13,-118.72999999999999
5327,34252525,2023-02-07,82.79,-35.93999999999998
5328,34252525,2023-02-08,-85.07,-121.00999999999998
5329,34252525,2023-02-13,1503.4,1382.39
5330,34264499,2023-01-31,,864.86
5331,34264499,2023-02-08,105.97,970.83
5332,34264499,2023-02-09,898.1,1868.93
5333,34264499,2023-02-09,135.68,2004.6100000000001
5334,34264499,2023-02-09,25.95,2030.5600000000002
5335,34264499,2023-02-12,-77.9,1952.66
5336,34264499,2023-02-13,76.07,2028.73
5337,34264499,2023-02-14,72.4,2101.13
5338,34275044,2023-01-31,,532.29
5339,34275044,2023-02-07,79.84,612.13
5340,34275044,2023-02-08,144.26,756.39
5341,34275044,2023-02-10,91.66,848.05
5342,34275044,2023-02-11,109.94,957.99
5343,34275044,2023-02-13,-156.89,801.0999999999999
5344,34284479,2023-01-31,,74.46
5345,34284479,2023-02-04,-25.74,48.72
5346,34284479,2023-02-05,155.64,204.35999999999999
5347,34284479,2023-02-08,-66.05,138.31
5348,34284479,2023-02-08,-203.1,-64.79000000000002
5349,34284479,2023-02-10,63.76,-1.0300000000000225
5350,34284479,2023-02-12,122.48,121.44999999999999
5351,34336001,2023-01-31,,396.75
5352,34336001,2023-02-01,-48.39,348.36
5353,34336001,2023-02-06,133.66,482.02
5354,34336001,2023-02-08,186.34,668.36
5355,34336001,2023-02-12,-71.39,596.97
5356,34336001,2023-02-14,72.93,669.9
5357,34336001,2023-02-14,-89.16,580.74
5358,34351752,2023-01-31,,30.31
5359,34351752,2023-02-02,-12.65,17.659999999999997
5360,34351752,2023-02-02,-27.52,-9.86
5361,34351752,2023-02-05,-227.66,-237.51999999999998
5362,34374766,2023-01-31,,916.09
5363,34374766,2023-02-01,131.53,1047.6200000000001
5364,34374766,2023-02-03,749.7,1797.3200000000002
5365,34374766,2023-02-06,-138.24,1659.08
5366,34374766,2023-02-08,968.8,2627.88
5367,34374766,2023-02-08,-233.36,2394.52
5368,34374766,2023-02-10,-68.91,2325.61
5369,34374766,2023-02-14,13.43,2339.04
5370,34400277,2023-01-31,,207.59
5371,34400277,2023-02-01,-1393.7,-1186.1100000000001
5372,34400277,2023-02-03,68.13,-1117.98
5373,34400277,2023-02-04,150.45,-967.5300000000002
5374,34400277,2023-02-04,76.66,-890.8700000000001
5375,34400277,2023-02-05,6.72,-884.1500000000001
5376,34400277,2023-02-06,688.5,-195.6500000000001
5377,34400277,2023-02-10,-54.78,-250.4300000000001
5378,34400277,2023-02-14,113.52,-136.91000000000008
5379,34400277,2023-02-14,-86.17,-223.0800000000001
5380,34403979,2023-01-31,,101.14
5381,34403979,2023-02-01,181.06,282.2
5382,34403979,2023-02-02,-98.37,183.82999999999998
5383,34403979,2023-02-04,77.37,261.2
5384,34403979,2023-02-07,-210.28,50.91999999999999
5385,34403979,2023-02-11,42.47,93.38999999999999
5386,34403979,2023-02-12,-1201.1,-1107.71
5387,34403979,2023-02-14,85.41,-1022.3000000000001
5388,34461285,2023-01-31,,149.82
5389,34461285,2023-02-04,83.73,233.55
5390,34461285,2023-02-06,121.6,355.15
5391,34461285,2023-02-10,-109.1,246.05
5392,34461285,2023-02-11,143.15,389.2
5393,34461285,2023-02-11,-128.1,261.1
5394,34461285,2023-02-13,82.99,344.09
5395,34482885,2023-01-31,,359.84
5396,34482885,2023-02-05,-161.46,198.37999999999997
5397,34482885,2023-02-08,358.9,557.28
5398,34482885,2023-02-08,-175.42,381.86
5399,34482885,2023-02-11,1161.1,1542.96
5400,34482885,2023-02-14,-90.48,1452.48
5401,34650969,2023-01-31,,177.82
5402,34650969,2023-02-05,-116.94,60.879999999999995
5403,34650969,2023-02-06,-995.2,-934.32
5404,34650969,2023-02-08,69.02,-865.3000000000001
5405,34650969,2023-02-10,-63.76,-929.0600000000001
5406,34681193,2023-01-31,,183.13
5407,34681193,2023-02-01,-216.49,-33.360000000000014
5408,34681193,2023-02-04,67.01,33.64999999999999
5409,34681193,2023-02-06,133.12,166.76999999999998
5410,34681193,2023-02-07,-124.56,42.20999999999998
5411,34681193,2023-02-09,73.98,116.18999999999998
5412,34681193,2023-02-13,-115.5,0.6899999999999835
5413,34866268,2023-01-31,,516.92
5414,34866268,2023-02-03,-178.47,338.44999999999993
5415,34866268,2023-02-12,1261.7,1600.15
5416,34867145,2023-01-31,,212.16
5417,34867145,2023-02-02,-211.27,0.8899999999999864
5418,34867145,2023-02-05,-135.59,-134.70000000000002
5419,34867145,2023-02-10,-41.65,-176.35000000000002
5420,34902863,2023-01-31,,31.36
5421,34902863,2023-02-01,-89.22,-57.86
5422,34902863,2023-02-04,-68.54,-126.4
5423,34902863,2023-02-06,85.44,-40.96000000000001
5424,34902863,2023-02-07,140.1,99.13999999999999
5425,34902863,2023-02-11,191.93,291.07
5426,34908905,2023-01-31,,887.49
5427,34908905,2023-02-04,-102.31,785.1800000000001
5428,34908905,2023-02-05,17.69,802.87
5429,34908905,2023-02-07,-46.81,756.06
5430,34908905,2023-02-08,-155.62,600.44
5431,34908905,2023-02-09,134.21,734.65
5432,34908905,2023-02-09,-134.87,599.78
5433,34908905,2023-02-13,-124.37,475.40999999999997
5434,34921262,2023-01-31,,971.82
5435,34921262,2023-02-05,-1917.1,-945.2799999999999
5436,34921262,2023-02-07,71.52,-873.7599999999999
5437,34921262,2023-02-08,-101.87,-975.6299999999999
5438,34921262,2023-02-10,-84.84,-1060.4699999999998
5439,34921262,2023-02-13,49.05,-1011.4199999999998
5440,34921262,2023-02-14,-48.39,-1059.81
5441,34960760,2023-01-31,,981.79
5442,34960760,2023-02-02,-190.9,790.89
5443,34960760,2023-02-09,-95.76,695.13
5444,34960760,2023-02-10,89.12,784.25
5445,34960760,2023-02-12,160.14,944.3899999999999
5446,35038984,2023-01-31,,566.36
5447,35038984,2023-02-07,107.2,673.5600000000001
5448,35038984,2023-02-07,-176.01,497.55
5449,35038984,2023-02-09,94.29,591.84
5450,35038984,2023-02-11,-99.57,492.27000000000004
5451,35051369,2023-01-31,,637.18
5452,35051369,2023-02-01,-43.65,593.53
5453,35051369,2023-02-02,112.35,705.8799999999999
5454,35051369,2023-02-04,-198.37,507.50999999999993
5455,35051369,2023-02-11,-49.94,457.56999999999994
5456,35082945,2023-01-31,,713.95
5457,35082945,2023-02-07,-15.77,698.1800000000001
5458,35082945,2023-02-08,-132.78,565.4000000000001
5459,35082945,2023-02-12,113.6,679.0
5460,35082945,2023-02-14,188.72,867.72
5461,35083564,2023-01-31,,599.99
5462,35083564,2023-02-05,144.77,744.76
5463,35083564,2023-02-06,-32.2,712.5600000000001
5464,35083564,2023-02-06,-181.24,531.3199999999999
5465,35083564,2023-02-08,139.22,670.54
5466,35083564,2023-02-09,59.54,730.08
5467,35126236,2023-01-31,,739.8
5468,35126236,2023-02-02,-379.5,360.29999999999995
5469,35126236,2023-02-04,64.48,424.78
5470,35126236,2023-02-04,-109.21,315.56999999999994
5471,35126236,2023-02-06,995.2,1310.77
5472,35126236,2023-02-08,130.56,1441.33
5473,35126236,2023-02-08,103.89,1545.22
5474,35126236,2023-02-10,-34.71,1510.51
5475,35126236,2023-02-13,137.35,1647.86
5476,35126236,2023-02-13,114.39,1762.25
5477,35126236,2023-02-14,2138.0,3900.25
5478,35160368,2023-01-31,,53.59
5479,35160368,2023-02-01,41.55,95.14
5480,35160368,2023-02-05,163.32,258.46
5481,35160368,2023-02-05,85.08,343.53999999999996
5482,35160368,2023-02-10,155.39,498.92999999999995
5483,35160368,2023-02-12,139.57,638.5
5484,35160368,2023-02-13,-39.15,599.3499999999999
5485,35160368,2023-02-14,87.33,686.68
5486,35160368,2023-02-14,-92.59,594.0899999999999
5487,35177782,2023-01-31,,79.03
5488,35177782,2023-02-03,149.54,228.57
5489,35177782,2023-02-08,110.25,338.82
5490,35177782,2023-02-09,-105.82,233.0
5491,35177782,2023-02-10,72.18,305.18
5492,35177782,2023-02-10,-123.77,181.41000000000003
5493,35177782,2023-02-11,99.42,280.83000000000004
5494,35194218,2023-01-31,,842.34
5495,35194218,2023-02-01,142.2,984.54
5496,35194218,2023-02-04,5.86,990.4
5497,35194218,2023-02-05,-812.6,177.79999999999995
5498,35194218,2023-02-10,70.43,248.22999999999996
5499,35194218,2023-02-11,-134.16,114.06999999999996
5500,35194218,2023-02-12,-76.1,37.96999999999997
5501,35197451,2023-01-31,,411.69
5502,35197451,2023-02-01,-96.06,315.63
5503,35197451,2023-02-02,0.91,316.54
5504,35197451,2023-02-03,98.31,414.85
5505,35197451,2023-02-05,141.51,556.36
5506,35197451,2023-02-05,86.14,642.5
5507,35197451,2023-02-07,131.84,774.3399999999999
5508,35197451,2023-02-11,-60.22,714.12
5509,35197451,2023-02-11,-148.4,565.72
5510,35197451,2023-02-14,723.4,1289.12
5511,35210460,2023-01-31,,185.3
5512,35210460,2023-02-01,1821.2,2006.5
5513,35210460,2023-02-01,-99.63,1906.87
5514,35210460,2023-02-03,117.47,2024.34
5515,35210460,2023-02-08,199.46,2223.8
5516,35210460,2023-02-09,42.5,2266.3
5517,35210460,2023-02-10,68.78,2335.08
5518,35293864,2023-01-31,,592.55
5519,35293864,2023-02-01,-68.47,524.0799999999999
5520,35321469,2023-01-31,,194.57
5521,35321469,2023-02-01,76.26,270.83
5522,35321469,2023-02-02,-119.36,151.47
5523,35321469,2023-02-07,-113.03,38.44
5524,35321469,2023-02-09,74.96,113.39999999999999
5525,35321469,2023-02-14,-51.78,61.61999999999999
5526,35330225,2023-01-31,,717.9
5527,35330225,2023-02-02,38.42,756.3199999999999
5528,35330225,2023-02-04,117.96,874.28
5529,35330225,2023-02-05,72.1,946.38
5530,35330225,2023-02-06,-90.78,855.5999999999999
5531,35330225,2023-02-08,-95.08,760.52
5532,35330225,2023-02-09,1169.4,1929.92
5533,35330225,2023-02-14,-505.6,1424.3200000000002
5534,35345678,2023-01-31,,381.43
5535,35345678,2023-02-02,98.51,479.94
5536,35345678,2023-02-03,170.7,650.64
5537,35345678,2023-02-06,153.53,804.17
5538,35345678,2023-02-06,-97.06,707.11
5539,35345678,2023-02-07,-127.56,579.55
5540,35379604,2023-01-31,,171.68
5541,35379604,2023-02-06,28.36,200.04000000000002
5542,35379604,2023-02-06,-84.79,115.25
5543,35379604,2023-02-08,693.0,808.25
5544,35379604,2023-02-08,14.65,822.9
5545,35379604,2023-02-10,-113.82,709.08
5546,35379604,2023-02-13,-58.62,650.46
5547,35391237,2023-01-31,,412.06
5548,35391237,2023-02-01,103.94,516.0
5549,35391237,2023-02-01,-105.94,410.06
5550,35391237,2023-02-01,-126.5,283.56
5551,35391237,2023-02-02,-97.9,185.66
5552,35391237,2023-02-03,-147.6,38.06
5553,35391237,2023-02-04,-163.03,-124.97
5554,35391237,2023-02-07,-153.96,-278.93
5555,35391237,2023-02-11,58.36,-220.57
5556,35391237,2023-02-13,-134.72,-355.29
5557,35391237,2023-02-14,135.7,-219.59000000000003
5558,35391340,2023-01-31,,886.56
5559,35391340,2023-02-01,-119.2,767.3599999999999
5560,35391340,2023-02-04,125.41,892.77
5561,35391340,2023-02-04,-100.63,792.14
5562,35391340,2023-02-08,-77.26,714.8799999999999
5563,35391340,2023-02-09,156.67,871.55
5564,35391340,2023-02-09,64.44,935.9899999999999
5565,35391340,2023-02-11,109.76,1045.75
5566,35391340,2023-02-11,-87.63,958.1199999999999
5567,35391340,2023-02-12,-115.04,843.0799999999999
5568,35405748,2023-01-31,,19.49
5569,35405748,2023-02-02,1666.0,1685.49
5570,35405748,2023-02-03,-171.99,1513.5
5571,35405748,2023-02-06,-60.39,1453.11
5572,35405748,2023-02-09,-63.99,1389.12
5573,35445202,2023-01-31,,972.48
5574,35445202,2023-02-04,138.34,1110.82
5575,35445202,2023-02-04,-95.01,1015.8100000000001
5576,35445202,2023-02-05,42.25,1058.06
5577,35445202,2023-02-07,71.12,1129.18
5578,35445202,2023-02-13,50.67,1179.85
5579,35445202,2023-02-13,-80.72,1099.13
5580,35445202,2023-02-14,128.56,1227.69
5581,35506101,2023-01-31,,713.65
5582,35506101,2023-02-04,-143.83,569.8199999999999
5583,35506101,2023-02-06,-368.9,200.91999999999996
5584,35506101,2023-02-07,26.09,227.00999999999996
5585,35506101,2023-02-07,15.77,242.77999999999997
5586,35506101,2023-02-08,70.92,313.69999999999993
5587,35506101,2023-02-09,87.02,400.71999999999997
5588,35506101,2023-02-09,-1386.8,-986.0799999999999
5589,35506101,2023-02-11,-107.95,-1094.03
5590,35510004,2023-01-31,,723.62
5591,35510004,2023-02-07,-53.14,670.48
5592,35510004,2023-02-09,-140.03,530.45
5593,35510004,2023-02-14,122.94,653.39
5594,35539408,2023-01-31,,469.13
5595,35539408,2023-02-08,66.58,535.71
5596,35539408,2023-02-12,20.96,556.67
5597,35539408,2023-02-12,-60.3,496.37
5598,35540836,2023-01-31,,17.91
5599,35540836,2023-02-01,120.69,138.6
5600,35540836,2023-02-04,162.1,300.7
5601,35540836,2023-02-11,-64.55,236.14999999999998
5602,35540836,2023-02-12,850.1,1086.25
5603,35549277,2023-01-31,,505.72
5604,35549277,2023-02-03,164.14,669.86
5605,35549277,2023-02-04,143.95,813.81
5606,35549277,2023-02-06,54.21,868.02
5607,35549277,2023-02-08,-65.82,802.2
5608,35549277,2023-02-09,79.33,881.53
5609,35549277,2023-02-14,135.72,1017.25
5610,35555120,2023-01-31,,598.72
5611,35555120,2023-02-05,-112.03,486.69000000000005
5612,35555120,2023-02-06,-155.04,331.65000000000003
5613,35555120,2023-02-09,-75.39,256.26000000000005
5614,35564578,2023-01-31,,621.37
5615,35564578,2023-02-01,156.88,778.25
5616,35564578,2023-02-01,101.68,879.9300000000001
5617,35564578,2023-02-05,-33.32,846.61
5618,35564578,2023-02-06,140.83,987.44
5619,35564578,2023-02-06,76.6,1064.04
5620,35564578,2023-02-07,-93.89,970.15
5621,35564578,2023-02-09,93.14,1063.29
5622,35564578,2023-02-11,-909.1,154.19000000000005
5623,35564578,2023-02-12,-95.71,58.48000000000006
5624,35564578,2023-02-14,153.48,211.96000000000004
5625,35574156,2023-01-31,,471.05
5626,35574156,2023-02-02,81.2,552.25
5627,35574156,2023-02-02,-113.03,439.22
5628,35574156,2023-02-04,-98.27,340.95000000000005
5629,35574156,2023-02-10,117.79,458.74
5630,35574156,2023-02-12,-71.65,387.09000000000003
5631,35614465,2023-01-31,,276.17
5632,35614465,2023-02-01,106.89,383.06
5633,35614465,2023-02-01,75.62,458.68
5634,35614465,2023-02-01,-111.48,347.20000000000005
5635,35614465,2023-02-02,68.58,415.78000000000003
5636,35614465,2023-02-04,238.96,654.74
5637,35614465,2023-02-04,82.25,736.99
5638,35614465,2023-02-07,176.01,913.0
5639,35614465,2023-02-09,-81.5,831.5
5640,35614465,2023-02-12,-41.61,789.89
5641,35614465,2023-02-14,52.1,841.99
5642,35614465,2023-02-14,-69.51,772.48
5643,35616763,2023-01-31,,279.43
5644,35616763,2023-02-03,144.98,424.40999999999997
5645,35616763,2023-02-04,91.88,516.29
5646,35616763,2023-02-04,90.91,607.2
5647,35616763,2023-02-05,98.9,706.1
5648,35616763,2023-02-09,-94.78,611.3199999999999
5649,35616763,2023-02-10,-133.89,477.43
5650,35633136,2023-01-31,,603.11
5651,35633136,2023-02-07,-140.72,462.39
5652,35633136,2023-02-08,-1589.0,-1126.6100000000001
5653,35633136,2023-02-09,1855.5,728.8899999999999
5654,35633136,2023-02-10,-85.16,643.7299999999999
5655,35633136,2023-02-12,-128.62,515.1099999999999
5656,35633136,2023-02-14,223.99,739.0999999999999
5657,35642953,2023-01-31,,137.26
5658,35642953,2023-02-07,-45.83,91.42999999999999
5659,35642953,2023-02-10,141.83,233.26
5660,35642953,2023-02-11,-102.43,130.83
5661,35642953,2023-02-13,126.72,257.55
5662,35652360,2023-01-31,,41.81
5663,35652360,2023-02-02,87.3,129.11
5664,35652360,2023-02-07,-135.62,-6.509999999999991
5665,35652360,2023-02-10,-101.74,-108.24999999999999
5666,35652360,2023-02-12,-7.46,-115.70999999999998
5667,35698347,2023-01-31,,258.22
5668,35698347,2023-02-09,-145.02,113.20000000000002
5669,35698347,2023-02-12,82.2,195.40000000000003
5670,35698347,2023-02-12,76.36,271.76
5671,35698347,2023-02-12,28.42,300.18
5672,35698347,2023-02-12,-143.1,157.08000000000004
5673,35698347,2023-02-13,23.8,180.88000000000005
5674,35698347,2023-02-14,-105.03,75.85000000000004
5675,35712712,2023-01-31,,828.88
5676,35712712,2023-02-02,94.92,923.8
5677,35712712,2023-02-04,91.22,1015.02
5678,35712712,2023-02-13,-93.58,921.44
5679,35712712,2023-02-14,-131.58,789.86
5680,35721788,2023-01-31,,837.07
5681,35721788,2023-02-02,47.72,884.7900000000001
5682,35721788,2023-02-04,1548.2,2432.9900000000002
5683,35721788,2023-02-05,-189.35,2243.64
5684,35721788,2023-02-07,166.27,2409.91
5685,35721788,2023-02-11,-67.03,2342.88
5686,35726421,2023-01-31,,379.1
5687,35726421,2023-02-01,-36.3,342.8
5688,35726421,2023-02-09,257.1,599.9000000000001
5689,35726421,2023-02-09,-32.68,567.22
5690,35726421,2023-02-11,-117.41,449.81000000000006
5691,35726421,2023-02-12,118.77,568.58
5692,35726421,2023-02-12,-146.81,421.77000000000004
5693,35726421,2023-02-13,32.01,453.78000000000003
5694,35726421,2023-02-14,143.07,596.85
5695,35726421,2023-02-14,-84.96,511.89000000000004
5696,35746207,2023-01-31,,785.36
5697,35746207,2023-02-02,142.26,927.62
5698,35746207,2023-02-04,-163.58,764.04
5699,35746207,2023-02-08,-136.06,627.98
5700,35746207,2023-02-09,-180.04,447.94
5701,35746207,2023-02-11,-106.87,341.07
5702,35746207,2023-02-14,82.48,423.55
5703,35746207,2023-02-14,-73.77,349.78
5704,35762783,2023-01-31,,346.14
5705,35762783,2023-02-04,34.64,380.78
5706,35762783,2023-02-06,97.52,478.29999999999995
5707,35762783,2023-02-06,-98.21,380.09
5708,35772673,2023-01-31,,517.9
5709,35772673,2023-02-01,-76.39,441.51
5710,35772673,2023-02-11,17.45,458.96
5711,35772673,2023-02-12,113.78,572.74
5712,35799522,2023-01-31,,750.79
5713,35799522,2023-02-04,122.19,872.98
5714,35799522,2023-02-04,-84.48,788.5
5715,35799522,2023-02-08,811.2,1599.7
5716,35799522,2023-02-09,77.09,1676.79
5717,35799522,2023-02-12,481.2,2157.99
5718,35799522,2023-02-12,-122.13,2035.8600000000001
5719,35799522,2023-02-13,53.69,2089.55
5720,35805852,2023-01-31,,886.37
5721,35805852,2023-02-03,26.28,912.65
5722,35805852,2023-02-08,159.05,1071.7
5723,35805852,2023-02-13,-80.1,991.6
5724,35805852,2023-02-13,-128.78,862.82
5725,35827625,2023-01-31,,445.63
5726,35827625,2023-02-01,-4.45,441.18
5727,35827625,2023-02-03,-130.92,310.26
5728,35827625,2023-02-06,50.86,361.12
5729,35827625,2023-02-07,166.06,527.1800000000001
5730,35827625,2023-02-08,-103.49,423.69
5731,35827625,2023-02-13,138.07,561.76
5732,35869347,2023-01-31,,768.74
5733,35869347,2023-02-01,-99.06,669.6800000000001
5734,35869347,2023-02-06,128.7,798.38
5735,35869347,2023-02-08,-63.42,734.96
5736,35869347,2023-02-09,122.91,857.87
5737,35869347,2023-02-10,504.8,1362.67
5738,35869347,2023-02-13,-650.5,712.1700000000001
5739,35948735,2023-01-31,,117.14
5740,35948735,2023-02-06,173.27,290.41
5741,35948735,2023-02-08,-257.4,33.01000000000005
5742,35948735,2023-02-10,-59.81,-26.799999999999955
5743,35948735,2023-02-12,-103.8,-130.59999999999997
5744,35948735,2023-02-13,145.83,15.230000000000075
5745,35996817,2023-01-31,,187.89
5746,35996817,2023-02-02,62.13,250.01999999999998
5747,35996817,2023-02-02,-807.9,-557.88
5748,35996817,2023-02-03,-955.4,-1513.28
5749,35996817,2023-02-04,162.76,-1350.52
5750,35996817,2023-02-04,97.19,-1253.33
5751,35996817,2023-02-05,39.08,-1214.25
5752,35996817,2023-02-06,1144.5,-69.75
5753,35996817,2023-02-13,-111.75,-181.5
5754,36007496,2023-01-31,,239.44
5755,36007496,2023-02-03,-106.54,132.89999999999998
5756,36007496,2023-02-04,130.37,263.27
5757,36007496,2023-02-10,-142.78,120.48999999999998
5758,36007496,2023-02-11,-55.67,64.81999999999998
5759,36007496,2023-02-12,-90.33,-25.51000000000002
5760,36106467,2023-01-31,,720.17
5761,36106467,2023-02-02,54.11,774.28
5762,36106467,2023-02-13,-48.97,725.31
5763,36106467,2023-02-14,-109.13,616.18
5764,36110938,2023-01-31,,532.77
5765,36110938,2023-02-05,-151.15,381.62
5766,36110938,2023-02-14,110.42,492.03999999999996
5767,36110938,2023-02-14,-51.36,440.67999999999995
5768,36112473,2023-01-31,,530.67
5769,36112473,2023-02-02,104.28,634.9499999999999
5770,36112473,2023-02-07,-16.72,618.23
5771,36112473,2023-02-08,128.42,746.65
5772,36112473,2023-02-08,37.07,783.7199999999999
5773,36112473,2023-02-11,111.87,895.5899999999999
5774,36114551,2023-01-31,,876.22
5775,36114551,2023-02-03,-12.53,863.69
5776,36114551,2023-02-03,-1488.0,-624.31
5777,36114551,2023-02-07,-9.52,-633.8299999999999
5778,36114551,2023-02-11,134.5,-499.3299999999999
5779,36114551,2023-02-11,113.2,-386.12999999999994
5780,36114551,2023-02-13,-154.15,-540.28
5781,36114551,2023-02-14,134.51,-405.77
5782,36126802,2023-01-31,,617.04
5783,36126802,2023-02-04,117.97,735.01
5784,36126802,2023-02-10,-122.66,612.3499999999999
5785,36126802,2023-02-12,-80.63,531.72
5786,36131723,2023-01-31,,602.96
5787,36131723,2023-02-02,723.0,1325.96
5788,36131723,2023-02-06,74.78,1400.74
5789,36131723,2023-02-07,153.24,1553.98
5790,36131723,2023-02-08,-60.7,1493.28
5791,36131723,2023-02-13,118.36,1611.64
5792,36141472,2023-01-31,,656.7
5793,36141472,2023-02-09,20.1,676.8000000000001
5794,36143004,2023-01-31,,256.22
5795,36143004,2023-02-03,-132.95,123.27000000000004
5796,36143004,2023-02-04,-58.74,64.53000000000003
5797,36143004,2023-02-08,111.03,175.56000000000003
5798,36143004,2023-02-13,127.19,302.75
5799,36171568,2023-01-31,,343.44
5800,36171568,2023-02-06,-169.47,173.97
5801,36171568,2023-02-14,151.47,325.44
5802,36192947,2023-01-31,,744.33
5803,36192947,2023-02-02,73.15,817.48
5804,36192947,2023-02-04,47.16,864.6400000000001
5805,36192947,2023-02-05,-103.8,760.84
5806,36192947,2023-02-05,-134.86,625.98
5807,36192947,2023-02-05,-158.54,467.44000000000005
5808,36192947,2023-02-07,435.8,903.24
5809,36192947,2023-02-11,36.38,939.62
5810,36192947,2023-02-11,-69.7,869.9200000000001
5811,36192947,2023-02-13,-44.57,825.35
5812,36192947,2023-02-14,74.53,899.88
5813,36197772,2023-01-31,,962.03
5814,36197772,2023-02-01,-21.82,940.2099999999999
5815,36197772,2023-02-04,-189.3,750.91
5816,36197772,2023-02-06,179.58,930.49
5817,36197772,2023-02-12,-77.33,853.16
5818,36197772,2023-02-13,-164.76,688.4
5819,36197772,2023-02-14,-110.14,578.26
5820,36258926,2023-01-31,,549.71
5821,36258926,2023-02-06,103.37,653.08
5822,36258926,2023-02-06,-100.71,552.37
5823,36258926,2023-02-09,-133.16,419.21000000000004
5824,36258926,2023-02-10,120.39,539.6
5825,36259936,2023-01-31,,628.23
5826,36259936,2023-02-01,18.77,647.0
5827,36259936,2023-02-05,403.6,1050.6
5828,36259936,2023-02-06,16.5,1067.1
5829,36259936,2023-02-08,-60.7,1006.4
5830,36259936,2023-02-11,-131.61,874.79
5831,36259936,2023-02-12,-113.45,761.34
5832,36296704,2023-01-31,,491.31
5833,36296704,2023-02-04,167.73,659.04
5834,36296704,2023-02-04,-191.64,467.4
5835,36296704,2023-02-05,16.24,483.64
5836,36296704,2023-02-08,116.58,600.22
5837,36327122,2023-01-31,,808.81
5838,36327122,2023-02-02,-127.6,681.2099999999999
5839,36327122,2023-02-07,104.16,785.3699999999999
5840,36327122,2023-02-08,-51.75,733.6199999999999
5841,36389309,2023-01-31,,469.45
5842,36389309,2023-02-06,-132.93,336.52
5843,36389309,2023-02-08,-36.71,299.81
5844,36389309,2023-02-09,83.47,383.28
5845,36389309,2023-02-11,145.81,529.0899999999999
5846,36389309,2023-02-11,-1271.5,-742.4100000000001
5847,36393557,2023-01-31,,407.12
5848,36393557,2023-02-03,-99.07,308.05
5849,36393557,2023-02-05,-101.16,206.89000000000001
5850,36393557,2023-02-06,-142.55,64.34
5851,36393557,2023-02-09,5.59,69.93
5852,36393557,2023-02-13,161.44,231.37
5853,36419197,2023-01-31,,627.78
5854,36419197,2023-02-02,129.45,757.23
5855,36419197,2023-02-07,169.36,926.5899999999999
5856,36419197,2023-02-08,1693.2,2619.79
5857,36419197,2023-02-14,90.74,2710.5299999999997
5858,36425954,2023-01-31,,93.85
5859,36425954,2023-02-03,-146.59,-52.74000000000001
5860,36425954,2023-02-04,150.84,98.1
5861,36425954,2023-02-04,131.69,229.79
5862,36425954,2023-02-10,-141.46,88.32999999999998
5863,36425954,2023-02-11,-40.22,48.109999999999985
5864,36425954,2023-02-14,104.18,152.29
5865,36519974,2023-01-31,,922.41
5866,36519974,2023-02-05,-129.47,792.9399999999999
5867,36519974,2023-02-07,-38.88,754.06
5868,36519974,2023-02-09,-1522.7,-768.6400000000001
5869,36519974,2023-02-12,-138.36,-907.0000000000001
5870,36549889,2023-01-31,,760.2
5871,36549889,2023-02-09,-97.39,662.8100000000001
5872,36549889,2023-02-10,-12.48,650.33
5873,36549889,2023-02-10,-131.62,518.71
5874,36549889,2023-02-14,143.83,662.5400000000001
5875,36551112,2023-01-31,,976.02
5876,36551112,2023-02-01,-12.83,963.1899999999999
5877,36551112,2023-02-05,183.91,1147.1
5878,36551112,2023-02-05,-40.03,1107.07
5879,36551112,2023-02-06,97.64,1204.71
5880,36551112,2023-02-06,-32.34,1172.37
5881,36551112,2023-02-14,-1514.1,-341.73
5882,36551112,2023-02-14,-2197.2,-2538.93
5883,36596942,2023-01-31,,550.9
5884,36596942,2023-02-03,130.92,681.8199999999999
5885,36596942,2023-02-06,110.09,791.91
5886,36596942,2023-02-08,-74.13,717.78
5887,36596942,2023-02-08,-190.88,526.9
5888,36596942,2023-02-09,155.29,682.1899999999999
5889,36596942,2023-02-13,50.68,732.87
5890,36596942,2023-02-13,48.38,781.25
5891,36596942,2023-02-13,-18.85,762.4
5892,36611100,2023-01-31,,485.06
5893,36611100,2023-02-02,144.06,629.12
5894,36611100,2023-02-03,-565.2,63.91999999999996
5895,36611100,2023-02-05,-91.56,-27.640000000000043
5896,36611100,2023-02-08,71.61,43.969999999999956
5897,36611100,2023-02-10,-174.77,-130.80000000000007
5898,36636385,2023-01-31,,985.55
5899,36636385,2023-02-01,-134.06,851.49
5900,36636385,2023-02-04,74.02,925.51
5901,36636385,2023-02-07,1392.7,2318.21
5902,36636385,2023-02-10,-76.06,2242.15
5903,36636385,2023-02-10,-134.54,2107.61
5904,36668239,2023-01-31,,566.32
5905,36668239,2023-02-02,1640.2,2206.52
5906,36668239,2023-02-03,-71.27,2135.25
5907,36668239,2023-02-11,-123.81,2011.4400000000003
5908,36668239,2023-02-13,-11.11,2000.3300000000002
5909,36692647,2023-01-31,,710.29
5910,36692647,2023-02-02,166.35,876.64
5911,36692647,2023-02-09,129.76,1006.4
5912,36696277,2023-01-31,,395.42
5913,36696277,2023-02-01,153.43,548.85
5914,36696277,2023-02-08,74.38,623.23
5915,36696277,2023-02-08,-108.96,514.27
5916,36696277,2023-02-08,-121.98,392.29
5917,36696277,2023-02-09,50.78,443.07000000000005
5918,36696277,2023-02-10,550.8,993.87
5919,36696277,2023-02-11,38.74,1032.61
5920,36696277,2023-02-12,1491.7,2524.31
5921,36725272,2023-01-31,,52.82
5922,36725272,2023-02-02,52.78,105.6
5923,36725272,2023-02-05,129.27,234.87
5924,36725272,2023-02-06,161.37,396.24
5925,36725272,2023-02-07,-109.2,287.04
5926,36725272,2023-02-14,-126.36,160.68
5927,36837451,2023-01-31,,429.52
5928,36837451,2023-02-01,146.02,575.54
5929,36837451,2023-02-02,212.6,788.14
5930,36837451,2023-02-02,96.32,884.46
5931,36837451,2023-02-02,31.96,916.42
5932,36837451,2023-02-07,-77.46,838.96
5933,36837451,2023-02-12,77.33,916.29
5934,36837451,2023-02-12,-119.09,797.1999999999999
5935,36841261,2023-01-31,,172.37
5936,36841261,2023-02-01,-127.65,44.72
5937,36841261,2023-02-04,110.3,155.01999999999998
5938,36841261,2023-02-06,-159.47,-4.449999999999989
5939,36841261,2023-02-10,139.99,135.54000000000002
5940,36841261,2023-02-12,128.62,264.16
5941,36841261,2023-02-14,-148.63,115.53000000000003
5942,36849841,2023-01-31,,593.56
5943,36849841,2023-02-02,-62.52,531.04
5944,36849841,2023-02-03,-174.62,356.41999999999996
5945,36849841,2023-02-04,-83.73,272.68999999999994
5946,36849841,2023-02-05,114.02,386.7099999999999
5947,36849841,2023-02-10,-99.46,287.24999999999994
5948,36871984,2023-01-31,,949.89
5949,36871984,2023-02-05,-103.29,846.6
5950,36871984,2023-02-07,56.49,903.09
5951,36871984,2023-02-08,-154.63,748.46
5952,36871984,2023-02-12,1663.0,2411.46
5953,36871984,2023-02-13,-58.3,2353.16
5954,36949196,2023-01-31,,614.22
5955,36949196,2023-02-02,118.32,732.54
5956,36949196,2023-02-03,124.88,857.4200000000001
5957,36949196,2023-02-04,-86.74,770.6800000000001
5958,36949196,2023-02-04,-125.41,645.27
5959,36949196,2023-02-07,-85.77,559.5
5960,36982820,2023-01-31,,833.46
5961,36982820,2023-02-01,599.8,1433.26
5962,36982820,2023-02-05,-74.55,1358.71
5963,36982820,2023-02-08,2.72,1361.43
5964,36982820,2023-02-12,117.45,1478.88
5965,36982820,2023-02-12,-125.62,1353.26
5966,36982820,2023-02-14,80.46,1433.72
5967,37004975,2023-01-31,,635.77
5968,37004975,2023-02-04,-55.54,580.23
5969,37004975,2023-02-05,122.25,702.48
5970,37004975,2023-02-06,91.58,794.06
5971,37004975,2023-02-06,59.58,853.64
5972,37004975,2023-02-07,-1679.8,-826.16
5973,37004975,2023-02-08,-1290.2,-2116.36
5974,37004975,2023-02-09,37.65,-2078.71
5975,37004975,2023-02-09,-112.31,-2191.02
5976,37004975,2023-02-13,110.17,-2080.85
5977,37017424,2023-01-31,,71.34
5978,37017424,2023-02-01,-85.83,-14.489999999999995
5979,37017424,2023-02-01,-98.52,-113.00999999999999
5980,37017424,2023-02-02,111.16,-1.8499999999999943
5981,37017424,2023-02-10,-11.07,-12.919999999999995
5982,37017424,2023-02-10,-1531.0,-1543.92
5983,37017424,2023-02-12,71.74,-1472.18
5984,37017424,2023-02-13,71.51,-1400.67
5985,37062632,2023-01-31,,366.72
5986,37062632,2023-02-01,119.45,486.17
5987,37062632,2023-02-04,89.51,575.6800000000001
5988,37062632,2023-02-06,-171.3,404.38
5989,37062632,2023-02-09,50.41,454.79
5990,37062632,2023-02-10,104.53,559.32
5991,37062632,2023-02-10,-72.61,486.71000000000004
5992,37062632,2023-02-13,87.03,573.74
5993,37146521,2023-01-31,,471.64
5994,37146521,2023-02-01,-18.27,453.37
5995,37146521,2023-02-04,-94.29,359.08
5996,37146521,2023-02-08,-93.73,265.34999999999997
5997,37146521,2023-02-08,-195.35,70.0
5998,37146521,2023-02-08,-1565.7,-1495.7
5999,37146521,2023-02-10,-46.07,-1541.77
6000,37146521,2023-02-13,37.47,-1504.3
6001,37164421,2023-01-31,,302.68
6002,37164421,2023-02-03,145.42,448.1
6003,37164421,2023-02-06,133.47,581.5699999999999
6004,37164421,2023-02-10,-197.72,383.85
6005,37164421,2023-02-11,182.11,565.96
6006,37247834,2023-01-31,,319.19
6007,37247834,2023-02-01,-148.96,170.23
6008,37247834,2023-02-01,-937.1,-766.87
6009,37247834,2023-02-07,169.21,-597.66
6010,37247834,2023-02-08,163.97,-433.69
6011,37247834,2023-02-08,-56.13,-489.82
6012,37247834,2023-02-09,-80.13,-569.95
6013,37247834,2023-02-09,-138.48,-708.43
6014,37247834,2023-02-11,-117.67,-826.1
6015,37247834,2023-02-12,-185.51,-1011.6099999999999
6016,37247834,2023-02-14,42.13,-969.4799999999999
6017,37256412,2023-01-31,,24.43
6018,37256412,2023-02-03,-1529.4,-1504.97
6019,37256412,2023-02-05,135.39,-1369.58
6020,37256412,2023-02-08,80.13,-1289.45
6021,37256412,2023-02-11,123.24,-1166.21
6022,37267391,2023-01-31,,819.11
6023,37267391,2023-02-01,-105.76,713.35
6024,37267391,2023-02-02,-666.0,47.35000000000002
6025,37267391,2023-02-04,102.71,150.06
6026,37267391,2023-02-06,629.3,779.3599999999999
6027,37267391,2023-02-06,-100.8,678.56
6028,37267391,2023-02-09,134.87,813.4299999999998
6029,37267391,2023-02-10,-62.82,750.6099999999999
6030,37267391,2023-02-11,47.38,797.9899999999999
6031,37273974,2023-01-31,,533.14
6032,37273974,2023-02-02,699.9,1233.04
6033,37273974,2023-02-02,80.13,1313.17
6034,37273974,2023-02-03,180.87,1494.04
6035,37273974,2023-02-05,62.54,1556.58
6036,37273974,2023-02-13,-125.25,1431.33
6037,37274865,2023-01-31,,95.23
6038,37297429,2023-01-31,,693.82
6039,37297429,2023-02-01,-79.4,614.4200000000001
6040,37297429,2023-02-02,983.3,1597.72
6041,37297429,2023-02-02,108.09,1705.81
6042,37297429,2023-02-03,-128.25,1577.56
6043,37297429,2023-02-05,45.9,1623.46
6044,37297429,2023-02-06,72.88,1696.3400000000001
6045,37297429,2023-02-08,-193.89,1502.45
6046,37297429,2023-02-14,-25.45,1477.0
6047,37297429,2023-02-14,-153.15,1323.8500000000001
6048,37319261,2023-01-31,,574.42
6049,37319261,2023-02-04,-99.39,475.03
6050,37319261,2023-02-06,-1409.6,-934.5699999999999
6051,37319261,2023-02-09,-89.75,-1024.32
6052,37319261,2023-02-10,55.29,-969.03
6053,37369245,2023-01-31,,446.65
6054,37369245,2023-02-01,-74.4,372.25
6055,37369245,2023-02-03,-43.72,328.53
6056,37369245,2023-02-04,82.56,411.09
6057,37369245,2023-02-04,-118.19,292.9
6058,37369245,2023-02-05,-40.41,252.48999999999998
6059,37369245,2023-02-10,-1324.9,-1072.41
6060,37369245,2023-02-14,-124.26,-1196.67
6061,37407392,2023-01-31,,822.17
6062,37407392,2023-02-04,79.47,901.64
6063,37407392,2023-02-05,-6.87,894.77
6064,37407392,2023-02-10,-110.62,784.15
6065,37407392,2023-02-13,-87.2,696.9499999999999
6066,37407392,2023-02-14,49.4,746.3499999999999
6067,37443706,2023-01-31,,621.08
6068,37443706,2023-02-03,88.33,709.4100000000001
6069,37443706,2023-02-07,-89.31,620.1
6070,37443706,2023-02-08,158.67,778.77
6071,37443706,2023-02-08,48.19,826.96
6072,37443706,2023-02-12,95.8,922.76
6073,37443706,2023-02-13,1088.0,2010.76
6074,37443706,2023-02-13,-97.05,1913.71
6075,37443706,2023-02-14,47.25,1960.96
6076,37503622,2023-01-31,,630.18
6077,37503622,2023-02-03,146.88,777.06
6078,37503622,2023-02-03,-121.3,655.76
6079,37503622,2023-02-04,-1246.9,-591.1400000000001
6080,37503622,2023-02-04,-1395.3,-1986.44
6081,37503622,2023-02-09,1300.7,-685.74
6082,37503622,2023-02-09,103.16,-582.58
6083,37503622,2023-02-09,-102.69,-685.27
6084,37510139,2023-01-31,,546.33
6085,37510139,2023-02-03,-825.8,-279.4699999999999
6086,37510139,2023-02-05,116.94,-162.52999999999992
6087,37510139,2023-02-11,42.19,-120.33999999999992
6088,37510139,2023-02-14,163.39,43.05000000000007
6089,37528735,2023-01-31,,368.39
6090,37528735,2023-02-02,-92.47,275.91999999999996
6091,37528735,2023-02-07,153.3,429.22
6092,37528735,2023-02-08,-42.59,386.63
6093,37528735,2023-02-11,11.3,397.93
6094,37528735,2023-02-14,89.42,487.35
6095,37561049,2023-01-31,,903.95
6096,37561049,2023-02-01,-80.58,823.37
6097,37561049,2023-02-02,-140.34,683.03
6098,37561049,2023-02-03,-78.66,604.37
6099,37561049,2023-02-04,96.78,701.1500000000001
6100,37561049,2023-02-04,2.86,704.01
6101,37561049,2023-02-05,1922.5,2626.51
6102,37561049,2023-02-13,163.33,2789.84
6103,37561049,2023-02-13,-156.37,2633.47
6104,37561049,2023-02-14,113.07,2746.54
6105,37599317,2023-01-31,,177.32
6106,37599317,2023-02-02,116.43,293.75
6107,37599317,2023-02-03,-167.61,126.13999999999999
6108,37599317,2023-02-09,56.53,182.67
6109,37599317,2023-02-11,73.62,256.28999999999996
6110,37599317,2023-02-11,-103.41,152.88
6111,37599317,2023-02-12,-132.48,20.400000000000006
6112,37642787,2023-01-31,,396.03
6113,37642787,2023-02-03,78.28,474.30999999999995
6114,37642787,2023-02-03,1.03,475.34
6115,37642787,2023-02-03,-187.7,287.64
6116,37642787,2023-02-04,-127.76,159.88
6117,37642787,2023-02-06,-48.31,111.56999999999998
6118,37642787,2023-02-10,1289.6,1401.1699999999998
6119,37642787,2023-02-10,25.31,1426.4799999999998
6120,37642787,2023-02-14,159.09,1585.57
6121,37658218,2023-01-31,,561.27
6122,37658218,2023-02-01,570.3,1131.57
6123,37658218,2023-02-02,-39.87,1091.7
6124,37658218,2023-02-07,43.63,1135.33
6125,37658218,2023-02-09,-83.42,1051.9099999999999
6126,37658218,2023-02-14,-85.5,966.41
6127,37658218,2023-02-14,-101.53,864.8799999999999
6128,37678813,2023-01-31,,767.56
6129,37678813,2023-02-03,-67.35,700.2099999999999
6130,37678813,2023-02-08,-105.41,594.8
6131,37678813,2023-02-13,78.14,672.9399999999999
6132,37678813,2023-02-13,66.23,739.17
6133,37767441,2023-01-31,,726.46
6134,37767441,2023-02-01,-88.19,638.27
6135,37767441,2023-02-02,-15.8,622.47
6136,37767441,2023-02-03,94.83,717.3000000000001
6137,37767441,2023-02-08,87.01,804.3100000000001
6138,37767441,2023-02-09,64.96,869.27
6139,37767441,2023-02-12,169.44,1038.71
6140,37789180,2023-01-31,,854.05
6141,37789180,2023-02-02,-75.99,778.06
6142,37789180,2023-02-03,19.89,797.9499999999999
6143,37789180,2023-02-07,84.83,882.78
6144,37789180,2023-02-08,1621.0,2503.7799999999997
6145,37789180,2023-02-09,-1726.4,777.3799999999999
6146,37789180,2023-02-11,1037.0,1814.3799999999999
6147,37789180,2023-02-11,64.84,1879.2199999999998
6148,37789180,2023-02-11,26.87,1906.09
6149,37789180,2023-02-12,-66.32,1839.77
6150,37789180,2023-02-13,-147.5,1692.27
6151,37796234,2023-01-31,,992.46
6152,37796234,2023-02-02,1698.0,2690.46
6153,37796234,2023-02-02,54.93,2745.39
6154,37796234,2023-02-04,189.38,2934.77
6155,37796234,2023-02-04,-84.12,2850.65
6156,37796234,2023-02-04,-84.91,2765.7400000000002
6157,37796234,2023-02-06,63.36,2829.1
6158,37796234,2023-02-08,1096.2,3925.3
6159,37796234,2023-02-09,38.71,3964.01
6160,37796234,2023-02-09,-173.2,3790.8100000000004
6161,37830423,2023-01-31,,285.5
6162,37830423,2023-02-02,-84.91,200.59
6163,37830423,2023-02-04,120.69,321.28
6164,37830423,2023-02-05,55.38,376.66
6165,37830423,2023-02-07,-69.94,306.72
6166,37830423,2023-02-08,19.11,325.83
6167,37830423,2023-02-08,17.63,343.46
6168,37830423,2023-02-13,-63.17,280.28999999999996
6169,37878074,2023-01-31,,647.56
6170,37878074,2023-02-01,-124.69,522.8699999999999
6171,37878074,2023-02-03,-1218.0,-695.1300000000001
6172,37878074,2023-02-04,-36.24,-731.3700000000001
6173,37878074,2023-02-11,-102.13,-833.5000000000001
6174,37878074,2023-02-11,-117.62,-951.1200000000001
6175,37878074,2023-02-11,-720.7,-1671.8200000000002
6176,37905098,2023-01-31,,389.98
6177,37905098,2023-02-04,112.65,502.63
6178,37905098,2023-02-07,-37.9,464.73
6179,37905098,2023-02-07,-92.13,372.6
6180,37905098,2023-02-07,-197.62,174.98000000000002
6181,37905098,2023-02-08,105.41,280.39
6182,37905098,2023-02-09,109.67,390.06
6183,37905098,2023-02-11,80.85,470.91
6184,37905098,2023-02-12,-125.27,345.64
6185,37905098,2023-02-12,-170.43,175.21
6186,37936898,2023-01-31,,745.79
6187,37936898,2023-02-01,-104.85,640.9399999999999
6188,37936898,2023-02-03,-98.53,542.41
6189,37936898,2023-02-06,159.49,701.9
6190,37936898,2023-02-06,-999.1,-297.20000000000005
6191,37936898,2023-02-10,163.93,-133.27000000000004
6192,37936898,2023-02-10,62.15,-71.12000000000003
6193,37936898,2023-02-11,-86.98,-158.10000000000005
6194,37936898,2023-02-13,73.86,-84.24000000000005
6195,37945317,2023-01-31,,8.24
6196,37945317,2023-02-02,122.81,131.05
6197,37945317,2023-02-03,529.6,660.6500000000001
6198,37945317,2023-02-06,-120.15,540.5
6199,37945317,2023-02-07,1689.7,2230.2
6200,37945317,2023-02-09,-108.53,2121.67
6201,37945317,2023-02-09,-217.27,1904.4
6202,37945317,2023-02-10,1524.4,3428.8
6203,37945317,2023-02-12,89.44,3518.2400000000002
6204,37945317,2023-02-14,-100.7,3417.54
6205,37953007,2023-01-31,,440.78
6206,37953007,2023-02-02,-68.21,372.57
6207,37953007,2023-02-04,130.12,502.69
6208,37953007,2023-02-04,-786.1,-283.41
6209,38032055,2023-01-31,,416.47
6210,38032055,2023-02-04,-32.51,383.96000000000004
6211,38032055,2023-02-07,12.66,396.62
6212,38032055,2023-02-07,-155.12,241.50000000000003
6213,38032055,2023-02-10,-121.29,120.21000000000002
6214,38032055,2023-02-10,-386.8,-266.59
6215,38032055,2023-02-12,147.01,-119.57999999999998
6216,38032055,2023-02-14,88.36,-31.219999999999985
6217,38038623,2023-01-31,,526.98
6218,38038623,2023-02-05,1345.1,1872.08
6219,38038623,2023-02-06,-55.26,1816.82
6220,38038623,2023-02-10,-124.93,1691.8899999999999
6221,38038623,2023-02-13,-148.57,1543.32
6222,38038623,2023-02-14,-195.92,1347.3999999999999
6223,38124225,2023-01-31,,943.59
6224,38124225,2023-02-05,107.79,1051.38
6225,38124225,2023-02-08,91.24,1142.6200000000001
6226,38124225,2023-02-08,-114.16,1028.46
6227,38124225,2023-02-09,-101.24,927.22
6228,38124225,2023-02-09,-145.58,781.6400000000001
6229,38124225,2023-02-10,114.32,895.96
6230,38124225,2023-02-10,63.35,959.3100000000001
6231,38124225,2023-02-13,65.9,1025.21
6232,38157078,2023-01-31,,756.55
6233,38157078,2023-02-04,664.6,1421.15
6234,38157078,2023-02-07,-86.52,1334.6299999999999
6235,38157078,2023-02-13,-169.97,1164.6599999999999
6236,38224160,2023-01-31,,701.82
6237,38224160,2023-02-02,-92.9,608.9200000000001
6238,38224160,2023-02-03,-119.1,489.82000000000005
6239,38224160,2023-02-07,-75.95,413.87000000000006
6240,38224160,2023-02-13,-76.04,337.83000000000004
6241,38291062,2023-01-31,,486.68
6242,38291062,2023-02-01,-82.42,404.26
6243,38291062,2023-02-05,-78.67,325.59000000000003
6244,38291062,2023-02-06,246.82,572.41
6245,38291062,2023-02-11,1.71,574.12
6246,38291062,2023-02-12,-119.93,454.19
6247,38291062,2023-02-14,77.33,531.52
6248,38291062,2023-02-14,-105.25,426.27
6249,38316158,2023-01-31,,138.4
6250,38316158,2023-02-02,74.49,212.89
6251,38316158,2023-02-05,227.66,440.55
6252,38316158,2023-02-05,92.28,532.83
6253,38316158,2023-02-07,35.98,568.8100000000001
6254,38316158,2023-02-08,24.76,593.57
6255,38316158,2023-02-14,-53.27,540.3
6256,38346624,2023-01-31,,740.09
6257,38346624,2023-02-10,737.2,1477.29
6258,38346624,2023-02-10,185.21,1662.5
6259,38395807,2023-01-31,,463.52
6260,38395807,2023-02-07,144.93,608.45
6261,38395807,2023-02-08,44.05,652.5
6262,38395807,2023-02-09,-40.77,611.73
6263,38395807,2023-02-12,91.23,702.96
6264,38428295,2023-01-31,,690.12
6265,38428295,2023-02-08,-199.46,490.65999999999997
6266,38428295,2023-02-11,-167.56,323.1
6267,38428295,2023-02-13,-128.11,194.98999999999998
6268,38428295,2023-02-14,-170.29,24.69999999999999
6269,38429514,2023-01-31,,627.62
6270,38429514,2023-02-01,-72.18,555.44
6271,38429514,2023-02-04,-119.83,435.61
6272,38429514,2023-02-08,-108.02,327.59000000000003
6273,38429514,2023-02-10,-139.76,187.83
6274,38429514,2023-02-11,47.32,235.15
6275,38429514,2023-02-12,102.95,338.1
6276,38429514,2023-02-14,53.96,392.06
6277,38442044,2023-01-31,,106.95
6278,38442044,2023-02-02,64.9,171.85000000000002
6279,38442044,2023-02-03,-23.84,148.01000000000002
6280,38442044,2023-02-06,50.95,198.96
6281,38442044,2023-02-07,113.13,312.09000000000003
6282,38442044,2023-02-07,-144.16,167.93
6283,38442044,2023-02-07,-152.25,15.680000000000007
6284,38442044,2023-02-08,57.77,73.45000000000002
6285,38442044,2023-02-08,34.12,107.57000000000001
6286,38442044,2023-02-12,98.65,206.22000000000003
6287,38442044,2023-02-14,860.1,1066.3200000000002
6288,38487215,2023-01-31,,780.01
6289,38487215,2023-02-01,808.4,1588.4099999999999
6290,38487215,2023-02-03,118.95,1707.36
6291,38487215,2023-02-03,-128.1,1579.26
6292,38487215,2023-02-06,-1543.0,36.25999999999999
6293,38495059,2023-01-31,,14.18
6294,38495059,2023-02-02,-36.6,-22.42
6295,38495059,2023-02-06,-42.54,-64.96000000000001
6296,38495059,2023-02-11,-136.0,-200.96
6297,38502892,2023-01-31,,600.32
6298,38502892,2023-02-06,-62.08,538.24
6299,38502892,2023-02-07,71.61,609.85
6300,38502892,2023-02-08,-47.37,562.48
6301,38528119,2023-01-31,,165.9
6302,38528119,2023-02-06,78.29,244.19
6303,38528119,2023-02-06,-191.25,52.94
6304,38528119,2023-02-08,-167.66,-114.72
6305,38528119,2023-02-13,168.95,54.22999999999999
6306,38528119,2023-02-14,116.52,170.75
6307,38558525,2023-01-31,,833.07
6308,38558525,2023-02-04,62.25,895.32
6309,38558525,2023-02-07,1819.0,2714.32
6310,38558525,2023-02-08,194.3,2908.6200000000003
6311,38564653,2023-01-31,,647.95
6312,38564653,2023-02-03,3.5,651.45
6313,38564653,2023-02-05,104.58,756.0300000000001
6314,38564653,2023-02-12,133.45,889.48
6315,38564653,2023-02-13,93.97,983.45
6316,38587383,2023-01-31,,579.12
6317,38587383,2023-02-01,81.07,660.19
6318,38587383,2023-02-01,-146.1,514.09
6319,38587383,2023-02-03,110.66,624.75
6320,38587383,2023-02-03,-39.37,585.38
6321,38587383,2023-02-04,-162.1,423.28
6322,38587383,2023-02-07,124.31,547.59
6323,38587383,2023-02-07,-166.27,381.32
6324,38587383,2023-02-09,-118.41,262.90999999999997
6325,38587383,2023-02-12,-37.14,225.76999999999998
6326,38587383,2023-02-12,-82.59,143.18
6327,38606148,2023-01-31,,956.59
6328,38606148,2023-02-02,-111.16,845.4300000000001
6329,38606148,2023-02-04,67.91,913.34
6330,38606148,2023-02-04,-72.53,840.8100000000001
6331,38606148,2023-02-06,-26.04,814.77
6332,38606148,2023-02-11,-132.56,682.21
6333,38606148,2023-02-12,131.58,813.7900000000001
6334,38606148,2023-02-12,-1323.4,-509.61
6335,38627867,2023-01-31,,132.74
6336,38627867,2023-02-05,-99.91,32.83000000000001
6337,38627867,2023-02-06,70.94,103.77000000000001
6338,38627867,2023-02-14,-102.09,1.6800000000000068
6339,38690875,2023-01-31,,320.39
6340,38690875,2023-02-03,-126.21,194.18
6341,38690875,2023-02-06,-198.2,-4.019999999999982
6342,38690875,2023-02-11,-147.09,-151.10999999999999
6343,38690875,2023-02-13,-76.09,-227.2
6344,38690875,2023-02-13,-104.24,-331.44
6345,38690875,2023-02-14,-122.9,-454.34
6346,38740782,2023-01-31,,702.64
6347,38740782,2023-02-04,-133.55,569.0899999999999
6348,38740782,2023-02-05,-61.09,508.0
6349,38740782,2023-02-12,76.1,584.0999999999999
6350,38740782,2023-02-12,-84.07,500.03
6351,38749064,2023-01-31,,569.98
6352,38749064,2023-02-01,143.97,713.95
6353,38749064,2023-02-02,-1436.3,-722.3499999999999
6354,38749064,2023-02-03,89.06,-633.29
6355,38749064,2023-02-14,138.71,-494.5799999999999
6356,38764064,2023-01-31,,648.12
6357,38764064,2023-02-01,52.17,700.29
6358,38764064,2023-02-02,15.8,716.09
6359,38764064,2023-02-07,106.64,822.73
6360,38764064,2023-02-09,32.87,855.6
6361,38764064,2023-02-11,9.25,864.85
6362,38764064,2023-02-13,96.51,961.36
6363,38764064,2023-02-14,58.88,1020.24
6364,38780970,2023-01-31,,846.59
6365,38780970,2023-02-01,-118.27,728.32
6366,38780970,2023-02-04,117.26,845.58
6367,38780970,2023-02-07,54.28,899.86
6368,38780970,2023-02-10,47.87,947.73
6369,38780970,2023-02-13,-838.9,108.83000000000004
6370,38839019,2023-01-31,,187.15
6371,38839019,2023-02-01,937.1,1124.25
6372,38839019,2023-02-01,-52.99,1071.26
6373,38839019,2023-02-02,-156.04,915.22
6374,38839019,2023-02-08,113.98,1029.2
6375,38839019,2023-02-11,106.4,1135.6
6376,38839019,2023-02-11,-164.37,971.23
6377,38839019,2023-02-14,170.57,1141.8
6378,38903150,2023-01-31,,263.28
6379,38903150,2023-02-03,-96.77,166.51
6380,38903150,2023-02-04,-128.19,38.31999999999999
6381,38903150,2023-02-07,-188.36,-150.04000000000002
6382,38903150,2023-02-10,153.84,3.799999999999983
6383,38903150,2023-02-10,84.17,87.96999999999998
6384,38903150,2023-02-11,-133.59,-45.62000000000002
6385,38903150,2023-02-14,-1157.1,-1202.72
6386,38921478,2023-01-31,,641.48
6387,38921478,2023-02-02,112.16,753.64
6388,38921478,2023-02-03,-7.7,745.94
6389,38921478,2023-02-04,-90.13,655.8100000000001
6390,38921478,2023-02-05,69.58,725.39
6391,38921478,2023-02-05,-1292.8,-567.41
6392,38921478,2023-02-07,46.92,-520.49
6393,38921478,2023-02-10,-114.74,-635.23
6394,38921478,2023-02-12,105.2,-530.03
6395,38921478,2023-02-13,-43.56,-573.5899999999999
6396,38921478,2023-02-14,-130.84,-704.43
6397,38957380,2023-01-31,,37.95
6398,38957380,2023-02-02,-117.9,-79.95
6399,38957380,2023-02-03,75.66,-4.290000000000006
6400,38957380,2023-02-04,88.83,84.53999999999999
6401,38957380,2023-02-07,-112.51,-27.970000000000013
6402,38957380,2023-02-07,-123.7,-151.67000000000002
6403,38957380,2023-02-07,-133.96,-285.63
6404,38957380,2023-02-10,167.95,-117.68000000000004
6405,38957380,2023-02-10,121.27,3.589999999999961
6406,38957380,2023-02-13,-128.09,-124.50000000000004
6407,38969279,2023-01-31,,195.74
6408,38969279,2023-02-02,148.09,343.83000000000004
6409,38969279,2023-02-04,1579.8,1923.63
6410,38969279,2023-02-04,-5.54,1918.09
6411,38969279,2023-02-05,177.45,2095.54
6412,38969279,2023-02-05,-2160.7,-65.15999999999985
6413,38969279,2023-02-06,1037.3,972.1400000000001
6414,38969279,2023-02-10,1499.1,2471.24
6415,38969279,2023-02-12,103.8,2575.04
6416,38990596,2023-01-31,,108.78
6417,38990596,2023-02-03,1462.8,1571.58
6418,38990596,2023-02-07,1348.3,2919.88
6419,38990596,2023-02-07,-24.33,2895.5499999999997
6420,38990596,2023-02-10,125.04,3020.5899999999997
6421,38990596,2023-02-12,-93.42,2927.17
6422,38990596,2023-02-13,-122.16,2805.0099999999998
6423,38991889,2023-01-31,,292.35
6424,38991889,2023-02-05,-104.95,187.40000000000003
6425,38991889,2023-02-08,-162.63,24.77000000000004
6426,38991889,2023-02-10,23.96,48.73000000000004
6427,38991889,2023-02-10,-75.71,-26.979999999999954
6428,38991889,2023-02-12,129.0,102.02000000000004
6429,38991889,2023-02-14,-38.92,63.10000000000004
6430,39001531,2023-01-31,,882.34
6431,39001531,2023-02-03,-68.13,814.21
6432,39001531,2023-02-06,-48.43,765.7800000000001
6433,39001531,2023-02-10,-167.95,597.83
6434,39001531,2023-02-13,-110.74,487.09000000000003
6435,39013360,2023-01-31,,987.76
6436,39013360,2023-02-02,111.21,1098.97
6437,39013360,2023-02-03,183.87,1282.84
6438,39013360,2023-02-07,-80.19,1202.65
6439,39013360,2023-02-12,160.33,1362.98
6440,39013360,2023-02-12,114.77,1477.75
6441,39013360,2023-02-12,108.16,1585.91
6442,39013360,2023-02-12,93.42,1679.33
6443,39013360,2023-02-12,-1663.0,16.329999999999927
6444,39061853,2023-01-31,,353.93
6445,39061853,2023-02-01,98.05,451.98
6446,39061853,2023-02-03,118.33,570.31
6447,39061853,2023-02-03,106.6,676.91
6448,39061853,2023-02-04,74.21,751.12
6449,39061853,2023-02-04,0.23,751.35
6450,39061853,2023-02-04,-58.86,692.49
6451,39061853,2023-02-05,-117.54,574.95
6452,39061853,2023-02-07,-100.32,474.63
6453,39061853,2023-02-09,-185.1,289.53
6454,39061853,2023-02-12,-86.65,202.88
6455,39061853,2023-02-14,-82.4,120.47999999999999
6456,39093565,2023-01-31,,107.2
6457,39093565,2023-02-04,-178.94,-71.74
6458,39093565,2023-02-08,-1872.8,-1944.54
6459,39093565,2023-02-10,92.49,-1852.05
6460,39097663,2023-01-31,,326.42
6461,39097663,2023-02-02,124.78,451.20000000000005
6462,39097663,2023-02-08,67.17,518.37
6463,39097663,2023-02-12,125.48,643.85
6464,39097663,2023-02-12,-40.07,603.78
6465,39122920,2023-01-31,,445.68
6466,39122920,2023-02-08,124.8,570.48
6467,39122920,2023-02-08,66.97,637.45
6468,39122920,2023-02-09,134.75,772.2
6469,39122920,2023-02-10,124.93,897.13
6470,39122920,2023-02-12,56.08,953.21
6471,39122920,2023-02-12,-111.7,841.51
6472,39122920,2023-02-13,96.04,937.55
6473,39122920,2023-02-13,22.49,960.04
6474,39122920,2023-02-14,-75.01,885.03
6475,39122920,2023-02-14,-142.18,742.8499999999999
6476,39123048,2023-01-31,,687.59
6477,39123048,2023-02-01,83.41,771.0
6478,39123048,2023-02-01,-92.64,678.36
6479,39123048,2023-02-03,-87.46,590.9000000000001
6480,39123048,2023-02-03,-513.3,77.60000000000014
6481,39123048,2023-02-08,-135.88,-58.27999999999986
6482,39123048,2023-02-09,-140.35,-198.62999999999985
6483,39123048,2023-02-09,-157.79,-356.41999999999985
6484,39123048,2023-02-10,-13.9,-370.3199999999998
6485,39123048,2023-02-12,-122.43,-492.7499999999999
6486,39123048,2023-02-14,140.0,-352.7499999999999
6487,39160879,2023-01-31,,444.15
6488,39160879,2023-02-01,-186.89,257.26
6489,39160879,2023-02-04,133.05,390.31
6490,39160879,2023-02-13,838.9,1229.21
6491,39160879,2023-02-14,302.7,1531.9099999999999
6492,39161053,2023-01-31,,375.28
6493,39161053,2023-02-01,142.14,517.42
6494,39161053,2023-02-01,-156.89,360.53
6495,39161053,2023-02-02,93.84,454.37
6496,39161053,2023-02-03,103.43,557.8
6497,39161053,2023-02-05,480.6,1038.4
6498,39161053,2023-02-05,-137.15,901.25
6499,39161053,2023-02-07,53.14,954.39
6500,39161053,2023-02-14,-114.68,839.7099999999999
6501,39267013,2023-01-31,,516.74
6502,39267013,2023-02-02,-1495.8,-979.06
6503,39267013,2023-02-03,-67.76,-1046.82
6504,39267013,2023-02-04,-68.14,-1114.96
6505,39267013,2023-02-12,-89.62,-1204.58
6506,39267013,2023-02-14,-143.79,-1348.37
6507,39298122,2023-01-31,,607.25
6508,39298122,2023-02-01,135.0,742.25
6509,39298122,2023-02-02,122.54,864.79
6510,39298122,2023-02-03,193.29,1058.08
6511,39298122,2023-02-06,-885.9,172.18000000000006
6512,39298122,2023-02-08,-154.47,17.710000000000065
6513,39298122,2023-02-12,-53.57,-35.859999999999935
6514,39298122,2023-02-13,-32.94,-68.79999999999993
6515,39360799,2023-01-31,,379.72
6516,39360799,2023-02-01,-98.45,281.27000000000004
6517,39360799,2023-02-01,-137.25,144.02000000000004
6518,39360799,2023-02-01,-1634.7,-1490.68
6519,39360799,2023-02-07,43.24,-1447.44
6520,39360799,2023-02-13,117.96,-1329.48
6521,39386771,2023-01-31,,171.52
6522,39386771,2023-02-02,99.44,270.96000000000004
6523,39386771,2023-02-02,-87.3,183.66000000000003
6524,39386771,2023-02-04,-94.61,89.05000000000001
6525,39386771,2023-02-04,-162.76,-73.70999999999998
6526,39386771,2023-02-10,107.08,33.37000000000002
6527,39386771,2023-02-10,85.88,119.25000000000001
6528,39386771,2023-02-10,-57.19,62.06000000000002
6529,39398476,2023-01-31,,541.52
6530,39398476,2023-02-02,106.61,648.13
6531,39398476,2023-02-07,116.86,764.99
6532,39398476,2023-02-10,100.16,865.15
6533,39400991,2023-01-31,,896.44
6534,39400991,2023-02-05,10.32,906.7600000000001
6535,39400991,2023-02-11,38.45,945.21
6536,39400991,2023-02-13,93.58,1038.79
6537,39402264,2023-01-31,,993.04
6538,39402264,2023-02-01,1255.3,2248.34
6539,39402264,2023-02-05,126.99,2375.33
6540,39402264,2023-02-07,99.51,2474.84
6541,39402264,2023-02-07,-98.93,2375.91
6542,39402264,2023-02-11,-1949.6,426.30999999999995
6543,39402264,2023-02-14,-117.68,308.62999999999994
6544,39402264,2023-02-14,-241.71,66.91999999999993
6545,39427922,2023-01-31,,794.1
6546,39427922,2023-02-01,-131.53,662.57
6547,39427922,2023-02-02,145.85,808.4200000000001
6548,39427922,2023-02-03,140.5,948.9200000000001
6549,39427922,2023-02-04,-163.28,785.64
6550,39427922,2023-02-07,-146.82,638.82
6551,39427922,2023-02-08,-117.07,521.75
6552,39427922,2023-02-13,30.41,552.1600000000001
6553,39427922,2023-02-14,-163.28,388.88
6554,39491241,2023-01-31,,564.0
6555,39491241,2023-02-02,100.0,664.0
6556,39491241,2023-02-05,122.18,786.1800000000001
6557,39491241,2023-02-06,79.45,865.63
6558,39491241,2023-02-08,115.63,981.26
6559,39491241,2023-02-12,80.63,1061.89
6560,39491241,2023-02-12,-120.9,940.99
6561,39502821,2023-01-31,,924.88
6562,39502821,2023-02-03,321.6,1246.48
6563,39502821,2023-02-03,-28.45,1218.03
6564,39502821,2023-02-05,26.93,1244.96
6565,39502821,2023-02-09,-59.28,1185.68
6566,39502821,2023-02-09,-136.48,1049.2
6567,39502821,2023-02-12,-206.28,842.9200000000001
6568,39504855,2023-01-31,,890.63
6569,39504855,2023-02-02,118.6,1009.23
6570,39504855,2023-02-05,-124.37,884.86
6571,39504855,2023-02-06,55.26,940.12
6572,39504855,2023-02-11,1000.2,1940.3200000000002
6573,39504855,2023-02-11,-93.32,1847.0
6574,39504855,2023-02-12,3.07,1850.0700000000002
6575,39504855,2023-02-14,-72.35,1777.72
6576,39516154,2023-01-31,,620.87
6577,39516154,2023-02-02,-1273.1,-652.2299999999999
6578,39516154,2023-02-06,22.66,-629.5699999999999
6579,39516154,2023-02-11,-1094.0,-1723.57
6580,39516154,2023-02-12,-106.02,-1829.59
6581,39516154,2023-02-13,157.09,-1672.5
6582,39516154,2023-02-13,-62.08,-1734.58
6583,39516203,2023-01-31,,689.19
6584,39516203,2023-02-03,129.19,818.3800000000001
6585,39516203,2023-02-07,-186.08,632.3000000000001
6586,39516203,2023-02-10,93.02,725.32
6587,39516203,2023-02-11,30.47,755.7900000000001
6588,39516203,2023-02-11,23.0,778.7900000000001
6589,39516203,2023-02-13,-112.31,666.48
6590,39516203,2023-02-14,172.96,839.44
6591,39529729,2023-01-31,,425.66
6592,39529729,2023-02-01,86.44,512.1
6593,39529729,2023-02-02,38.74,550.84
6594,39529729,2023-02-06,35.38,586.22
6595,39529729,2023-02-07,-78.85,507.37
6596,39529729,2023-02-11,-226.92,280.45000000000005
6597,39529729,2023-02-12,100.01,380.46000000000004
6598,39529729,2023-02-13,-63.85,316.61000000000007
6599,39542358,2023-01-31,,671.28
6600,39542358,2023-02-06,-48.45,622.8299999999999
6601,39542358,2023-02-07,107.26,730.0899999999999
6602,39542358,2023-02-08,522.3,1252.3899999999999
6603,39542358,2023-02-08,257.4,1509.79
6604,39542358,2023-02-08,-71.61,1438.1799999999998
6605,39542358,2023-02-10,-125.04,1313.1399999999999
6606,39542358,2023-02-11,2361.6,3674.74
6607,39542358,2023-02-11,1168.2,4842.94
6608,39542358,2023-02-11,-62.18,4780.76
6609,39590347,2023-01-31,,180.22
6610,39590347,2023-02-04,-35.8,144.42000000000002
6611,39590347,2023-02-05,-101.45,42.97
6612,39590347,2023-02-09,-165.46,-122.49000000000001
6613,39590347,2023-02-12,-57.89,-180.38
6614,39590347,2023-02-12,-133.67,-314.05
6615,39602737,2023-01-31,,881.44
6616,39602737,2023-02-06,83.89,965.33
6617,39602737,2023-02-13,-95.71,869.6200000000001
6618,39620163,2023-01-31,,126.08
6619,39620163,2023-02-03,-126.76,-0.6800000000000068
6620,39620163,2023-02-05,-193.2,-193.88
6621,39620163,2023-02-09,-59.74,-253.62
6622,39620163,2023-02-10,27.61,-226.01
6623,39620163,2023-02-12,122.43,-103.57999999999998
6624,39620163,2023-02-12,-105.79,-209.37
6625,39620163,2023-02-14,-99.23,-308.6
6626,39623640,2023-01-31,,617.74
6627,39623640,2023-02-03,141.26,759.0
6628,39623640,2023-02-03,62.98,821.98
6629,39623640,2023-02-03,-163.12,658.86
6630,39623640,2023-02-09,-136.79,522.0699999999999
6631,39623640,2023-02-09,-176.29,345.78
6632,39623640,2023-02-10,-186.7,159.08
6633,39623640,2023-02-11,94.12,253.20000000000002
6634,39662559,2023-01-31,,536.88
6635,39662559,2023-02-06,106.77,643.65
6636,39662559,2023-02-08,-45.23,598.42
6637,39662559,2023-02-09,140.11,738.53
6638,39662559,2023-02-09,78.03,816.56
6639,39662559,2023-02-13,45.1,861.66
6640,39684993,2023-01-31,,168.99
6641,39684993,2023-02-03,612.6,781.59
6642,39684993,2023-02-04,102.22,883.8100000000001
6643,39684993,2023-02-05,27.15,910.96
6644,39684993,2023-02-06,-146.22,764.74
6645,39684993,2023-02-08,83.02,847.76
6646,39684993,2023-02-14,47.11,894.87
6647,39710099,2023-01-31,,155.88
6648,39710099,2023-02-01,105.76,261.64
6649,39710099,2023-02-02,-191.44,70.19999999999999
6650,39710099,2023-02-05,-63.96,6.239999999999988
6651,39710099,2023-02-09,-105.33,-99.09
6652,39710099,2023-02-11,-82.76,-181.85000000000002
6653,39710099,2023-02-13,-211.13,-392.98
6654,39744047,2023-01-31,,505.93
6655,39744047,2023-02-08,103.57,609.5
6656,39744047,2023-02-14,1583.4,2192.9
6657,39744047,2023-02-14,-55.79,2137.11
6658,39749381,2023-01-31,,576.13
6659,39749381,2023-02-02,-70.63,505.5
6660,39749381,2023-02-03,16.93,522.43
6661,39749381,2023-02-03,-207.91,314.52
6662,39749381,2023-02-04,91.7,406.22
6663,39749381,2023-02-06,158.11,564.33
6664,39749381,2023-02-06,142.55,706.8800000000001
6665,39749381,2023-02-08,183.05,889.9300000000001
6666,39749381,2023-02-08,49.6,939.5300000000001
6667,39749381,2023-02-09,-156.71,782.82
6668,39749381,2023-02-11,-143.94,638.8800000000001
6669,39749381,2023-02-14,52.36,691.24
6670,39772392,2023-01-31,,370.34
6671,39772392,2023-02-01,101.28,471.62
6672,39772392,2023-02-01,-116.66,354.96
6673,39772392,2023-02-02,179.0,533.96
6674,39772392,2023-02-03,7.7,541.66
6675,39772392,2023-02-08,38.27,579.93
6676,39772392,2023-02-09,-108.57,471.36
6677,39772392,2023-02-10,171.22,642.5799999999999
6678,39822234,2023-01-31,,718.73
6679,39822234,2023-02-02,681.0,1399.73
6680,39822234,2023-02-02,97.9,1497.63
6681,39822234,2023-02-04,113.62,1611.25
6682,39822234,2023-02-05,17.88,1629.13
6683,39822234,2023-02-09,159.54,1788.67
6684,39822234,2023-02-09,40.77,1829.44
6685,39822234,2023-02-10,-849.7,979.74
6686,39822234,2023-02-14,64.1,1043.84
6687,39863459,2023-01-31,,387.4
6688,39863459,2023-02-02,-121.1,266.29999999999995
6689,39863459,2023-02-04,-48.63,217.67
6690,39863459,2023-02-13,101.87,319.53999999999996
6691,39863459,2023-02-13,-123.49,196.05
6692,39875057,2023-01-31,,126.02
6693,39875057,2023-02-05,-149.4,-23.38000000000001
6694,39875057,2023-02-09,-115.89,-139.27
6695,39875057,2023-02-11,96.34,-42.93000000000001
6696,39875057,2023-02-11,-126.5,-169.43
6697,39875057,2023-02-13,153.16,-16.27000000000001
6698,39875057,2023-02-14,-104.45,-120.72000000000001
6699,39920664,2023-01-31,,627.45
6700,39920664,2023-02-06,101.84,729.2900000000001
6701,39920664,2023-02-10,190.65,919.94
6702,39920664,2023-02-10,-72.61,847.33
6703,39974803,2023-01-31,,567.93
6704,39974803,2023-02-04,85.93,653.8599999999999
6705,39974803,2023-02-04,-39.82,614.04
6706,39974803,2023-02-07,-131.84,482.19999999999993
6707,39974803,2023-02-08,86.91,569.1099999999999
6708,39974803,2023-02-10,74.29,643.4
6709,40004707,2023-01-31,,206.15
6710,40004707,2023-02-04,74.84,280.99
6711,40004707,2023-02-12,111.7,392.69
6712,40039031,2023-01-31,,124.72
6713,40039031,2023-02-02,792.0,916.72
6714,40039031,2023-02-07,-1581.8,-665.0799999999999
6715,40039031,2023-02-08,157.28,-507.79999999999995
6716,40039031,2023-02-08,-35.13,-542.93
6717,40039031,2023-02-09,97.15,-445.7799999999999
6718,40039031,2023-02-12,-43.72,-489.4999999999999
6719,40039031,2023-02-14,-134.52,-624.02
6720,40048102,2023-01-31,,519.25
6721,40048102,2023-02-03,103.29,622.54
6722,40048102,2023-02-06,-43.89,578.65
6723,40048102,2023-02-08,-811.2,-232.55000000000007
6724,40048102,2023-02-09,-119.86,-352.4100000000001
6725,40048102,2023-02-10,168.35,-184.06000000000006
6726,40048102,2023-02-12,20.81,-163.25000000000006
6727,40082477,2023-01-31,,171.74
6728,40082477,2023-02-01,-131.11,40.629999999999995
6729,40082477,2023-02-07,86.16,126.78999999999999
6730,40082477,2023-02-09,1434.1,1560.8899999999999
6731,40082477,2023-02-09,135.47,1696.36
6732,40082477,2023-02-11,-49.15,1647.2099999999998
6733,40082477,2023-02-13,121.9,1769.11
6734,40082477,2023-02-14,120.81,1889.9199999999998
6735,40082950,2023-01-31,,322.41
6736,40082950,2023-02-04,40.4,362.81
6737,40082950,2023-02-04,-80.37,282.44000000000005
6738,40082950,2023-02-08,169.4,451.84000000000003
6739,40082950,2023-02-08,149.73,601.57
6740,40082950,2023-02-12,171.12,772.69
6741,40091206,2023-01-31,,812.34
6742,40091206,2023-02-01,86.72,899.0600000000001
6743,40091206,2023-02-08,-118.11,780.95
6744,40091206,2023-02-09,-11.2,769.75
6745,40091206,2023-02-11,-36.38,733.37
6746,40091206,2023-02-12,157.02,890.3900000000001
6747,40091206,2023-02-13,67.73,958.12
6748,40098771,2023-01-31,,742.62
6749,40098771,2023-02-03,-47.78,694.84
6750,40098771,2023-02-08,-145.4,549.44
6751,40098771,2023-02-10,62.82,612.26
6752,40098771,2023-02-10,-93.3,518.96
6753,40098771,2023-02-11,-60.09,458.87
6754,40098771,2023-02-14,71.12,529.99
6755,40098912,2023-01-31,,951.18
6756,40098912,2023-02-08,54.56,1005.74
6757,40098912,2023-02-10,78.83,1084.57
6758,40098912,2023-02-11,47.98,1132.55
6759,40098912,2023-02-14,109.46,1242.01
6760,40112082,2023-01-31,,289.68
6761,40112082,2023-02-04,-97.86,191.82
6762,40112082,2023-02-12,-168.73,23.090000000000032
6763,40112082,2023-02-13,-113.44,-90.34999999999997
6764,40127778,2023-01-31,,196.74
6765,40127778,2023-02-01,-85.77,110.97000000000001
6766,40127778,2023-02-02,-205.49,-94.52
6767,40127778,2023-02-05,-26.38,-120.89999999999999
6768,40127778,2023-02-05,-179.9,-300.8
6769,40127778,2023-02-07,-159.97,-460.77
6770,40127778,2023-02-10,-90.86,-551.63
6771,40127778,2023-02-11,-832.5,-1384.13
6772,40127778,2023-02-14,-65.19,-1449.32
6773,40176462,2023-01-31,,193.24
6774,40176462,2023-02-02,744.2,937.44
6775,40176462,2023-02-05,276.4,1213.8400000000001
6776,40176462,2023-02-06,77.47,1291.31
6777,40176462,2023-02-08,141.03,1432.3400000000001
6778,40176462,2023-02-10,-116.72,1315.6200000000001
6779,40176462,2023-02-13,33.75,1349.3700000000001
6780,40189934,2023-01-31,,804.21
6781,40189934,2023-02-02,1824.3,2628.51
6782,40189934,2023-02-04,-1705.8,922.71
6783,40189934,2023-02-07,64.02,986.73
6784,40189934,2023-02-13,-108.27,878.46
6785,40224914,2023-01-31,,53.1
6786,40224914,2023-02-01,8.07,61.17
6787,40224914,2023-02-05,-104.89,-43.72
6788,40224914,2023-02-13,-39.74,-83.46000000000001
6789,40224914,2023-02-14,91.53,8.069999999999993
6790,40247376,2023-01-31,,209.78
6791,40247376,2023-02-02,58.7,268.48
6792,40247376,2023-02-04,-124.72,143.76
6793,40247376,2023-02-11,-91.93,51.83
6794,40247376,2023-02-12,-38.33,13.5
6795,40247376,2023-02-13,-49.9,-36.4
6796,40374724,2023-01-31,,692.58
6797,40374724,2023-02-01,-187.15,505.43000000000006
6798,40374724,2023-02-02,36.32,541.75
6799,40374724,2023-02-03,105.36,647.11
6800,40374724,2023-02-04,97.05,744.1600000000001
6801,40374724,2023-02-04,84.48,828.6400000000001
6802,40374724,2023-02-04,-40.4,788.24
6803,40374724,2023-02-05,62.34,850.58
6804,40374724,2023-02-05,-63.32,787.26
6805,40374724,2023-02-06,-160.25,627.01
6806,40374724,2023-02-09,-60.37,566.6400000000001
6807,40374724,2023-02-10,58.79,625.4300000000001
6808,40374724,2023-02-14,1139.7,1765.13
6809,40374724,2023-02-14,-95.2,1669.93
6810,40436811,2023-01-31,,445.93
6811,40436811,2023-02-03,-40.33,405.6
6812,40436811,2023-02-03,-55.47,350.13
6813,40436811,2023-02-08,-66.67,283.46000000000004
6814,40436811,2023-02-11,42.48,325.94
6815,40436811,2023-02-13,30.92,356.86
6816,40436811,2023-02-13,-81.01,275.85
6817,40507682,2023-01-31,,524.63
6818,40507682,2023-02-01,86.68,611.31
6819,40507682,2023-02-02,-83.88,527.4300000000001
6820,40507682,2023-02-08,53.13,580.5600000000001
6821,40507682,2023-02-10,-74.41,506.15
6822,40507682,2023-02-12,118.43,624.58
6823,40507682,2023-02-12,-77.47,547.11
6824,40507682,2023-02-13,76.49,623.6
6825,40507682,2023-02-14,1514.1,2137.7
6826,40530538,2023-01-31,,364.98
6827,40530538,2023-02-06,-13.61,351.37
6828,40530538,2023-02-06,-16.08,335.29
6829,40530538,2023-02-06,-87.21,248.08000000000004
6830,40530538,2023-02-07,166.24,414.32000000000005
6831,40530538,2023-02-07,27.47,441.7900000000001
6832,40530538,2023-02-13,-112.38,329.4100000000001
6833,40548885,2023-01-31,,160.32
6834,40548885,2023-02-04,-25.82,134.5
6835,40548885,2023-02-05,130.7,265.2
6836,40548885,2023-02-07,117.32,382.52
6837,40548885,2023-02-12,56.37,438.89
6838,40548885,2023-02-13,334.9,773.79
6839,40548885,2023-02-14,-68.84,704.9499999999999
6840,40550712,2023-01-31,,511.4
6841,40550712,2023-02-05,85.05,596.4499999999999
6842,40550712,2023-02-06,-72.25,524.1999999999999
6843,40550712,2023-02-06,-98.85,425.34999999999997
6844,40550712,2023-02-07,-112.11,313.24
6845,40550712,2023-02-09,-84.03,229.20999999999998
6846,40550712,2023-02-11,149.28,378.49
6847,40551490,2023-01-31,,569.45
6848,40551490,2023-02-04,95.01,664.46
6849,40551490,2023-02-04,-761.9,-97.43999999999994
6850,40551490,2023-02-05,101.23,3.790000000000063
6851,40551490,2023-02-12,76.51,80.30000000000007
6852,40600852,2023-01-31,,15.08
6853,40600852,2023-02-01,57.48,72.56
6854,40600852,2023-02-01,32.39,104.94999999999999
6855,40600852,2023-02-06,157.94,262.89
6856,40600852,2023-02-08,-146.43,116.45999999999998
6857,40600852,2023-02-09,24.49,140.95
6858,40600852,2023-02-10,-34.9,106.04999999999998
6859,40600852,2023-02-11,154.67,260.71999999999997
6860,40600852,2023-02-11,-111.87,148.84999999999997
6861,40600852,2023-02-11,-667.1,-518.25
6862,40600852,2023-02-13,-93.21,-611.4600000000002
6863,40631802,2023-01-31,,104.96
6864,40631802,2023-02-02,136.28,241.24
6865,40631802,2023-02-02,-528.9,-287.65999999999997
6866,40631802,2023-02-04,189.3,-98.35999999999996
6867,40631802,2023-02-06,136.61,38.25000000000006
6868,40631802,2023-02-08,-714.2,-675.95
6869,40631802,2023-02-10,-92.9,-768.85
6870,40673170,2023-01-31,,124.66
6871,40673170,2023-02-01,95.49,220.14999999999998
6872,40673170,2023-02-04,-103.05,117.1
6873,40673170,2023-02-06,-80.15,36.94999999999999
6874,40673170,2023-02-08,123.3,160.25
6875,40673170,2023-02-13,14.09,174.33999999999997
6876,40712298,2023-01-31,,781.72
6877,40712298,2023-02-06,107.96,889.6800000000001
6878,40712298,2023-02-07,74.11,963.79
6879,40712298,2023-02-11,147.09,1110.88
6880,40745545,2023-01-31,,460.29
6881,40745545,2023-02-01,-85.94,374.35
6882,40745545,2023-02-04,-189.33,185.02
6883,40745545,2023-02-11,159.21,344.23
6884,40745545,2023-02-11,-100.04,244.19
6885,40745545,2023-02-12,-139.58,104.61000000000001
6886,40745545,2023-02-13,121.39,226.0
6887,40745965,2023-01-31,,654.15
6888,40745965,2023-02-01,-1264.3,-610.15
6889,40745965,2023-02-02,-196.6,-806.75
6890,40745965,2023-02-03,77.07,-729.68
6891,40745965,2023-02-05,-98.72,-828.4
6892,40745965,2023-02-07,-42.04,-870.4399999999999
6893,40745965,2023-02-08,-100.85,-971.29
6894,40745965,2023-02-09,111.83,-859.4599999999999
6895,40745965,2023-02-09,-81.65,-941.11
6896,40797438,2023-01-31,,679.38
6897,40797438,2023-02-01,49.69,729.0699999999999
6898,40797438,2023-02-02,-153.46,575.61
6899,40797438,2023-02-03,116.69,692.3
6900,40797438,2023-02-04,-77.37,614.93
6901,40797438,2023-02-06,193.06,807.99
6902,40797438,2023-02-10,98.45,906.4399999999999
6903,40797438,2023-02-12,84.72,991.16
6904,40797438,2023-02-14,-154.35,836.81
6905,40813783,2023-01-31,,288.51
6906,40813783,2023-02-03,130.36,418.87
6907,40813783,2023-02-06,32.2,451.07
6908,40813783,2023-02-07,119.18,570.25
6909,40813783,2023-02-14,-182.1,388.15000000000003
6910,40872555,2023-01-31,,115.88
6911,40872555,2023-02-02,89.7,205.57999999999998
6912,40872555,2023-02-03,-27.83,177.75
6913,40872555,2023-02-04,-1218.0,-1040.25
6914,40872555,2023-02-12,61.6,-978.65
6915,40898013,2023-01-31,,650.33
6916,40898013,2023-02-04,-115.27,535.0600000000001
6917,40898013,2023-02-04,-245.23,289.83000000000004
6918,40898013,2023-02-05,28.46,318.29
6919,40898013,2023-02-06,-68.98,249.31000000000003
6920,40898013,2023-02-09,-30.36,218.95000000000005
6921,40898013,2023-02-11,130.61,349.56000000000006
6922,40898013,2023-02-13,-145.19,204.37000000000006
6923,40906801,2023-01-31,,83.77
6924,40906801,2023-02-01,185.45,269.21999999999997
6925,40906801,2023-02-02,-24.23,244.98999999999998
6926,40906801,2023-02-06,-42.19,202.79999999999995
6927,40906801,2023-02-09,1162.9,1365.7
6928,40906801,2023-02-09,97.54,1463.24
6929,40906801,2023-02-09,39.08,1502.3200000000002
6930,40906801,2023-02-09,-100.36,1401.96
6931,41022448,2023-01-31,,37.89
6932,41022448,2023-02-07,168.78,206.67000000000002
6933,41022448,2023-02-10,-180.01,26.659999999999997
6934,41022448,2023-02-13,-168.95,-142.29
6935,41022448,2023-02-14,161.34,19.05000000000001
6936,41036701,2023-01-31,,249.29
6937,41036701,2023-02-01,-802.6,-553.3100000000001
6938,41036701,2023-02-09,109.88,-443.43000000000006
6939,41036701,2023-02-14,823.0,379.56999999999994
6940,41038634,2023-01-31,,802.08
6941,41038634,2023-02-02,-37.84,764.24
6942,41038634,2023-02-11,-202.15,562.09
6943,41038634,2023-02-14,-120.81,441.28000000000003
6944,41085190,2023-01-31,,78.73
6945,41085190,2023-02-03,113.59,192.32
6946,41085190,2023-02-03,-43.6,148.72
6947,41085190,2023-02-05,37.99,186.71
6948,41085190,2023-02-07,143.04,329.75
6949,41085190,2023-02-07,-1522.0,-1192.25
6950,41085190,2023-02-08,-118.54,-1310.79
6951,41085190,2023-02-08,-1168.1,-2478.89
6952,41085190,2023-02-10,1580.9,-897.9899999999998
6953,41085190,2023-02-12,78.26,-819.7299999999998
6954,41085190,2023-02-14,884.5,64.77000000000021
6955,41085190,2023-02-14,43.95,108.72000000000021
6956,41170515,2023-01-31,,713.46
6957,41170515,2023-02-03,227.05,940.51
6958,41170515,2023-02-10,-1147.5,-206.99
6959,41194009,2023-01-31,,585.15
6960,41194009,2023-02-07,-108.31,476.84
6961,41194009,2023-02-07,-138.38,338.46
6962,41194009,2023-02-09,145.82,484.28
6963,41194009,2023-02-12,-104.69,379.59
6964,41194009,2023-02-13,-53.28,326.30999999999995
6965,41211432,2023-01-31,,205.0
6966,41211432,2023-02-01,87.59,292.59000000000003
6967,41211432,2023-02-01,-80.9,211.69
6968,41211432,2023-02-04,129.37,341.06
6969,41211432,2023-02-07,-60.73,280.33
6970,41211432,2023-02-08,120.67,401.0
6971,41211432,2023-02-10,-97.9,303.1
6972,41211432,2023-02-11,-79.08,224.01999999999998
6973,41245288,2023-01-31,,540.61
6974,41245288,2023-02-05,92.78,633.39
6975,41245288,2023-02-10,59.42,692.8100000000001
6976,41245288,2023-02-10,34.9,727.71
6977,41245288,2023-02-11,87.57,815.28
6978,41245288,2023-02-13,-80.87,734.41
6979,41245288,2023-02-13,-1088.0,-353.59000000000003
6980,41245805,2023-01-31,,753.91
6981,41245805,2023-02-03,-116.55,637.36
6982,41245805,2023-02-04,900.7,1538.06
6983,41245805,2023-02-04,-55.24,1482.8200000000002
6984,41245805,2023-02-04,-176.15,1306.67
6985,41252281,2023-01-31,,834.88
6986,41252281,2023-02-01,148.34,983.22
6987,41252281,2023-02-03,67.76,1050.98
6988,41252281,2023-02-03,19.31,1070.29
6989,41252281,2023-02-03,-89.06,981.23
6990,41252281,2023-02-05,-89.54,891.69
6991,41252281,2023-02-09,787.2,1678.89
6992,41252281,2023-02-10,1052.9,2731.79
6993,41282329,2023-01-31,,80.32
6994,41282329,2023-02-01,-42.27,38.04999999999999
6995,41282329,2023-02-05,1685.4,1723.45
6996,41282329,2023-02-09,-112.38,1611.0700000000002
6997,41282329,2023-02-10,75.67,1686.74
6998,41282329,2023-02-13,1023.0,2709.74
6999,41356963,2023-01-31,,398.3
7000,41356963,2023-02-04,80.86,479.16
7001,41356963,2023-02-05,74.98,554.14
7002,41356963,2023-02-05,-98.47,455.67
7003,41356963,2023-02-06,-125.59,330.08000000000004
7004,41356963,2023-02-09,132.11,462.19000000000005
7005,41420018,2023-01-31,,816.5
7006,41420018,2023-02-02,-118.87,697.63
7007,41420018,2023-02-09,-166.64,530.99
7008,41420018,2023-02-10,114.86,645.85
7009,41420018,2023-02-13,68.86,714.71
7010,41420018,2023-02-14,96.41,811.12
7011,41542689,2023-01-31,,246.73
7012,41542689,2023-02-03,36.94,283.66999999999996
7013,41542689,2023-02-03,-149.87,133.79999999999998
7014,41542689,2023-02-04,-124.08,9.719999999999985
7015,41542689,2023-02-07,-130.23,-120.51
7016,41542689,2023-02-11,106.87,-13.64
7017,41542689,2023-02-12,1255.7,1242.06
7018,41542689,2023-02-13,-67.31,1174.75
7019,41561470,2023-01-31,,750.8
7020,41561470,2023-02-01,490.9,1241.6999999999998
7021,41561470,2023-02-03,144.92,1386.62
7022,41561470,2023-02-04,58.38,1445.0
7023,41561470,2023-02-05,161.25,1606.25
7024,41561470,2023-02-08,195.35,1801.6
7025,41561470,2023-02-11,41.42,1843.02
7026,41561470,2023-02-14,-1083.0,760.02
7027,41574018,2023-01-31,,254.89
7028,41574018,2023-02-01,160.61,415.5
7029,41574018,2023-02-01,-19.88,395.62
7030,41574018,2023-02-05,-118.39,277.23
7031,41574018,2023-02-09,18.91,296.14
7032,41574018,2023-02-11,58.37,354.51
7033,41574018,2023-02-12,145.1,499.61
7034,41574018,2023-02-14,40.82,540.4300000000001
7035,41584073,2023-01-31,,561.74
7036,41584073,2023-02-03,-46.59,515.15
7037,41584073,2023-02-04,91.41,606.56
7038,41584073,2023-02-04,34.22,640.78
7039,41584073,2023-02-05,96.95,737.73
7040,41584073,2023-02-08,-245.8,491.93
7041,41584073,2023-02-10,133.89,625.8199999999999
7042,41584073,2023-02-11,114.84,740.66
7043,41584073,2023-02-12,-70.6,670.06
7044,41664336,2023-01-31,,853.37
7045,41664336,2023-02-01,45.11,898.48
7046,41706310,2023-01-31,,126.08
7047,41706310,2023-02-01,82.09,208.17000000000002
7048,41706310,2023-02-01,71.89,280.06
7049,41706310,2023-02-01,34.17,314.23
7050,41706310,2023-02-03,89.33,403.56
7051,41706310,2023-02-04,-88.18,315.38
7052,41706310,2023-02-05,89.54,404.92
7053,41706310,2023-02-06,-49.54,355.38
7054,41706310,2023-02-06,-114.75,240.63
7055,41706310,2023-02-12,-97.82,142.81
7056,41716822,2023-01-31,,418.05
7057,41716822,2023-02-01,78.07,496.12
7058,41716822,2023-02-06,158.15,654.27
7059,41716822,2023-02-10,106.77,761.04
7060,41716822,2023-02-10,-143.3,617.74
7061,41716822,2023-02-11,125.71,743.45
7062,41716822,2023-02-12,-68.38,675.07
7063,41716822,2023-02-13,-47.15,627.92
7064,41741558,2023-01-31,,435.71
7065,41741558,2023-02-02,-43.55,392.15999999999997
7066,41741558,2023-02-05,57.79,449.95
7067,41741558,2023-02-05,-97.55,352.4
7068,41741558,2023-02-06,-86.91,265.49
7069,41741558,2023-02-07,-112.5,152.98999999999998
7070,41741558,2023-02-09,-58.59,94.39999999999998
7071,41741558,2023-02-09,-101.51,-7.110000000000028
7072,41741558,2023-02-10,-151.6,-158.71000000000004
7073,41741558,2023-02-11,989.3,830.5899999999999
7074,41755476,2023-01-31,,72.71
7075,41755476,2023-02-02,205.22,277.93
7076,41755476,2023-02-02,62.51,340.44
7077,41755476,2023-02-06,59.59,400.03
7078,41755476,2023-02-14,71.18,471.21
7079,41773473,2023-01-31,,355.0
7080,41773473,2023-02-01,68.47,423.47
7081,41773473,2023-02-06,78.99,502.46
7082,41773473,2023-02-12,-118.77,383.69
7083,41778536,2023-01-31,,722.03
7084,41778536,2023-02-02,132.64,854.67
7085,41778536,2023-02-07,34.47,889.14
7086,41778536,2023-02-07,-129.29,759.8499999999999
7087,41778536,2023-02-08,-42.43,717.42
7088,41778536,2023-02-09,859.1,1576.52
7089,41778536,2023-02-11,-160.56,1415.96
7090,41778536,2023-02-12,-150.22,1265.74
7091,41778536,2023-02-12,-1499.6,-233.8599999999999
7092,41778536,2023-02-13,112.18,-121.6799999999999
7093,41778536,2023-02-14,141.62,19.94000000000011
7094,41852767,2023-01-31,,993.36
7095,41852767,2023-02-01,114.68,1108.04
7096,41852767,2023-02-03,-106.35,1001.69
7097,41852767,2023-02-04,207.89,1209.58
7098,41852767,2023-02-06,155.92,1365.5
7099,41852767,2023-02-10,92.13,1457.63
7100,41852767,2023-02-13,-23.37,1434.26
7101,41879906,2023-01-31,,29.05
7102,41879906,2023-02-01,-80.81,-51.760000000000005
7103,41879906,2023-02-03,105.23,53.47
7104,41879906,2023-02-06,-46.31,7.159999999999997
7105,41879906,2023-02-09,-65.76,-58.60000000000001
7106,41879906,2023-02-10,958.6,900.0
7107,41879906,2023-02-10,82.73,982.73
7108,41879906,2023-02-11,-99.31,883.42
7109,41881442,2023-01-31,,650.34
7110,41881442,2023-02-01,-135.55,514.79
7111,41881442,2023-02-01,-212.26,302.53000000000003
7112,41881442,2023-02-10,-139.99,162.54000000000002
7113,41881442,2023-02-11,114.97,277.51
7114,41881442,2023-02-12,50.34,327.85
7115,41881442,2023-02-12,26.35,354.20000000000005
7116,41914097,2023-01-31,,921.06
7117,41914097,2023-02-02,87.3,1008.3599999999999
7118,41914097,2023-02-03,84.5,1092.86
7119,41914097,2023-02-04,-95.13,997.7299999999999
7120,41914097,2023-02-07,192.3,1190.03
7121,41914097,2023-02-07,-61.37,1128.66
7122,41914097,2023-02-08,-25.37,1103.29
7123,41914097,2023-02-08,-86.91,1016.38
7124,41914097,2023-02-10,-111.11,905.27
7125,41914097,2023-02-13,93.82,999.0899999999999
7126,41914097,2023-02-13,-44.17,954.92
7127,41919083,2023-01-31,,884.52
7128,41919083,2023-02-01,-164.31,720.21
7129,41919083,2023-02-03,-99.68,620.53
7130,41919083,2023-02-07,1738.7,2359.23
7131,41919083,2023-02-07,109.89,2469.12
7132,41919083,2023-02-14,86.17,2555.29
7133,41919083,2023-02-14,-69.27,2486.02
7134,41954037,2023-01-31,,768.8
7135,41954037,2023-02-08,34.38,803.18
7136,41954037,2023-02-08,-27.23,775.9499999999999
7137,41954037,2023-02-12,-1015.8,-239.85000000000002
7138,41954037,2023-02-14,-145.08,-384.93000000000006
7139,41972741,2023-01-31,,374.09
7140,41972741,2023-02-02,123.02,497.10999999999996
7141,41972741,2023-02-08,88.5,585.61
7142,41972741,2023-02-09,155.66,741.27
7143,41972741,2023-02-12,57.33,798.6
7144,41972741,2023-02-13,48.57,847.17
7145,41981752,2023-01-31,,843.61
7146,41981752,2023-02-05,-179.42,664.19
7147,41981752,2023-02-10,1375.3,2039.49
7148,41981752,2023-02-10,114.57,2154.06
7149,41981752,2023-02-11,50.91,2204.97
7150,42017456,2023-01-31,,947.67
7151,42017456,2023-02-04,-55.98,891.6899999999999
7152,42017456,2023-02-04,-132.12,759.5699999999999
7153,42017456,2023-02-05,-62.54,697.03
7154,42017456,2023-02-06,222.12,919.15
7155,42017456,2023-02-08,-77.04,842.11
7156,42017456,2023-02-10,66.19,908.3
7157,42181728,2023-01-31,,51.89
7158,42181728,2023-02-02,-87.3,-35.41
7159,42181728,2023-02-04,-88.31,-123.72
7160,42181728,2023-02-05,116.94,-6.780000000000001
7161,42181728,2023-02-06,-98.86,-105.64
7162,42181728,2023-02-06,-98.97,-204.61
7163,42181728,2023-02-07,153.16,-51.44999999999999
7164,42181728,2023-02-08,50.38,-1.069999999999986
7165,42181728,2023-02-13,-60.63,-61.69999999999999
7166,42202867,2023-01-31,,614.83
7167,42202867,2023-02-06,117.02,731.85
7168,42202867,2023-02-06,-82.67,649.1800000000001
7169,42202867,2023-02-07,129.86,779.0400000000001
7170,42202867,2023-02-07,57.45,836.49
7171,42202867,2023-02-10,-85.13,751.36
7172,42202867,2023-02-11,-177.1,574.26
7173,42232896,2023-01-31,,647.99
7174,42232896,2023-02-02,21.71,669.7
7175,42232896,2023-02-04,-42.73,626.97
7176,42232896,2023-02-04,-84.59,542.38
7177,42232896,2023-02-09,97.8,640.1800000000001
7178,42232896,2023-02-10,130.57,770.75
7179,42232896,2023-02-10,74.94,845.69
7180,42232896,2023-02-13,-74.01,771.68
7181,42235537,2023-01-31,,165.2
7182,42235537,2023-02-01,807.2,972.4000000000001
7183,42235537,2023-02-02,-92.05,880.3500000000001
7184,42235537,2023-02-02,-101.22,779.1300000000001
7185,42235537,2023-02-04,-127.96,651.1700000000001
7186,42235537,2023-02-06,-161.61,489.56000000000006
7187,42235537,2023-02-07,-185.51,304.05000000000007
7188,42235537,2023-02-08,167.23,471.2800000000001
7189,42235537,2023-02-08,130.54,601.82
7190,42235537,2023-02-08,-118.58,483.24000000000007
7191,42235537,2023-02-08,-1244.2,-760.96
7192,42235537,2023-02-09,101.12,-659.84
7193,42235537,2023-02-10,118.64,-541.2
7194,42235537,2023-02-12,119.03,-422.17
7195,42235537,2023-02-13,-116.3,-538.47
7196,42235537,2023-02-14,88.32,-450.15000000000003
7197,42245590,2023-01-31,,229.01
7198,42245590,2023-02-01,55.09,284.1
7199,42245590,2023-02-02,120.7,404.8
7200,42245590,2023-02-07,639.3,1044.1
7201,42245590,2023-02-09,144.93,1189.03
7202,42245590,2023-02-09,-137.79,1051.24
7203,42245590,2023-02-12,134.05,1185.29
7204,42245590,2023-02-13,0.22,1185.51
7205,42255054,2023-01-31,,550.4
7206,42255054,2023-02-01,129.39,679.79
7207,42255054,2023-02-01,126.46,806.25
7208,42255054,2023-02-04,292.64,1098.8899999999999
7209,42255054,2023-02-05,144.67,1243.56
7210,42255054,2023-02-07,-50.0,1193.56
7211,42255054,2023-02-08,57.72,1251.28
7212,42268900,2023-01-31,,521.35
7213,42268900,2023-02-01,140.67,662.02
7214,42268900,2023-02-03,177.67,839.69
7215,42268900,2023-02-03,-85.29,754.4
7216,42268900,2023-02-03,-97.5,656.9
7217,42268900,2023-02-05,-46.87,610.03
7218,42268900,2023-02-08,-103.7,506.33
7219,42268900,2023-02-09,38.42,544.75
7220,42300418,2023-01-31,,151.39
7221,42300418,2023-02-01,-808.4,-657.01
7222,42300418,2023-02-04,-950.2,-1607.21
7223,42300418,2023-02-11,127.49,-1479.72
7224,42311039,2023-01-31,,98.95
7225,42311039,2023-02-01,156.73,255.68
7226,42311039,2023-02-03,-8.57,247.10999999999999
7227,42311039,2023-02-05,160.67,407.78
7228,42311039,2023-02-06,-144.74,263.03999999999996
7229,42311039,2023-02-10,39.22,302.26
7230,42311039,2023-02-10,-124.46,177.79999999999995
7231,42311039,2023-02-13,-128.84,48.95999999999998
7232,42322494,2023-01-31,,486.58
7233,42322494,2023-02-03,-15.35,471.22999999999996
7234,42322494,2023-02-06,78.93,550.16
7235,42322494,2023-02-07,-47.31,502.85
7236,42322494,2023-02-12,110.14,612.99
7237,42322494,2023-02-12,-101.4,511.59
7238,42340050,2023-01-31,,935.61
7239,42340050,2023-02-01,188.33,1123.94
7240,42340050,2023-02-01,-3.55,1120.39
7241,42340050,2023-02-03,-41.22,1079.17
7242,42340050,2023-02-05,130.71,1209.88
7243,42340050,2023-02-07,52.36,1262.24
7244,42340050,2023-02-11,174.4,1436.64
7245,42340050,2023-02-12,-170.0,1266.64
7246,42340050,2023-02-13,-1678.8,-412.15999999999985
7247,42396753,2023-01-31,,628.86
7248,42396753,2023-02-02,-38.42,590.44
7249,42396753,2023-02-07,98.66,689.1
7250,42396753,2023-02-08,-95.14,593.96
7251,42396753,2023-02-08,-194.3,399.65999999999997
7252,42396753,2023-02-09,77.75,477.40999999999997
7253,42509068,2023-01-31,,890.56
7254,42509068,2023-02-05,127.52,1018.0799999999999
7255,42509068,2023-02-05,-191.47,826.6099999999999
7256,42509068,2023-02-06,97.06,923.67
7257,42509068,2023-02-11,137.31,1060.98
7258,42509068,2023-02-12,518.5,1579.48
7259,42509068,2023-02-14,156.79,1736.27
7260,42515631,2023-01-31,,186.74
7261,42515631,2023-02-09,-117.38,69.36000000000001
7262,42515631,2023-02-10,-64.12,5.240000000000009
7263,42515631,2023-02-10,-121.27,-116.02999999999999
7264,42515631,2023-02-11,116.46,0.4300000000000068
7265,42515631,2023-02-13,186.35,186.78
7266,42546381,2023-01-31,,409.3
7267,42546381,2023-02-05,197.22,606.52
7268,42546381,2023-02-05,-128.72,477.8
7269,42546381,2023-02-06,-127.85,349.95000000000005
7270,42546381,2023-02-09,61.15,411.1
7271,42546381,2023-02-14,104.78,515.88
7272,42589255,2023-01-31,,282.84
7273,42589255,2023-02-03,240.55,523.39
7274,42589255,2023-02-03,101.42,624.81
7275,42589255,2023-02-12,-134.18,490.63
7276,42602631,2023-01-31,,539.62
7277,42602631,2023-02-04,-196.98,342.64
7278,42602631,2023-02-07,-764.7,-422.06000000000006
7279,42652193,2023-01-31,,566.53
7280,42652193,2023-02-04,1465.5,2032.03
7281,42652193,2023-02-05,-129.51,1902.52
7282,42652193,2023-02-10,-89.09,1813.43
7283,42652193,2023-02-13,-1062.5,750.9300000000001
7284,42652193,2023-02-14,-174.26,576.6700000000001
7285,42726921,2023-01-31,,590.15
7286,42726921,2023-02-05,155.76,745.91
7287,42726921,2023-02-05,-99.16,646.75
7288,42726921,2023-02-12,1342.4,1989.15
7289,42726921,2023-02-12,157.87,2147.02
7290,42726928,2023-01-31,,601.3
7291,42726928,2023-02-01,102.89,704.1899999999999
7292,42726928,2023-02-04,-55.58,648.6099999999999
7293,42726928,2023-02-04,-63.83,584.78
7294,42726928,2023-02-04,-210.25,374.53
7295,42726928,2023-02-05,181.42,555.9499999999999
7296,42726928,2023-02-06,-52.22,503.72999999999996
7297,42726928,2023-02-06,-63.33,440.4
7298,42726928,2023-02-06,-75.55,364.84999999999997
7299,42726928,2023-02-12,187.21,552.06
7300,42726928,2023-02-14,-163.23,388.83
7301,42746180,2023-01-31,,12.15
7302,42746180,2023-02-04,-1610.8,-1598.6499999999999
7303,42746180,2023-02-05,-8.72,-1607.37
7304,42746180,2023-02-07,-79.0,-1686.37
7305,42746180,2023-02-08,-92.43,-1778.8
7306,42746180,2023-02-09,-176.97,-1955.77
7307,42752982,2023-01-31,,526.19
7308,42752982,2023-02-06,-106.97,419.22
7309,42752982,2023-02-07,-192.3,226.92000000000004
7310,42752982,2023-02-11,-43.78,183.14000000000004
7311,42752982,2023-02-14,-12.8,170.34000000000003
7312,42752982,2023-02-14,-42.9,127.44000000000004
7313,42783101,2023-01-31,,289.82
7314,42783101,2023-02-01,-61.16,228.66
7315,42783101,2023-02-06,92.42,321.08
7316,42783101,2023-02-07,-1035.2,-714.1200000000001
7317,42783101,2023-02-11,125.65,-588.4700000000001
7318,42783101,2023-02-12,-88.66,-677.1300000000001
7319,42783101,2023-02-13,142.63,-534.5000000000001
7320,42813808,2023-01-31,,633.08
7321,42813808,2023-02-08,-129.37,503.71000000000004
7322,42813808,2023-02-09,-125.63,378.08000000000004
7323,42838186,2023-01-31,,466.48
7324,42838186,2023-02-01,56.55,523.03
7325,42838186,2023-02-08,-1382.5,-859.47
7326,42838186,2023-02-09,1176.8,317.3299999999999
7327,42838186,2023-02-10,-149.19,168.13999999999993
7328,42882563,2023-01-31,,419.69
7329,42882563,2023-02-07,-77.43,342.26
7330,42889744,2023-01-31,,223.01
7331,42889744,2023-02-02,98.78,321.78999999999996
7332,42889744,2023-02-03,-175.68,146.10999999999999
7333,42889744,2023-02-04,160.12,306.23
7334,43017336,2023-01-31,,935.99
7335,43017336,2023-02-03,-152.86,783.13
7336,43017336,2023-02-12,-122.62,660.51
7337,43017336,2023-02-13,196.46,856.97
7338,43017336,2023-02-14,-96.78,760.19
7339,43017598,2023-01-31,,151.6
7340,43017598,2023-02-02,-148.35,3.25
7341,43017598,2023-02-07,164.87,168.12
7342,43017598,2023-02-07,-64.08,104.04
7343,43017598,2023-02-10,-39.22,64.82000000000001
7344,43017598,2023-02-12,-158.31,-93.49
7345,43017598,2023-02-13,75.37,-18.11999999999999
7346,43017598,2023-02-13,-77.47,-95.58999999999999
7347,43017598,2023-02-14,-64.61,-160.2
7348,43032836,2023-01-31,,386.83
7349,43032836,2023-02-01,137.9,524.73
7350,43032836,2023-02-01,132.52,657.25
7351,43032836,2023-02-01,-52.56,604.69
7352,43032836,2023-02-02,148.04,752.73
7353,43032836,2023-02-03,136.92,889.65
7354,43032836,2023-02-03,56.07,945.72
7355,43032836,2023-02-04,-49.53,896.1899999999999
7356,43032836,2023-02-09,-42.5,853.6899999999999
7357,43032836,2023-02-09,-130.36,723.3299999999999
7358,43064169,2023-01-31,,555.44
7359,43064169,2023-02-02,27.69,583.1300000000001
7360,43064169,2023-02-03,772.8,1355.93
7361,43064169,2023-02-03,188.47,1544.4
7362,43064169,2023-02-03,-141.26,1403.14
7363,43064169,2023-02-05,974.8,2377.94
7364,43064169,2023-02-07,-109.58,2268.36
7365,43064169,2023-02-07,-124.55,2143.81
7366,43064169,2023-02-10,-1289.6,854.21
7367,43064169,2023-02-11,110.11,964.32
7368,43064169,2023-02-11,75.76,1040.08
7369,43064169,2023-02-13,-103.99,936.09
7370,43074888,2023-01-31,,779.86
7371,43074888,2023-02-02,-130.94,648.9200000000001
7372,43074888,2023-02-05,112.03,760.95
7373,43074888,2023-02-05,6.73,767.6800000000001
7374,43074888,2023-02-11,991.6,1759.2800000000002
7375,43074888,2023-02-11,104.39,1863.67
7376,43074888,2023-02-13,61.19,1924.8600000000001
7377,43080619,2023-01-31,,426.64
7378,43080619,2023-02-03,-22.57,404.07
7379,43080619,2023-02-05,17.93,422.0
7380,43080619,2023-02-08,-53.32,368.68
7381,43080619,2023-02-09,-112.69,255.98999999999998
7382,43080619,2023-02-13,84.91,340.9
7383,43140934,2023-01-31,,820.81
7384,43140934,2023-02-05,160.91,981.7199999999999
7385,43140934,2023-02-05,-57.87,923.8499999999999
7386,43140934,2023-02-10,-150.39,773.4599999999999
7387,43140934,2023-02-14,97.09,870.55
7388,43140934,2023-02-14,-58.12,812.43
7389,43257373,2023-01-31,,483.49
7390,43257373,2023-02-04,46.93,530.42
7391,43257373,2023-02-04,-135.72,394.70000000000005
7392,43257373,2023-02-06,116.91,511.61
7393,43257373,2023-02-06,-117.11,394.5
7394,43257373,2023-02-09,96.17,490.67
7395,43257373,2023-02-12,-129.61,361.06
7396,43265708,2023-01-31,,814.0
7397,43265708,2023-02-03,179.75,993.75
7398,43265708,2023-02-04,95.37,1089.12
7399,43265708,2023-02-13,65.62,1154.74
7400,43265708,2023-02-14,117.3,1272.04
7401,43312288,2023-01-31,,830.91
7402,43312288,2023-02-02,-152.95,677.96
7403,43312288,2023-02-04,-72.87,605.0899999999999
7404,43312288,2023-02-05,-84.4,520.6899999999999
7405,43312288,2023-02-08,110.55,631.24
7406,43312288,2023-02-13,66.09,697.3299999999999
7407,43312288,2023-02-14,-132.36,564.97
7408,43329727,2023-01-31,,477.69
7409,43329727,2023-02-04,-96.31,381.38
7410,43329727,2023-02-04,-1231.2,-849.82
7411,43329727,2023-02-07,144.16,-705.6600000000001
7412,43329727,2023-02-07,-141.01,-846.6700000000001
7413,43329727,2023-02-08,99.49,-747.1800000000001
7414,43329727,2023-02-13,42.54,-704.6400000000001
7415,43330367,2023-01-31,,172.38
7416,43330367,2023-02-02,-52.78,119.6
7417,43330367,2023-02-06,88.52,208.12
7418,43330367,2023-02-10,-182.81,25.310000000000002
7419,43330367,2023-02-11,24.9,50.21
7420,43330367,2023-02-13,87.2,137.41
7421,43338400,2023-01-31,,783.12
7422,43338400,2023-02-01,-80.7,702.42
7423,43338400,2023-02-04,-134.81,567.61
7424,43338400,2023-02-08,147.81,715.4200000000001
7425,43338400,2023-02-08,98.38,813.8
7426,43338400,2023-02-14,2197.2,3011.0
7427,43354643,2023-01-31,,863.38
7428,43354643,2023-02-02,105.59,968.97
7429,43354643,2023-02-06,-51.69,917.28
7430,43354643,2023-02-10,98.85,1016.13
7431,43354643,2023-02-11,125.91,1142.04
7432,43365633,2023-01-31,,57.11
7433,43365633,2023-02-07,-27.88,29.23
7434,43365633,2023-02-10,-107.66,-78.42999999999999
7435,43365633,2023-02-13,111.43,33.000000000000014
7436,43368978,2023-01-31,,133.07
7437,43368978,2023-02-01,55.49,188.56
7438,43368978,2023-02-06,-172.68,15.879999999999995
7439,43368978,2023-02-06,-202.83,-186.95000000000002
7440,43368978,2023-02-11,64.21,-122.74000000000002
7441,43387803,2023-01-31,,646.4
7442,43387803,2023-02-02,57.84,704.24
7443,43387803,2023-02-03,50.38,754.62
7444,43387803,2023-02-05,128.94,883.56
7445,43387803,2023-02-05,23.02,906.5799999999999
7446,43387803,2023-02-05,-81.21,825.37
7447,43387803,2023-02-06,71.54,896.91
7448,43387803,2023-02-10,-113.99,782.92
7449,43387803,2023-02-10,-249.81,533.11
7450,43387803,2023-02-11,-139.14,393.97
7451,43387803,2023-02-14,141.17,535.14
7452,43417466,2023-01-31,,874.02
7453,43417466,2023-02-01,66.84,940.86
7454,43417466,2023-02-07,-84.97,855.89
7455,43417466,2023-02-12,-153.64,702.25
7456,43417466,2023-02-14,-195.84,506.40999999999997
7457,43420385,2023-01-31,,881.49
7458,43420385,2023-02-02,117.9,999.39
7459,43420385,2023-02-06,-71.0,928.39
7460,43420385,2023-02-07,52.52,980.91
7461,43420385,2023-02-09,1522.7,2503.61
7462,43420385,2023-02-09,129.19,2632.7999999999997
7463,43420385,2023-02-09,-83.64,2549.16
7464,43453543,2023-01-31,,890.67
7465,43453543,2023-02-01,-98.39,792.28
7466,43453543,2023-02-02,75.16,867.4399999999999
7467,43453543,2023-02-10,130.32,997.76
7468,43453543,2023-02-12,72.09,1069.85
7469,43490748,2023-01-31,,807.92
7470,43490748,2023-02-01,-143.86,664.06
7471,43490748,2023-02-07,173.42,837.4799999999999
7472,43490748,2023-02-08,66.93,904.41
7473,43490748,2023-02-10,135.0,1039.4099999999999
7474,43490748,2023-02-13,-82.37,957.04
7475,43490748,2023-02-13,-102.44,854.5999999999999
7476,43490748,2023-02-14,77.21,931.81
7477,43499771,2023-01-31,,28.4
7478,43499771,2023-02-01,78.47,106.87
7479,43499771,2023-02-06,1003.2,1110.0700000000002
7480,43499771,2023-02-06,77.81,1187.88
7481,43499771,2023-02-06,-65.08,1122.8
7482,43499771,2023-02-07,-75.13,1047.67
7483,43499771,2023-02-07,-149.48,898.19
7484,43499771,2023-02-11,143.86,1042.0500000000002
7485,43499771,2023-02-11,-118.35,923.7
7486,43499771,2023-02-12,-154.74,768.96
7487,43499771,2023-02-12,-157.02,611.94
7488,43499771,2023-02-14,228.87,840.8100000000001
7489,43541008,2023-01-31,,413.2
7490,43541008,2023-02-01,105.55,518.75
7491,43541008,2023-02-05,-56.72,462.03
7492,43541008,2023-02-05,-1144.8,-682.77
7493,43541008,2023-02-11,-42.48,-725.25
7494,43541008,2023-02-13,73.96,-651.29
7495,43597919,2023-01-31,,906.64
7496,43597919,2023-02-03,-95.54,811.1
7497,43597919,2023-02-06,144.03,955.13
7498,43597919,2023-02-06,-944.2,10.92999999999995
7499,43597919,2023-02-07,1610.4,1621.33
7500,43597919,2023-02-08,-87.01,1534.32
7501,43597919,2023-02-12,1323.4,2857.7200000000003
7502,43597919,2023-02-12,-114.06,2743.66
7503,43597919,2023-02-14,44.44,2788.1
7504,43616790,2023-01-31,,365.67
7505,43616790,2023-02-02,62.33,428.0
7506,43616790,2023-02-05,61.68,489.68
7507,43616790,2023-02-06,-154.24,335.44
7508,43616790,2023-02-07,139.63,475.07
7509,43616790,2023-02-08,943.5,1418.57
7510,43616790,2023-02-08,36.72,1455.29
7511,43616790,2023-02-09,74.39,1529.6799999999998
7512,43616790,2023-02-09,-1705.6,-175.92000000000007
7513,43616790,2023-02-13,104.18,-71.74000000000007
7514,43623061,2023-01-31,,724.39
7515,43623061,2023-02-02,1502.2,2226.59
7516,43623061,2023-02-04,-75.48,2151.11
7517,43623061,2023-02-11,331.8,2482.91
7518,43623061,2023-02-12,66.33,2549.24
7519,43623061,2023-02-12,-76.84,2472.4
7520,43623061,2023-02-13,-129.32,2343.08
7521,43623061,2023-02-14,-49.38,2293.7
7522,43623061,2023-02-14,-124.19,2169.5099999999998
7523,43772330,2023-01-31,,701.52
7524,43772330,2023-02-03,-169.95,531.5699999999999
7525,43772330,2023-02-05,-143.73,387.84000000000003
7526,43772330,2023-02-06,-97.33,290.51
7527,43772330,2023-02-08,65.49,356.0
7528,43772330,2023-02-10,98.76,454.76
7529,43772330,2023-02-11,90.71,545.47
7530,43772330,2023-02-12,45.77,591.24
7531,43781476,2023-01-31,,28.83
7532,43781476,2023-02-01,128.49,157.32
7533,43781476,2023-02-02,115.98,273.3
7534,43781476,2023-02-02,56.3,329.6
7535,43781476,2023-02-04,143.83,473.43
7536,43781476,2023-02-06,45.55,518.98
7537,43781476,2023-02-08,-52.3,466.68
7538,43781476,2023-02-08,-943.5,-476.82
7539,43781476,2023-02-13,153.14,-323.68
7540,43811112,2023-01-31,,99.92
7541,43811112,2023-02-02,-97.69,2.230000000000004
7542,43811112,2023-02-05,5.44,7.670000000000004
7543,43811112,2023-02-07,1760.8,1768.47
7544,43811112,2023-02-08,-99.77,1668.7
7545,43811112,2023-02-08,-136.68,1532.02
7546,43811112,2023-02-09,-1485.0,47.01999999999998
7547,43811112,2023-02-10,-52.93,-5.910000000000018
7548,43811112,2023-02-13,65.54,59.62999999999999
7549,43811112,2023-02-14,93.12,152.75
7550,43830772,2023-01-31,,158.17
7551,43830772,2023-02-03,89.74,247.90999999999997
7552,43843937,2023-01-31,,79.03
7553,43843937,2023-02-06,67.96,146.99
7554,43843937,2023-02-09,940.9,1087.8899999999999
7555,43843937,2023-02-10,155.28,1243.17
7556,43843937,2023-02-11,518.1,1761.27
7557,43843937,2023-02-13,901.5,2662.77
7558,43858112,2023-01-31,,641.78
7559,43858112,2023-02-01,-102.95,538.8299999999999
7560,43858112,2023-02-02,-39.75,499.08
7561,43858112,2023-02-04,77.7,576.78
7562,43858112,2023-02-04,-49.6,527.18
7563,43858112,2023-02-05,-65.82,461.36
7564,43858112,2023-02-08,-99.49,361.87
7565,43858112,2023-02-13,90.0,451.87
7566,43858112,2023-02-13,-118.46,333.40999999999997
7567,43858112,2023-02-14,171.25,504.65999999999997
7568,43858112,2023-02-14,-170.78,333.88
7569,43860538,2023-01-31,,478.05
7570,43860538,2023-02-02,-89.8,388.25
7571,43860538,2023-02-08,69.75,458.0
7572,43860538,2023-02-12,-53.98,404.02000000000004
7573,43892675,2023-01-31,,997.95
7574,43892675,2023-02-03,64.03,1061.98
7575,43892675,2023-02-07,-150.57,911.4100000000001
7576,43892675,2023-02-08,-80.77,830.6400000000001
7577,43892675,2023-02-14,-53.35,777.2900000000001
7578,43930935,2023-01-31,,651.22
7579,43930935,2023-02-04,-21.78,629.44
7580,43930935,2023-02-04,-120.69,508.75
7581,43930935,2023-02-09,-63.04,445.71000000000004
7582,43930935,2023-02-12,69.99,515.7
7583,43930935,2023-02-14,-82.7,433.0
7584,43979238,2023-01-31,,68.08
7585,43979238,2023-02-01,170.96,239.04000000000002
7586,43979238,2023-02-03,49.39,288.43
7587,43979238,2023-02-03,-64.85,223.57999999999998
7588,43979238,2023-02-04,115.27,338.85
7589,43979238,2023-02-06,-178.37,160.48
7590,43979238,2023-02-12,1486.8,1647.28
7591,44007497,2023-01-31,,331.92
7592,44007497,2023-02-03,41.22,373.14
7593,44007497,2023-02-05,-87.07,286.07000000000005
7594,44007497,2023-02-06,-39.91,246.16000000000003
7595,44007497,2023-02-07,-54.52,191.64000000000001
7596,44007497,2023-02-08,88.74,280.38
7597,44007497,2023-02-08,61.39,341.77000000000004
7598,44009985,2023-01-31,,763.43
7599,44009985,2023-02-02,13.68,777.1099999999999
7600,44009985,2023-02-08,-946.2,-169.09000000000015
7601,44009985,2023-02-10,905.0,735.9099999999999
7602,44009985,2023-02-11,102.26,838.1699999999998
7603,44009985,2023-02-11,-60.05,778.1199999999999
7604,44009985,2023-02-13,106.6,884.7199999999998
7605,44009985,2023-02-14,-104.91,779.8099999999998
7606,44019515,2023-01-31,,312.63
7607,44019515,2023-02-02,116.25,428.88
7608,44019515,2023-02-04,-151.32,277.56
7609,44019515,2023-02-06,-38.7,238.86
7610,44019515,2023-02-06,-102.12,136.74
7611,44019515,2023-02-07,1159.5,1296.24
7612,44019515,2023-02-09,80.13,1376.37
7613,44019515,2023-02-13,101.48,1477.85
7614,44066457,2023-01-31,,18.09
7615,44066457,2023-02-03,1179.0,1197.09
7616,44066457,2023-02-03,78.92,1276.01
7617,44066457,2023-02-03,-92.94,1183.07
7618,44066457,2023-02-04,21.78,1204.85
7619,44066457,2023-02-05,102.9,1307.75
7620,44066457,2023-02-11,103.18,1410.9299999999998
7621,44066457,2023-02-13,-1226.1,184.82999999999993
7622,44066457,2023-02-14,156.38,341.2099999999999
7623,44066457,2023-02-14,-51.9,289.30999999999995
7624,44066457,2023-02-14,-149.95,139.35999999999993
7625,44075619,2023-01-31,,979.0
7626,44075619,2023-02-05,217.15,1196.15
7627,44075619,2023-02-08,-83.96,1112.19
7628,44075619,2023-02-08,-108.51,1003.6800000000001
7629,44075619,2023-02-09,97.39,1101.07
7630,44075619,2023-02-10,92.21,1193.28
7631,44075619,2023-02-10,50.52,1243.8
7632,44075619,2023-02-12,-78.89,1164.91
7633,44130477,2023-01-31,,918.0
7634,44130477,2023-02-04,622.4,1540.4
7635,44130477,2023-02-04,-66.17,1474.23
7636,44130477,2023-02-08,137.66,1611.8899999999999
7637,44130477,2023-02-08,129.87,1741.76
7638,44130477,2023-02-12,-36.64,1705.12
7639,44133867,2023-01-31,,358.61
7640,44133867,2023-02-03,169.26,527.87
7641,44133867,2023-02-04,-91.11,436.76
7642,44133867,2023-02-11,851.2,1287.96
7643,44133867,2023-02-14,26.02,1313.98
7644,44140049,2023-01-31,,372.02
7645,44140049,2023-02-06,-49.33,322.69
7646,44140049,2023-02-10,84.47,407.15999999999997
7647,44140049,2023-02-10,-114.57,292.59
7648,44140049,2023-02-11,122.35,414.94
7649,44140049,2023-02-11,-89.98,324.96
7650,44140049,2023-02-13,77.8,402.76
7651,44145489,2023-01-31,,635.75
7652,44145489,2023-02-03,87.5,723.25
7653,44145489,2023-02-06,51.69,774.94
7654,44145489,2023-02-10,-79.08,695.86
7655,44145489,2023-02-11,-55.33,640.53
7656,44145489,2023-02-12,-1003.7,-363.1700000000001
7657,44162563,2023-01-31,,325.77
7658,44162563,2023-02-09,-1162.9,-837.1300000000001
7659,44162563,2023-02-11,-41.42,-878.5500000000001
7660,44162563,2023-02-14,-102.55,-981.1000000000001
7661,44164363,2023-01-31,,998.43
7662,44164363,2023-02-02,164.6,1163.03
7663,44164363,2023-02-02,82.72,1245.75
7664,44164363,2023-02-03,-155.02,1090.73
7665,44164363,2023-02-06,-51.71,1039.02
7666,44164363,2023-02-09,-72.19,966.8299999999999
7667,44228646,2023-01-31,,651.3
7668,44228646,2023-02-03,129.77,781.0699999999999
7669,44228646,2023-02-03,-53.78,727.29
7670,44228646,2023-02-04,1315.2,2042.49
7671,44228646,2023-02-05,1144.8,3187.29
7672,44228646,2023-02-05,112.01,3299.3
7673,44228646,2023-02-07,36.15,3335.45
7674,44228646,2023-02-08,1244.2,4579.65
7675,44228646,2023-02-08,105.88,4685.53
7676,44228646,2023-02-09,-101.37,4584.16
7677,44228646,2023-02-10,46.55,4630.71
7678,44228646,2023-02-12,-169.44,4461.27
7679,44234432,2023-01-31,,399.17
7680,44234432,2023-02-01,-127.46,271.71000000000004
7681,44234432,2023-02-06,82.67,354.38
7682,44234432,2023-02-07,-46.31,308.07000000000005
7683,44234432,2023-02-08,-90.88,217.19000000000003
7684,44234432,2023-02-09,156.08,373.27000000000004
7685,44234432,2023-02-09,95.64,468.91
7686,44234432,2023-02-10,180.0,648.9100000000001
7687,44234432,2023-02-11,10.99,659.9
7688,44234432,2023-02-12,140.79,800.69
7689,44234432,2023-02-14,-191.09,609.6
7690,44239230,2023-01-31,,390.94
7691,44239230,2023-02-01,-189.46,201.48
7692,44239230,2023-02-06,-68.72,132.76
7693,44242297,2023-01-31,,388.02
7694,44242297,2023-02-01,-136.95,251.07
7695,44242297,2023-02-03,195.91,446.98
7696,44242297,2023-02-05,962.0,1408.98
7697,44242297,2023-02-09,170.19,1579.17
7698,44242297,2023-02-10,46.07,1625.24
7699,44242297,2023-02-11,102.02,1727.26
7700,44242297,2023-02-12,1003.7,2730.96
7701,44242297,2023-02-12,124.55,2855.51
7702,44242297,2023-02-13,147.05,3002.56
7703,44242297,2023-02-14,179.57,3182.13
7704,44243236,2023-01-31,,797.95
7705,44243236,2023-02-01,-54.25,743.7
7706,44243236,2023-02-02,108.85,852.5500000000001
7707,44243236,2023-02-04,51.81,904.36
7708,44243236,2023-02-11,-123.03,781.33
7709,44243236,2023-02-12,966.7,1748.0300000000002
7710,44243236,2023-02-14,137.37,1885.4
7711,44272912,2023-01-31,,448.18
7712,44272912,2023-02-01,-142.26,305.92
7713,44272912,2023-02-07,742.8,1048.72
7714,44272912,2023-02-07,-18.61,1030.1100000000001
7715,44272912,2023-02-07,-89.09,941.02
7716,44272912,2023-02-08,113.46,1054.48
7717,44272912,2023-02-09,78.16,1132.64
7718,44272912,2023-02-09,38.09,1170.73
7719,44272912,2023-02-09,-157.69,1013.04
7720,44272912,2023-02-11,63.8,1076.84
7721,44272912,2023-02-12,882.7,1959.54
7722,44272912,2023-02-14,-118.75,1840.79
7723,44281556,2023-01-31,,70.7
7724,44281556,2023-02-01,-117.4,-46.7
7725,44281556,2023-02-08,58.6,11.899999999999999
7726,44310966,2023-01-31,,361.02
7727,44310966,2023-02-02,107.8,468.82
7728,44310966,2023-02-03,-136.66,332.15999999999997
7729,44310966,2023-02-05,137.15,469.30999999999995
7730,44310966,2023-02-07,-41.35,427.96
7731,44310966,2023-02-09,-117.9,310.05999999999995
7732,44310966,2023-02-13,113.3,423.35999999999996
7733,44310966,2023-02-14,-0.36,422.99999999999994
7734,44317934,2023-01-31,,920.21
7735,44317934,2023-02-01,1888.2,2808.41
7736,44317934,2023-02-02,-162.4,2646.01
7737,44317934,2023-02-10,-206.87,2439.14
7738,44317934,2023-02-13,117.77,2556.91
7739,44331942,2023-01-31,,389.13
7740,44331942,2023-02-02,225.34,614.47
7741,44331942,2023-02-03,60.47,674.94
7742,44331942,2023-02-04,49.6,724.54
7743,44331942,2023-02-12,169.34,893.88
7744,44358901,2023-01-31,,576.73
7745,44358901,2023-02-01,-144.31,432.42
7746,44358901,2023-02-02,137.17,569.59
7747,44358901,2023-02-03,-117.51,452.08
7748,44358901,2023-02-04,73.67,525.75
7749,44358901,2023-02-08,1805.6,2331.35
7750,44358901,2023-02-10,75.3,2406.65
7751,44358901,2023-02-11,-40.81,2365.8399999999997
7752,44358901,2023-02-12,88.66,2454.5
7753,44364430,2023-01-31,,306.44
7754,44364430,2023-02-01,-65.61,240.82999999999998
7755,44364430,2023-02-09,-142.44,98.38999999999999
7756,44364430,2023-02-11,116.14,214.52999999999997
7757,44364430,2023-02-11,87.14,301.66999999999996
7758,44364430,2023-02-13,216.37,518.04
7759,44368280,2023-01-31,,291.54
7760,44368280,2023-02-03,13.52,305.06
7761,44368280,2023-02-09,-46.29,258.77000000000004
7762,44368280,2023-02-11,-84.29,174.48000000000002
7763,44368280,2023-02-11,-92.54,81.94000000000001
7764,44368280,2023-02-12,19.56,101.50000000000001
7765,44378133,2023-01-31,,721.21
7766,44378133,2023-02-01,-12.5,708.71
7767,44378133,2023-02-02,123.2,831.9100000000001
7768,44378133,2023-02-03,100.38,932.2900000000001
7769,44378133,2023-02-03,66.09,998.38
7770,44378133,2023-02-08,44.49,1042.8700000000001
7771,44378133,2023-02-11,-633.2,409.66999999999996
7772,44378133,2023-02-12,-197.45,212.21999999999997
7773,44378133,2023-02-14,-102.06,110.15999999999997
7774,44378133,2023-02-14,-107.51,2.649999999999963
7775,44389169,2023-01-31,,978.69
7776,44389169,2023-02-04,-51.81,926.8800000000001
7777,44389169,2023-02-10,-103.67,823.21
7778,44389169,2023-02-10,-135.0,688.21
7779,44413402,2023-01-31,,75.55
7780,44413402,2023-02-02,23.22,98.77
7781,44413402,2023-02-08,140.73,239.5
7782,44413402,2023-02-11,-126.93,112.56999999999996
7783,44427272,2023-01-31,,970.1
7784,44427272,2023-02-01,-174.19,795.9100000000001
7785,44427272,2023-02-02,2.63,798.5400000000001
7786,44427272,2023-02-05,108.26,906.8000000000001
7787,44427272,2023-02-07,97.67,1004.47
7788,44427272,2023-02-10,-15.31,989.1600000000001
7789,44474369,2023-01-31,,663.93
7790,44474369,2023-02-09,64.46,728.39
7791,44474369,2023-02-09,-97.79,630.5999999999999
7792,44474369,2023-02-10,-71.41,559.1899999999999
7793,44474369,2023-02-11,-120.57,438.61999999999995
7794,44474369,2023-02-12,80.58,519.1999999999999
7795,44474369,2023-02-12,69.4,588.5999999999999
7796,44516940,2023-01-31,,930.17
7797,44516940,2023-02-01,-182.19,747.98
7798,44516940,2023-02-06,-172.27,575.7099999999999
7799,44516940,2023-02-08,209.01,784.7199999999999
7800,44516940,2023-02-09,-12.71,772.01
7801,44516940,2023-02-12,165.18,937.1899999999999
7802,44516940,2023-02-12,58.82,996.01
7803,44516940,2023-02-12,-67.31,928.6999999999999
7804,44537960,2023-01-31,,675.03
7805,44537960,2023-02-01,-168.84,506.18999999999994
7806,44537960,2023-02-02,95.09,601.28
7807,44537960,2023-02-06,147.34,748.62
7808,44537960,2023-02-06,-135.04,613.5799999999999
7809,44537960,2023-02-09,-187.78,425.79999999999995
7810,44537960,2023-02-10,-72.06,353.74
7811,44537960,2023-02-12,-192.75,160.98999999999998
7812,44537960,2023-02-13,-116.22,44.76999999999998
7813,44564500,2023-01-31,,355.18
7814,44564500,2023-02-01,215.02,570.2
7815,44564500,2023-02-03,67.38,637.58
7816,44564500,2023-02-06,34.38,671.96
7817,44564500,2023-02-10,67.6,739.56
7818,44586370,2023-01-31,,440.56
7819,44586370,2023-02-02,-84.65,355.90999999999997
7820,44586370,2023-02-06,-40.91,315.0
7821,44586370,2023-02-06,-42.82,272.18
7822,44586370,2023-02-07,1500.0,1772.18
7823,44586370,2023-02-07,77.43,1849.6100000000001
7824,44586370,2023-02-08,-166.36,1683.25
7825,44586370,2023-02-12,117.51,1800.76
7826,44586370,2023-02-13,-105.71,1695.0500000000002
7827,44586370,2023-02-14,69.01,1764.0600000000002
7828,44586370,2023-02-14,-52.78,1711.28
7829,44626164,2023-01-31,,915.14
7830,44626164,2023-02-07,65.37,980.51
7831,44626164,2023-02-09,-1166.4,-185.8900000000001
7832,44626164,2023-02-14,-124.79,-310.6800000000001
7833,44662337,2023-01-31,,768.12
7834,44662337,2023-02-01,119.68,887.8
7835,44662337,2023-02-09,-140.49,747.31
7836,44662337,2023-02-14,162.09,909.4
7837,44701536,2023-01-31,,995.4
7838,44701536,2023-02-01,-76.18,919.22
7839,44701536,2023-02-06,-151.44,767.78
7840,44701536,2023-02-08,110.6,878.38
7841,44701536,2023-02-08,-117.22,761.16
7842,44701536,2023-02-10,-117.1,644.06
7843,44701536,2023-02-11,-75.88,568.18
7844,44711172,2023-01-31,,382.83
7845,44711172,2023-02-02,-174.75,208.07999999999998
7846,44711172,2023-02-04,150.01,358.09
7847,44711172,2023-02-04,141.33,499.41999999999996
7848,44711172,2023-02-08,-81.17,418.25
7849,44711172,2023-02-13,8.94,427.19
7850,44759468,2023-01-31,,962.91
7851,44759468,2023-02-01,-97.92,864.99
7852,44759468,2023-02-04,141.71,1006.7
7853,44759468,2023-02-07,84.46,1091.16
7854,44759468,2023-02-09,-35.18,1055.98
7855,44759468,2023-02-10,74.15,1130.13
7856,44759468,2023-02-10,-105.35,1024.78
7857,44759468,2023-02-11,-34.81,989.97
7858,44759468,2023-02-12,-169.36,820.61
7859,44759468,2023-02-13,-110.34,710.27
7860,44794340,2023-01-31,,488.91
7861,44794340,2023-02-13,-71.54,417.37
7862,44812075,2023-01-31,,863.71
7863,44812075,2023-02-01,601.7,1465.41
7864,44812075,2023-02-02,116.1,1581.51
7865,44812075,2023-02-02,-108.51,1473.0
7866,44812075,2023-02-06,127.59,1600.5900000000001
7867,44812075,2023-02-12,127.27,1727.8600000000001
7868,44812075,2023-02-13,64.31,1792.17
7869,44816910,2023-01-31,,185.51
7870,44816910,2023-02-01,229.8,415.31
7871,44816910,2023-02-04,89.58,504.89
7872,44816910,2023-02-05,56.62,561.51
7873,44816910,2023-02-05,-9.05,552.46
7874,44816910,2023-02-05,-147.37,405.09000000000003
7875,44816910,2023-02-06,30.45,435.54
7876,44816910,2023-02-07,756.5,1192.04
7877,44816910,2023-02-08,110.8,1302.84
7878,44816910,2023-02-13,-32.01,1270.83
7879,44816910,2023-02-13,-118.4,1152.4299999999998
7880,44873253,2023-01-31,,660.51
7881,44873253,2023-02-03,60.33,720.84
7882,44873253,2023-02-03,8.57,729.41
7883,44873253,2023-02-05,-93.57,635.84
7884,44873253,2023-02-07,-113.43,522.41
7885,44873253,2023-02-10,-93.74,428.67
7886,44873253,2023-02-10,-192.26,236.41000000000003
7887,44873253,2023-02-11,726.2,962.6100000000001
7888,44902994,2023-01-31,,790.34
7889,44902994,2023-02-01,85.77,876.11
7890,44902994,2023-02-02,-174.13,701.98
7891,44902994,2023-02-03,23.84,725.82
7892,44902994,2023-02-03,-31.0,694.82
7893,44902994,2023-02-03,-58.23,636.59
7894,44902994,2023-02-03,-1259.6,-623.0099999999999
7895,44902994,2023-02-04,94.29,-528.7199999999999
7896,44902994,2023-02-04,76.17,-452.54999999999984
7897,44902994,2023-02-05,99.16,-353.3899999999999
7898,44902994,2023-02-06,-28.63,-382.01999999999987
7899,44902994,2023-02-08,117.41,-264.6099999999999
7900,44902994,2023-02-13,-61.69,-326.29999999999984
7901,44912164,2023-01-31,,355.61
7902,44912164,2023-02-03,-110.67,244.94
7903,44912164,2023-02-05,-29.75,215.19
7904,44912164,2023-02-07,-50.93,164.26000000000002
7905,44912164,2023-02-12,25.82,190.08
7906,44912164,2023-02-13,-128.76,61.32000000000002
7907,44912164,2023-02-14,157.43,218.75000000000003
7908,44912164,2023-02-14,49.38,268.13000000000005
7909,45015534,2023-01-31,,215.54
7910,45015534,2023-02-06,-154.92,60.620000000000005
7911,45015534,2023-02-07,76.2,136.82
7912,45015534,2023-02-08,1032.4,1169.22
7913,45015534,2023-02-09,83.42,1252.64
7914,45015570,2023-01-31,,905.57
7915,45015570,2023-02-01,754.9,1660.47
7916,45015570,2023-02-01,137.72,1798.19
7917,45015570,2023-02-06,-72.7,1725.49
7918,45015570,2023-02-06,-98.87,1626.6200000000001
7919,45015570,2023-02-07,136.3,1762.92
7920,45015570,2023-02-08,-150.64,1612.28
7921,45015570,2023-02-09,-145.82,1466.46
7922,45015570,2023-02-13,159.89,1626.35
7923,45015570,2023-02-14,176.37,1802.72
7924,45020832,2023-01-31,,104.89
7925,45020832,2023-02-02,92.05,196.94
7926,45020832,2023-02-03,89.95,286.89
7927,45020832,2023-02-05,-158.24,128.64999999999998
7928,45020832,2023-02-09,110.01,238.65999999999997
7929,45020832,2023-02-11,42.85,281.51
7930,45020832,2023-02-11,16.09,297.59999999999997
7931,45021115,2023-01-31,,464.27
7932,45021115,2023-02-07,116.04,580.31
7933,45021115,2023-02-08,-189.71,390.59999999999997
7934,45021115,2023-02-10,125.47,516.0699999999999
7935,45021115,2023-02-10,62.01,578.0799999999999
7936,45021115,2023-02-11,1813.6,2391.68
7937,45021115,2023-02-12,41.2,2432.8799999999997
7938,45021115,2023-02-13,-18.93,2413.95
7939,45021398,2023-01-31,,783.24
7940,45021398,2023-02-02,77.43,860.6700000000001
7941,45021398,2023-02-04,515.6,1376.27
7942,45021398,2023-02-08,-68.68,1307.59
7943,45021398,2023-02-10,108.64,1416.23
7944,45021398,2023-02-10,-72.23,1344.0
7945,45021398,2023-02-10,-344.3,999.6999999999999
7946,45026430,2023-01-31,,745.31
7947,45026430,2023-02-04,178.94,924.25
7948,45026430,2023-02-07,-36.73,887.52
7949,45026430,2023-02-09,-148.45,739.0699999999999
7950,45026430,2023-02-10,-55.29,683.78
7951,45026430,2023-02-11,626.6,1310.38
7952,45026430,2023-02-13,-85.75,1224.63
7953,45027876,2023-01-31,,80.13
7954,45027876,2023-02-01,72.35,152.48
7955,45027876,2023-02-01,-57.48,95.0
7956,45027876,2023-02-01,-170.25,-75.25
7957,45027876,2023-02-03,-79.86,-155.11
7958,45027876,2023-02-04,176.15,21.04000000000002
7959,45027876,2023-02-06,-80.8,-59.75999999999998
7960,45027876,2023-02-07,54.35,-5.409999999999975
7961,45027876,2023-02-07,-227.16,-232.56999999999996
7962,45027876,2023-02-12,-3.07,-235.63999999999996
7963,45027876,2023-02-14,-85.41,-321.04999999999995
7964,45029598,2023-01-31,,558.87
7965,45029598,2023-02-06,-67.0,491.87
7966,45029598,2023-02-06,-119.61,372.26
7967,45029598,2023-02-08,-149.83,222.43
7968,45029598,2023-02-09,76.46,298.89
7969,45029598,2023-02-09,70.47,369.36
7970,45029598,2023-02-09,-64.47,304.89
7971,45029598,2023-02-12,7.46,312.35
7972,45029598,2023-02-14,42.19,354.54
7973,45029598,2023-02-14,-1338.4,-983.8600000000001
7974,45067158,2023-01-31,,115.23
7975,45067158,2023-02-04,-78.83,36.400000000000006
7976,45067158,2023-02-04,-101.3,-64.89999999999999
7977,45067158,2023-02-04,-102.44,-167.33999999999997
7978,45067158,2023-02-05,106.32,-61.019999999999996
7979,45067158,2023-02-05,-83.99,-145.01
7980,45067158,2023-02-09,184.91,39.900000000000006
7981,45067158,2023-02-10,177.19,217.09
7982,45067158,2023-02-11,90.72,307.81
7983,45089475,2023-01-31,,676.92
7984,45089475,2023-02-03,-119.64,557.28
7985,45089475,2023-02-13,-125.97,431.30999999999995
7986,45089475,2023-02-13,-1582.4,-1151.0900000000001
7987,45111669,2023-01-31,,459.28
7988,45111669,2023-02-01,121.91,581.1899999999999
7989,45111669,2023-02-03,16.43,597.62
7990,45111669,2023-02-10,-116.33,481.28999999999996
7991,45111669,2023-02-11,-84.36,396.92999999999995
7992,45111669,2023-02-14,-173.04,223.89
7993,45161114,2023-01-31,,282.6
7994,45161114,2023-02-01,134.43,417.03000000000003
7995,45161114,2023-02-06,132.91,549.94
7996,45161114,2023-02-10,126.15,676.09
7997,45196342,2023-01-31,,402.48
7998,45196342,2023-02-01,-64.89,337.59000000000003
7999,45196342,2023-02-03,-104.89,232.70000000000002
8000,45196342,2023-02-04,136.46,369.16
8001,45196342,2023-02-10,120.91,490.07000000000005
8002,45196342,2023-02-11,-112.23,377.84000000000003
8003,45196342,2023-02-12,-1192.7,-814.86
8004,45238909,2023-01-31,,904.83
8005,45238909,2023-02-04,120.85,1025.68
8006,45238909,2023-02-08,751.9,1777.58
8007,45238909,2023-02-08,-38.91,1738.67
8008,45238909,2023-02-13,133.97,1872.64
8009,45242171,2023-01-31,,174.66
8010,45242171,2023-02-04,84.12,258.78
8011,45242171,2023-02-09,-93.14,165.64
8012,45242171,2023-02-13,73.31,238.95
8013,45253870,2023-01-31,,273.37
8014,45253870,2023-02-07,485.9,759.27
8015,45253870,2023-02-11,-78.2,681.0699999999999
8016,45253870,2023-02-12,142.98,824.05
8017,45275334,2023-01-31,,49.55
8018,45275334,2023-02-02,112.23,161.78
8019,45275334,2023-02-03,-89.95,71.83
8020,45397824,2023-01-31,,741.62
8021,45397824,2023-02-01,-130.8,610.8199999999999
8022,45397824,2023-02-02,177.51,788.3299999999999
8023,45397824,2023-02-03,20.42,808.75
8024,45397824,2023-02-03,-154.95,653.8
8025,45397824,2023-02-07,-113.55,540.25
8026,45397824,2023-02-11,46.65,586.9
8027,45397824,2023-02-12,134.97,721.87
8028,45397824,2023-02-14,-625.3,96.57000000000005
8029,45519330,2023-01-31,,840.22
8030,45519330,2023-02-01,-80.88,759.34
8031,45519330,2023-02-01,-180.83,578.51
8032,45519330,2023-02-03,240.26,818.77
8033,45519330,2023-02-07,85.76,904.53
8034,45519330,2023-02-11,-163.65,740.88
8035,45519330,2023-02-13,25.59,766.47
8036,45543867,2023-01-31,,419.92
8037,45543867,2023-02-01,82.42,502.34000000000003
8038,45543867,2023-02-02,117.71,620.05
8039,45543867,2023-02-03,136.66,756.71
8040,45543867,2023-02-03,106.43,863.14
8041,45543867,2023-02-07,1522.0,2385.14
8042,45543867,2023-02-09,100.78,2485.92
8043,45543867,2023-02-11,-78.66,2407.2599999999998
8044,45543867,2023-02-13,562.4,2969.66
8045,45558696,2023-01-31,,760.19
8046,45558696,2023-02-02,1890.0,2650.19
8047,45558696,2023-02-05,-1526.1,1124.0900000000001
8048,45558696,2023-02-07,42.19,1166.2800000000002
8049,45558696,2023-02-07,-144.93,1021.3500000000001
8050,45558696,2023-02-07,-173.42,847.9300000000002
8051,45558696,2023-02-08,-62.15,785.7800000000002
8052,45611838,2023-01-31,,784.55
8053,45611838,2023-02-03,47.74,832.29
8054,45611838,2023-02-04,46.49,878.78
8055,45611838,2023-02-04,-53.51,825.27
8056,45611838,2023-02-06,-97.64,727.63
8057,45611838,2023-02-07,-69.22,658.41
8058,45611838,2023-02-09,173.88,832.29
8059,45611838,2023-02-14,122.61,954.9
8060,45631973,2023-01-31,,762.7
8061,45631973,2023-02-01,-187.01,575.69
8062,45631973,2023-02-04,109.43,685.1200000000001
8063,45631973,2023-02-05,-220.0,465.12000000000006
8064,45631973,2023-02-08,-1428.0,-962.8799999999999
8065,45631973,2023-02-09,105.79,-857.0899999999999
8066,45631973,2023-02-11,-108.78,-965.8699999999999
8067,45639009,2023-01-31,,489.05
8068,45639009,2023-02-04,-72.72,416.33000000000004
8069,45639009,2023-02-04,-108.24,308.09000000000003
8070,45639009,2023-02-05,-5.44,302.65000000000003
8071,45639009,2023-02-05,-72.56,230.09000000000003
8072,45639009,2023-02-09,-44.94,185.15000000000003
8073,45639009,2023-02-12,205.26,390.41
8074,45639009,2023-02-12,-114.03,276.38
8075,45688415,2023-01-31,,686.92
8076,45688415,2023-02-01,1393.7,2080.62
8077,45688415,2023-02-03,178.47,2259.09
8078,45688415,2023-02-07,-121.91,2137.1800000000003
8079,45688415,2023-02-11,96.36,2233.54
8080,45688415,2023-02-11,-135.48,2098.06
8081,45688415,2023-02-13,102.31,2200.37
8082,45706674,2023-01-31,,390.73
8083,45706674,2023-02-01,-1187.7,-796.97
8084,45706674,2023-02-04,114.54,-682.4300000000001
8085,45706674,2023-02-04,-141.31,-823.74
8086,45706674,2023-02-04,-150.84,-974.58
8087,45706674,2023-02-05,109.63,-864.95
8088,45706674,2023-02-06,-60.77,-925.72
8089,45706674,2023-02-10,-123.35,-1049.07
8090,45706674,2023-02-12,-158.11,-1207.18
8091,45740727,2023-01-31,,904.27
8092,45740727,2023-02-05,149.91,1054.18
8093,45740727,2023-02-08,-220.34,833.8399999999999
8094,45740727,2023-02-13,155.36,989.2
8095,45790907,2023-01-31,,567.67
8096,45790907,2023-02-01,1264.3,1831.9699999999998
8097,45790907,2023-02-01,112.34,1944.31
8098,45790907,2023-02-04,133.0,2077.31
8099,45790907,2023-02-04,-45.53,2031.78
8100,45790907,2023-02-05,108.92,2140.7
8101,45790907,2023-02-05,58.28,2198.98
8102,45790907,2023-02-07,-67.95,2131.03
8103,45790907,2023-02-10,-1275.4,855.6299999999999
8104,45790907,2023-02-12,-144.32,711.31
8105,45790907,2023-02-14,-67.85,643.4599999999999
8106,45816894,2023-01-31,,227.68
8107,45816894,2023-02-02,-81.01,146.67000000000002
8108,45816894,2023-02-08,1006.9,1153.57
8109,45816894,2023-02-13,-44.84,1108.73
8110,45816894,2023-02-13,-152.58,956.1500000000001
8111,45822265,2023-01-31,,881.34
8112,45822265,2023-02-02,-180.16,701.1800000000001
8113,45822265,2023-02-03,-113.78,587.4000000000001
8114,45822265,2023-02-05,99.15,686.5500000000001
8115,45822265,2023-02-05,-617.7,68.85000000000002
8116,45822265,2023-02-05,-1152.5,-1083.65
8117,45822265,2023-02-11,-86.28,-1169.93
8118,45822265,2023-02-11,-140.15,-1310.0800000000002
8119,45822265,2023-02-12,877.5,-432.58000000000015
8120,45829157,2023-01-31,,361.77
8121,45829157,2023-02-01,-147.6,214.17
8122,45829157,2023-02-03,-183.87,30.299999999999983
8123,45829157,2023-02-05,23.74,54.03999999999998
8124,45829157,2023-02-06,156.97,211.01
8125,45829157,2023-02-08,-80.46,130.54999999999995
8126,45829157,2023-02-10,114.0,244.54999999999995
8127,45829157,2023-02-12,89.04,333.59
8128,45829157,2023-02-14,-153.48,180.10999999999999
8129,45859156,2023-01-31,,644.5
8130,45859156,2023-02-01,-146.02,498.48
8131,45859156,2023-02-02,120.32,618.8
8132,45859156,2023-02-05,166.03,784.8299999999999
8133,45859156,2023-02-07,102.22,887.05
8134,45859156,2023-02-10,1725.1,2612.1499999999996
8135,45960045,2023-01-31,,853.47
8136,45960045,2023-02-03,128.1,981.57
8137,45960045,2023-02-03,49.28,1030.85
8138,45960045,2023-02-07,-45.38,985.47
8139,45960045,2023-02-09,120.08,1105.55
8140,45960045,2023-02-13,-35.47,1070.08
8141,45960045,2023-02-13,-48.13,1021.95
8142,45974864,2023-01-31,,957.27
8143,45974864,2023-02-03,-108.6,848.67
8144,45974864,2023-02-10,120.81,969.48
8145,45974864,2023-02-13,63.85,1033.33
8146,45974864,2023-02-14,-43.42,989.91
8147,46012936,2023-01-31,,120.79
8148,46012936,2023-02-03,46.59,167.38
8149,46012936,2023-02-04,-113.62,53.760000000000005
8150,46012936,2023-02-06,55.52,109.28
8151,46012936,2023-02-13,62.93,172.21
8152,46012936,2023-02-14,-175.07,-2.859999999999985
8153,46059921,2023-01-31,,905.78
8154,46059921,2023-02-01,-95.21,810.5699999999999
8155,46059921,2023-02-02,-79.3,731.27
8156,46059921,2023-02-10,83.52,814.79
8157,46059921,2023-02-13,9.8,824.59
8158,46059921,2023-02-14,-147.85,676.74
8159,46064017,2023-01-31,,672.77
8160,46064017,2023-02-02,28.99,701.76
8161,46064017,2023-02-03,129.73,831.49
8162,46064017,2023-02-05,60.9,892.39
8163,46064017,2023-02-10,1575.6,2467.99
8164,46064017,2023-02-11,-471.8,1996.1899999999998
8165,46064017,2023-02-12,145.68,2141.87
8166,46064017,2023-02-12,-115.87,2025.9999999999998
8167,46064017,2023-02-13,-800.9,1225.1
8168,46064017,2023-02-14,141.13,1366.2299999999998
8169,46067647,2023-01-31,,677.66
8170,46067647,2023-02-03,-54.41,623.25
8171,46067647,2023-02-03,-88.94,534.31
8172,46067647,2023-02-03,-98.31,436.0
8173,46067647,2023-02-06,64.29,500.28999999999996
8174,46067647,2023-02-08,-43.9,456.39
8175,46067647,2023-02-13,140.52,596.91
8176,46067647,2023-02-14,101.91,698.8199999999999
8177,46073044,2023-01-31,,957.36
8178,46073044,2023-02-06,-158.15,799.21
8179,46073044,2023-02-08,-265.04,534.17
8180,46073044,2023-02-11,-121.51,412.65999999999997
8181,46073044,2023-02-14,1879.5,2292.16
8182,46073044,2023-02-14,155.82,2447.98
8183,46085917,2023-01-31,,340.16
8184,46085917,2023-02-06,104.85,445.01
8185,46085917,2023-02-08,-110.8,334.21000000000004
8186,46085917,2023-02-08,-1374.1,-1039.8899999999999
8187,46085917,2023-02-09,-155.66,-1195.55
8188,46085917,2023-02-10,90.3,-1105.2499999999998
8189,46085917,2023-02-11,155.49,-949.7599999999999
8190,46085917,2023-02-13,67.31,-882.4499999999998
8191,46085917,2023-02-13,62.41,-820.0399999999998
8192,46100177,2023-01-31,,979.25
8193,46100177,2023-02-02,-93.98,885.27
8194,46100177,2023-02-02,-681.0,204.26999999999998
8195,46100177,2023-02-03,-42.34,161.92999999999998
8196,46100177,2023-02-06,-74.62,87.30999999999997
8197,46100177,2023-02-08,797.2,884.51
8198,46100177,2023-02-09,99.44,983.95
8199,46133743,2023-01-31,,862.26
8200,46133743,2023-02-02,-100.0,762.26
8201,46133743,2023-02-06,93.21,855.47
8202,46133743,2023-02-10,29.52,884.99
8203,46215382,2023-01-31,,549.77
8204,46215382,2023-02-03,-76.11,473.65999999999997
8205,46215382,2023-02-03,-152.95,320.71
8206,46215382,2023-02-03,-1569.4,-1248.69
8207,46215382,2023-02-04,-57.41,-1306.1000000000001
8208,46215382,2023-02-05,-114.53,-1420.63
8209,46215382,2023-02-06,171.29,-1249.3400000000001
8210,46215382,2023-02-07,-167.72,-1417.06
8211,46215382,2023-02-10,2084.1,667.04
8212,46215382,2023-02-11,-56.36,610.68
8213,46215382,2023-02-13,135.78,746.46
8214,46215382,2023-02-13,-38.78,707.68
8215,46230315,2023-01-31,,4.43
8216,46230315,2023-02-02,120.61,125.03999999999999
8217,46230315,2023-02-04,-153.16,-28.119999999999976
8218,46230315,2023-02-06,-145.42,-173.53999999999996
8219,46230315,2023-02-13,125.25,-48.289999999999964
8220,46230315,2023-02-13,-66.15,-114.43999999999997
8221,46231176,2023-01-31,,290.35
8222,46231176,2023-02-01,162.41,452.76
8223,46231176,2023-02-01,-1397.4,-944.6400000000001
8224,46231176,2023-02-02,98.15,-846.4900000000001
8225,46231176,2023-02-05,-46.86,-893.3500000000001
8226,46231176,2023-02-09,625.1,-268.2500000000001
8227,46231176,2023-02-11,-17.45,-285.7000000000001
8228,46231176,2023-02-12,55.81,-229.8900000000001
8229,46231176,2023-02-12,-37.7,-267.59000000000015
8230,46231176,2023-02-13,94.69,-172.90000000000012
8231,46231176,2023-02-13,-16.59,-189.49000000000012
8232,46255563,2023-01-31,,565.42
8233,46255563,2023-02-01,92.51,657.93
8234,46255563,2023-02-04,-129.16,528.77
8235,46255563,2023-02-14,-52.1,476.66999999999996
8236,46255563,2023-02-14,-89.67,387.0
8237,46322903,2023-01-31,,873.01
8238,46322903,2023-02-06,-22.54,850.47
8239,46322903,2023-02-06,-179.1,671.37
8240,46322903,2023-02-08,66.39,737.76
8241,46322903,2023-02-08,-206.07,531.69
8242,46322903,2023-02-09,143.77,675.46
8243,46322903,2023-02-14,81.74,757.2
8244,46326165,2023-01-31,,571.8
8245,46326165,2023-02-03,-94.28,477.52
8246,46326165,2023-02-06,14.55,492.06999999999994
8247,46326165,2023-02-07,-87.09,404.97999999999996
8248,46326165,2023-02-10,143.62,548.5999999999999
8249,46326165,2023-02-12,-99.3,449.29999999999995
8250,46326165,2023-02-13,185.27,634.5699999999999
8251,46346470,2023-01-31,,787.87
8252,46346470,2023-02-02,-93.94,693.9300000000001
8253,46346470,2023-02-04,-133.0,560.9300000000001
8254,46346470,2023-02-08,-35.51,525.42
8255,46346470,2023-02-09,70.29,595.71
8256,46346470,2023-02-11,-118.19,477.52
8257,46346470,2023-02-12,81.44,558.96
8258,46346470,2023-02-13,-67.73,491.23
8259,46355307,2023-01-31,,152.4
8260,46355307,2023-02-01,-161.31,-8.909999999999997
8261,46355307,2023-02-02,174.13,165.22
8262,46355307,2023-02-14,-987.9,-822.68
8263,46442210,2023-01-31,,732.14
8264,46442210,2023-02-02,-118.22,613.92
8265,46442210,2023-02-06,80.8,694.72
8266,46442210,2023-02-09,-899.8,-205.07999999999993
8267,46442210,2023-02-11,-23.58,-228.6599999999999
8268,46442210,2023-02-14,34.84,-193.81999999999994
8269,46479025,2023-01-31,,323.03
8270,46479025,2023-02-04,88.89,411.91999999999996
8271,46479025,2023-02-04,-45.51,366.40999999999997
8272,46479025,2023-02-11,-90.03,276.38
8273,46479025,2023-02-12,100.49,376.86999999999995
8274,46479025,2023-02-14,-172.38,204.48999999999995
8275,46525458,2023-01-31,,938.4
8276,46525458,2023-02-05,-1748.6,-810.1999999999999
8277,46525458,2023-02-07,1225.0,414.80000000000007
8278,46525458,2023-02-07,153.96,568.7600000000001
8279,46525458,2023-02-10,86.14,654.9000000000001
8280,46525458,2023-02-11,-38.25,616.6500000000001
8281,46525458,2023-02-13,-116.37,500.2800000000001
8282,46552077,2023-01-31,,672.51
8283,46552077,2023-02-02,-54.94,617.5699999999999
8284,46552077,2023-02-06,-153.53,464.03999999999996
8285,46561814,2023-01-31,,216.29
8286,46561814,2023-02-01,70.34,286.63
8287,46561814,2023-02-06,-106.0,180.63
8288,46561814,2023-02-07,93.93,274.56
8289,46561814,2023-02-07,-185.39,89.17000000000002
8290,46561814,2023-02-07,-214.17,-124.99999999999997
8291,46561814,2023-02-09,124.56,-0.4399999999999693
8292,46561814,2023-02-13,-159.46,-159.89999999999998
8293,46597215,2023-01-31,,455.5
8294,46597215,2023-02-06,73.5,529.0
8295,46597215,2023-02-07,165.34,694.34
8296,46597215,2023-02-08,1123.1,1817.44
8297,46597215,2023-02-09,-11.47,1805.97
8298,46597728,2023-01-31,,920.72
8299,46597728,2023-02-04,110.99,1031.71
8300,46597728,2023-02-05,749.9,1781.6100000000001
8301,46597728,2023-02-06,111.94,1893.55
8302,46597728,2023-02-13,-165.07,1728.48
8303,46597728,2023-02-13,-1856.7,-128.22000000000003
8304,46643937,2023-01-31,,751.73
8305,46643937,2023-02-03,61.92,813.65
8306,46643937,2023-02-07,67.88,881.53
8307,46643937,2023-02-07,-74.11,807.4200000000001
8308,46643937,2023-02-07,-1348.3,-540.8799999999999
8309,46643937,2023-02-11,226.92,-313.9599999999999
8310,46643937,2023-02-12,1041.9,727.9400000000002
8311,46643937,2023-02-12,76.94,804.8800000000001
8312,46643937,2023-02-14,-110.66,694.2200000000001
8313,46663039,2023-01-31,,989.43
8314,46663039,2023-02-01,49.37,1038.8
8315,46663039,2023-02-03,-52.27,986.53
8316,46663039,2023-02-03,-119.2,867.3299999999999
8317,46663039,2023-02-06,161.03,1028.36
8318,46663039,2023-02-06,34.2,1062.56
8319,46663039,2023-02-09,-813.0,249.55999999999995
8320,46663039,2023-02-12,120.86,370.41999999999996
8321,46663039,2023-02-14,-112.47,257.94999999999993
8322,46730484,2023-01-31,,398.49
8323,46730484,2023-02-04,111.88,510.37
8324,46730484,2023-02-10,-111.05,399.32
8325,46730484,2023-02-11,-63.08,336.24
8326,46730484,2023-02-13,80.9,417.14
8327,46730484,2023-02-14,-79.28,337.86
8328,46741126,2023-01-31,,393.18
8329,46741126,2023-02-02,-114.87,278.31
8330,46741126,2023-02-03,-169.26,109.05000000000001
8331,46741126,2023-02-06,-46.16,62.890000000000015
8332,46741126,2023-02-07,-60.76,2.1300000000000168
8333,46741126,2023-02-10,184.75,186.88000000000002
8334,46741126,2023-02-13,-116.37,70.51000000000002
8335,46768821,2023-01-31,,458.81
8336,46768821,2023-02-03,90.12,548.9300000000001
8337,46768821,2023-02-04,135.11,684.04
8338,46768821,2023-02-06,124.41,808.45
8339,46768821,2023-02-08,-132.61,675.84
8340,46768821,2023-02-13,129.28,805.12
8341,46790294,2023-01-31,,855.42
8342,46790294,2023-02-01,-55.85,799.5699999999999
8343,46790294,2023-02-01,-156.88,642.6899999999999
8344,46790294,2023-02-03,-72.41,570.28
8345,46790294,2023-02-07,87.09,657.37
8346,46790294,2023-02-08,-98.38,558.99
8347,46790294,2023-02-09,37.65,596.64
8348,46792863,2023-01-31,,843.5
8349,46792863,2023-02-01,-81.07,762.4300000000001
8350,46792863,2023-02-03,87.36,849.79
8351,46792863,2023-02-06,159.47,1009.26
8352,46792863,2023-02-07,-84.66,924.6
8353,46851905,2023-01-31,,18.23
8354,46851905,2023-02-01,216.49,234.72
8355,46851905,2023-02-01,-123.29,111.42999999999999
8356,46851905,2023-02-04,196.98,308.40999999999997
8357,46851905,2023-02-05,140.22,448.63
8358,46851905,2023-02-06,441.4,890.03
8359,46851905,2023-02-09,50.63,940.66
8360,46854962,2023-01-31,,364.03
8361,46854962,2023-02-01,35.88,399.90999999999997
8362,46854962,2023-02-01,-81.49,318.41999999999996
8363,46854962,2023-02-02,93.7,412.12
8364,46854962,2023-02-13,104.27,516.39
8365,46854962,2023-02-14,111.83,628.22
8366,46854962,2023-02-14,-544.0,84.22000000000003
8367,46879333,2023-01-31,,462.44
8368,46879333,2023-02-06,-135.77,326.66999999999996
8369,46879333,2023-02-10,38.95,365.62
8370,46879333,2023-02-14,-79.28,286.34
8371,46879333,2023-02-14,-128.86,157.47999999999996
8372,46913859,2023-01-31,,410.19
8373,46913859,2023-02-01,-119.68,290.51
8374,46913859,2023-02-05,88.7,379.21
8375,46913859,2023-02-07,126.94,506.15
8376,46913859,2023-02-08,1127.1,1633.25
8377,46913859,2023-02-09,-107.84,1525.41
8378,46920610,2023-01-31,,124.16
8379,46920610,2023-02-01,124.86,249.01999999999998
8380,46920610,2023-02-02,25.85,274.87
8381,46920610,2023-02-05,36.13,311.0
8382,46920610,2023-02-05,-161.25,149.75
8383,46920610,2023-02-08,-30.53,119.22
8384,46920610,2023-02-09,-93.51,25.709999999999994
8385,46925211,2023-01-31,,509.25
8386,46925211,2023-02-01,189.46,698.71
8387,46925211,2023-02-09,4.38,703.09
8388,46925211,2023-02-12,-205.26,497.83000000000004
8389,46925211,2023-02-13,49.89,547.72
8390,47040996,2023-01-31,,462.95
8391,47040996,2023-02-01,-130.83,332.12
8392,47040996,2023-02-02,173.89,506.01
8393,47040996,2023-02-03,121.3,627.31
8394,47040996,2023-02-04,-98.52,528.79
8395,47040996,2023-02-07,-89.73,439.05999999999995
8396,47040996,2023-02-09,-76.61,362.44999999999993
8397,47040996,2023-02-12,7.66,370.10999999999996
8398,47091705,2023-01-31,,54.6
8399,47091705,2023-02-01,-75.52,-20.919999999999995
8400,47091705,2023-02-02,41.88,20.960000000000008
8401,47091705,2023-02-02,-88.29,-67.33
8402,47091705,2023-02-03,-67.38,-134.70999999999998
8403,47091705,2023-02-04,95.6,-39.11
8404,47091705,2023-02-05,1195.0,1155.89
8405,47091705,2023-02-05,-142.28,1013.6100000000001
8406,47091705,2023-02-06,92.29,1105.9
8407,47091705,2023-02-09,1340.1,2446.0
8408,47091705,2023-02-14,96.17,2542.17
8409,47115177,2023-01-31,,759.59
8410,47115177,2023-02-01,81.36,840.95
8411,47115177,2023-02-01,-137.75,703.2
8412,47115177,2023-02-04,110.0,813.2
8413,47115177,2023-02-06,-527.4,285.80000000000007
8414,47115177,2023-02-09,-136.48,149.32000000000008
8415,47115177,2023-02-11,120.95,270.2700000000001
8416,47115177,2023-02-13,167.82,438.0900000000001
8417,47115177,2023-02-13,165.07,603.1600000000001
8418,47115177,2023-02-13,72.13,675.2900000000001
8419,47115177,2023-02-14,123.42,798.71
8420,47127756,2023-01-31,,300.02
8421,47127756,2023-02-02,-101.47,198.54999999999998
8422,47127756,2023-02-12,-84.03,114.51999999999998
8423,47133143,2023-01-31,,723.52
8424,47133143,2023-02-01,-182.36,541.16
8425,47133143,2023-02-03,33.17,574.3299999999999
8426,47133143,2023-02-07,-57.45,516.88
8427,47133143,2023-02-13,-31.07,485.80999999999995
8428,47133143,2023-02-14,-41.25,444.55999999999995
8429,47172665,2023-01-31,,11.06
8430,47172665,2023-02-08,-80.13,-69.07
8431,47172665,2023-02-08,-130.56,-199.63
8432,47172665,2023-02-13,56.41,-143.22
8433,47172665,2023-02-13,-25.59,-168.81
8434,47172665,2023-02-14,135.61,-33.19999999999999
8435,47226769,2023-01-31,,449.88
8436,47226769,2023-02-01,126.5,576.38
8437,47226769,2023-02-04,-132.93,443.45
8438,47226769,2023-02-06,1065.6,1509.05
8439,47226769,2023-02-06,-125.82,1383.23
8440,47226769,2023-02-07,169.12,1552.35
8441,47232232,2023-01-31,,53.44
8442,47232232,2023-02-01,126.4,179.84
8443,47232232,2023-02-07,-134.29,45.55000000000001
8444,47232232,2023-02-10,-136.1,-90.54999999999998
8445,47232232,2023-02-12,153.41,62.860000000000014
8446,47232232,2023-02-12,-117.55,-54.68999999999998
8447,47232232,2023-02-12,-157.46,-212.14999999999998
8448,47266645,2023-01-31,,207.15
8449,47266645,2023-02-02,876.4,1083.55
8450,47266645,2023-02-02,-190.68,892.8699999999999
8451,47266645,2023-02-06,122.69,1015.56
8452,47266645,2023-02-07,-484.1,531.4599999999999
8453,47266645,2023-02-13,138.4,669.8599999999999
8454,47313428,2023-01-31,,204.67
8455,47313428,2023-02-03,965.4,1170.07
8456,47313428,2023-02-08,-113.3,1056.77
8457,47313428,2023-02-13,-127.61,929.16
8458,47356348,2023-01-31,,65.95
8459,47356348,2023-02-03,1223.8,1289.75
8460,47356348,2023-02-13,-139.98,1149.77
8461,47406737,2023-01-31,,963.14
8462,47406737,2023-02-01,844.6,1807.74
8463,47406737,2023-02-03,-68.61,1739.13
8464,47406737,2023-02-06,-1204.5,534.6300000000001
8465,47406737,2023-02-08,24.94,559.5700000000002
8466,47406737,2023-02-09,179.26,738.8300000000002
8467,47406737,2023-02-09,-115.75,623.0800000000002
8468,47406737,2023-02-12,144.32,767.4000000000001
8469,47406737,2023-02-12,128.61,896.0100000000001
8470,47406737,2023-02-12,52.46,948.4700000000001
8471,47406737,2023-02-14,-129.18,819.2900000000001
8472,47414258,2023-01-31,,900.7
8473,47414258,2023-02-06,-27.94,872.76
8474,47414258,2023-02-06,-123.37,749.3900000000001
8475,47414258,2023-02-06,-184.01,565.3800000000001
8476,47414258,2023-02-07,-1277.4,-712.02
8477,47414258,2023-02-08,-63.1,-775.12
8478,47414258,2023-02-11,108.92,-666.2
8479,47414258,2023-02-13,-134.58,-800.78
8480,47473145,2023-01-31,,801.43
8481,47473145,2023-02-12,132.48,933.91
8482,47473145,2023-02-12,-35.17,898.7399999999999
8483,47483982,2023-01-31,,661.58
8484,47483982,2023-02-08,-76.6,584.98
8485,47483982,2023-02-10,74.87,659.85
8486,47483982,2023-02-11,159.08,818.9300000000001
8487,47483982,2023-02-13,1017.6,1836.5300000000002
8488,47582488,2023-01-31,,744.99
8489,47582488,2023-02-02,-124.68,620.31
8490,47582488,2023-02-03,-55.81,564.5
8491,47582488,2023-02-05,1.11,565.61
8492,47582488,2023-02-05,-88.27,477.34000000000003
8493,47582488,2023-02-05,-110.72,366.62
8494,47582488,2023-02-06,87.2,453.82
8495,47582488,2023-02-07,114.74,568.56
8496,47582488,2023-02-12,-7.97,560.59
8497,47582488,2023-02-13,-101.4,459.19
8498,47654093,2023-01-31,,294.0
8499,47654093,2023-02-04,-63.26,230.74
8500,47654093,2023-02-05,161.8,392.54
8501,47654093,2023-02-10,88.04,480.58000000000004
8502,47654093,2023-02-12,109.8,590.38
8503,47654093,2023-02-12,-191.46,398.92
8504,47763906,2023-01-31,,980.42
8505,47763906,2023-02-02,-20.57,959.8499999999999
8506,47763906,2023-02-02,-187.19,772.66
8507,47763906,2023-02-07,99.56,872.22
8508,47763906,2023-02-12,7.97,880.1899999999999
8509,47763906,2023-02-12,-210.36,669.8299999999999
8510,47781255,2023-01-31,,462.62
8511,47781255,2023-02-02,133.0,595.62
8512,47781255,2023-02-02,-24.87,570.75
8513,47781255,2023-02-02,-78.61,492.14
8514,47781255,2023-02-03,101.07,593.21
8515,47781255,2023-02-05,-67.95,525.26
8516,47781255,2023-02-08,63.9,589.16
8517,47781255,2023-02-10,34.35,623.51
8518,47781255,2023-02-14,124.48,747.99
8519,47808992,2023-01-31,,885.16
8520,47808992,2023-02-09,197.63,1082.79
8521,47808992,2023-02-10,106.19,1188.98
8522,47808992,2023-02-11,-121.09,1067.8899999999999
8523,47808992,2023-02-12,-44.96,1022.93
8524,47824990,2023-01-31,,704.97
8525,47824990,2023-02-12,86.17,791.14
8526,47824990,2023-02-13,113.91,905.0500000000001
8527,47886866,2023-01-31,,399.75
8528,47886866,2023-02-02,-25.61,374.14
8529,47886866,2023-02-04,105.17,479.31
8530,47886866,2023-02-07,-110.79,368.52
8531,47886866,2023-02-10,51.82,420.34
8532,47886866,2023-02-11,125.01,545.35
8533,47886866,2023-02-11,-133.59,411.76
8534,47886866,2023-02-14,-32.8,378.96
8535,47902339,2023-01-31,,919.92
8536,47902339,2023-02-05,-65.25,854.67
8537,47902339,2023-02-06,-80.92,773.75
8538,47902339,2023-02-10,165.02,938.77
8539,47932460,2023-01-31,,785.05
8540,47932460,2023-02-01,-99.41,685.64
8541,47932460,2023-02-04,204.89,890.53
8542,47932460,2023-02-04,-220.77,669.76
8543,47932460,2023-02-07,-81.45,588.31
8544,47932460,2023-02-08,-124.98,463.3299999999999
8545,47932460,2023-02-09,-27.53,435.79999999999995
8546,47932460,2023-02-11,909.1,1344.9
8547,47964895,2023-01-31,,982.97
8548,47964895,2023-02-04,-111.88,871.09
8549,47964895,2023-02-05,-184.78,686.3100000000001
8550,47964895,2023-02-07,-46.27,640.0400000000001
8551,47964895,2023-02-14,-109.46,530.58
8552,48018851,2023-01-31,,288.26
8553,48018851,2023-02-05,897.5,1185.76
8554,48018851,2023-02-07,-101.82,1083.94
8555,48018851,2023-02-13,85.75,1169.69
8556,48018851,2023-02-14,144.57,1314.26
8557,48029032,2023-01-31,,422.88
8558,48029032,2023-02-06,69.2,492.08
8559,48029032,2023-02-06,27.93,520.01
8560,48029032,2023-02-09,98.06,618.0699999999999
8561,48029032,2023-02-09,15.37,633.4399999999999
8562,48029032,2023-02-09,-168.19,465.25
8563,48029032,2023-02-10,-65.29,399.96
8564,48029032,2023-02-12,92.12,492.08
8565,48029032,2023-02-12,-7.66,484.42
8566,48029032,2023-02-13,142.2,626.62
8567,48050578,2023-01-31,,203.26
8568,48050578,2023-02-06,60.08,263.34
8569,48050578,2023-02-07,101.89,365.23
8570,48056301,2023-01-31,,943.28
8571,48056301,2023-02-03,85.06,1028.34
8572,48056301,2023-02-03,-98.24,930.1
8573,48056301,2023-02-13,52.77,982.87
8574,48056301,2023-02-13,-114.39,868.48
8575,48071843,2023-01-31,,997.62
8576,48071843,2023-02-01,-387.9,609.72
8577,48071843,2023-02-02,159.22,768.94
8578,48071843,2023-02-09,-1877.3,-1108.36
8579,48075275,2023-01-31,,881.31
8580,48075275,2023-02-01,-77.94,803.3699999999999
8581,48075275,2023-02-01,-98.75,704.6199999999999
8582,48075275,2023-02-04,117.79,822.41
8583,48075275,2023-02-09,85.81,908.2199999999999
8584,48075275,2023-02-10,142.07,1050.29
8585,48075275,2023-02-14,-1209.0,-158.71000000000004
8586,48081999,2023-01-31,,290.89
8587,48081999,2023-02-02,96.07,386.96
8588,48081999,2023-02-04,189.06,576.02
8589,48081999,2023-02-05,111.66,687.68
8590,48081999,2023-02-06,27.72,715.4
8591,48081999,2023-02-11,72.7,788.1
8592,48081999,2023-02-11,-132.19,655.91
8593,48081999,2023-02-12,1291.9,1947.81
8594,48081999,2023-02-12,-89.43,1858.3799999999999
8595,48081999,2023-02-12,-168.57,1689.81
8596,48081999,2023-02-13,-104.18,1585.6299999999999
8597,48131431,2023-01-31,,809.8
8598,48131431,2023-02-01,-128.93,680.8699999999999
8599,48131431,2023-02-14,404.9,1085.77
8600,48185625,2023-01-31,,822.11
8601,48185625,2023-02-02,-74.49,747.62
8602,48185625,2023-02-03,-106.8,640.82
8603,48185625,2023-02-07,185.51,826.33
8604,48185625,2023-02-13,-98.9,727.4300000000001
8605,48186857,2023-01-31,,518.26
8606,48186857,2023-02-03,145.32,663.5799999999999
8607,48186857,2023-02-06,98.85,762.43
8608,48186857,2023-02-09,97.62,860.05
8609,48186857,2023-02-09,69.39,929.4399999999999
8610,48186857,2023-02-12,110.79,1040.23
8611,48271608,2023-01-31,,343.94
8612,48271608,2023-02-01,54.71,398.65
8613,48271608,2023-02-03,164.56,563.21
8614,48271608,2023-02-07,140.12,703.33
8615,48271608,2023-02-10,55.38,758.71
8616,48271608,2023-02-10,47.4,806.11
8617,48271608,2023-02-10,-111.12,694.99
8618,48271608,2023-02-13,1665.4,2360.3900000000003
8619,48271608,2023-02-14,153.15,2513.54
8620,48318402,2023-01-31,,965.28
8621,48318402,2023-02-04,-44.62,920.66
8622,48318402,2023-02-04,-111.18,809.48
8623,48318402,2023-02-08,-96.4,713.0799999999999
8624,48318402,2023-02-09,30.36,743.4399999999999
8625,48318402,2023-02-14,101.59,845.03
8626,48350476,2023-01-31,,305.2
8627,48350476,2023-02-02,95.1,400.29999999999995
8628,48350476,2023-02-02,-38.74,361.56
8629,48350476,2023-02-03,-82.71,278.85
8630,48350476,2023-02-04,-152.03,126.82
8631,48350476,2023-02-05,-92.4,34.41999999999999
8632,48350476,2023-02-06,39.91,74.32999999999998
8633,48350476,2023-02-10,213.83,288.15999999999997
8634,48350476,2023-02-10,-57.64,230.51999999999998
8635,48399121,2023-01-31,,984.98
8636,48399121,2023-02-09,233.91,1218.89
8637,48399121,2023-02-14,-104.64,1114.25
8638,48429255,2023-01-31,,79.7
8639,48429255,2023-02-06,-110.9,-31.200000000000003
8640,48429255,2023-02-11,99.36,68.16
8641,48429255,2023-02-12,128.19,196.35
8642,48429255,2023-02-14,-88.32,108.03
8643,48434572,2023-01-31,,351.7
8644,48434572,2023-02-01,-113.69,238.01
8645,48434572,2023-02-03,28.45,266.46
8646,48434572,2023-02-04,72.42,338.88
8647,48434572,2023-02-10,75.71,414.59
8648,48434572,2023-02-11,720.7,1135.29
8649,48434572,2023-02-12,-118.43,1016.8599999999999
8650,48444386,2023-01-31,,962.57
8651,48444386,2023-02-05,-91.73,870.84
8652,48444386,2023-02-06,94.25,965.09
8653,48444386,2023-02-11,152.17,1117.26
8654,48444386,2023-02-14,73.36,1190.6200000000001
8655,48491614,2023-01-31,,754.45
8656,48491614,2023-02-01,120.88,875.33
8657,48491614,2023-02-06,-738.2,137.13
8658,48491614,2023-02-11,-6.19,130.94
8659,48500030,2023-01-31,,917.05
8660,48500030,2023-02-09,-125.13,791.92
8661,48500030,2023-02-13,56.68,848.5999999999999
8662,48500030,2023-02-14,-148.05,700.55
8663,48507357,2023-01-31,,980.8
8664,48507357,2023-02-03,80.54,1061.34
8665,48507357,2023-02-06,-80.07,981.27
8666,48507357,2023-02-11,-81.26,900.01
8667,48524535,2023-01-31,,265.03
8668,48524535,2023-02-01,32.75,297.78
8669,48524535,2023-02-02,50.17,347.95
8670,48524535,2023-02-03,-76.66,271.28999999999996
8671,48524535,2023-02-06,-50.95,220.33999999999997
8672,48524535,2023-02-06,-78.99,141.34999999999997
8673,48524535,2023-02-07,-126.03,15.319999999999979
8674,48524535,2023-02-08,43.73,59.049999999999976
8675,48524535,2023-02-08,-65.85,-6.8000000000000185
8676,48524535,2023-02-10,-71.44,-78.24000000000001
8677,48524535,2023-02-11,-24.18,-102.42000000000002
8678,48524535,2023-02-14,120.62,18.19999999999999
8679,48524535,2023-02-14,-50.36,-32.16000000000001
8680,48532894,2023-01-31,,662.86
8681,48532894,2023-02-02,109.57,772.4300000000001
8682,48532894,2023-02-03,79.16,851.59
8683,48532894,2023-02-11,91.38,942.97
8684,48532894,2023-02-14,597.7,1540.67
8685,48553648,2023-01-31,,80.62
8686,48553648,2023-02-02,-122.23,-41.61
8687,48553648,2023-02-05,-12.08,-53.69
8688,48553648,2023-02-13,89.1,35.41
8689,48569537,2023-01-31,,374.69
8690,48569537,2023-02-01,-1153.0,-778.31
8691,48569537,2023-02-05,-178.08,-956.39
8692,48569537,2023-02-07,-173.79,-1130.1799999999998
8693,48569537,2023-02-07,-230.31,-1360.49
8694,48569537,2023-02-09,938.3,-422.19000000000005
8695,48569537,2023-02-10,-92.21,-514.4000000000001
8696,48569537,2023-02-11,818.2,303.79999999999995
8697,48569537,2023-02-13,-46.16,257.64
8698,48569537,2023-02-14,50.36,307.99999999999994
8699,48591774,2023-01-31,,422.94
8700,48591774,2023-02-01,84.03,506.97
8701,48591774,2023-02-03,-91.97,415.0
8702,48591774,2023-02-08,146.43,561.4300000000001
8703,48591774,2023-02-09,117.1,678.53
8704,48591774,2023-02-10,-90.33,588.2
8705,48591774,2023-02-10,-121.67,466.53
8706,48591774,2023-02-14,-139.74,326.78999999999996
8707,48625559,2023-01-31,,797.88
8708,48625559,2023-02-03,88.02,885.9
8709,48625559,2023-02-04,-146.29,739.61
8710,48625559,2023-02-07,105.97,845.58
8711,48625559,2023-02-08,147.08,992.6600000000001
8712,48625559,2023-02-08,-129.99,862.6700000000001
8713,48625559,2023-02-09,44.19,906.86
8714,48625559,2023-02-10,-93.87,812.99
8715,48625559,2023-02-11,187.8,1000.79
8716,48625559,2023-02-12,85.27,1086.06
8717,48625559,2023-02-14,-53.72,1032.34
8718,48654969,2023-01-31,,83.93
8719,48654969,2023-02-03,43.31,127.24000000000001
8720,48654969,2023-02-08,-119.16,8.080000000000013
8721,48654969,2023-02-10,951.2,959.2800000000001
8722,48654969,2023-02-10,747.3,1706.58
8723,48722022,2023-01-31,,586.44
8724,48722022,2023-02-01,123.96,710.4000000000001
8725,48722022,2023-02-05,-45.1,665.3000000000001
8726,48722022,2023-02-07,148.28,813.58
8727,48722022,2023-02-12,93.42,907.0
8728,48722022,2023-02-12,-61.43,845.57
8729,48733708,2023-01-31,,370.74
8730,48733708,2023-02-01,-60.93,309.81
8731,48733708,2023-02-01,-212.62,97.19
8732,48733708,2023-02-02,6.47,103.66
8733,48733708,2023-02-03,87.65,191.31
8734,48733708,2023-02-04,5.54,196.85
8735,48733708,2023-02-05,-118.28,78.57000000000001
8736,48733708,2023-02-08,-105.76,-27.189999999999998
8737,48733708,2023-02-09,123.28,96.09
8738,48757991,2023-01-31,,676.6
8739,48757991,2023-02-01,141.6,818.2
8740,48757991,2023-02-07,136.97,955.1700000000001
8741,48757991,2023-02-11,86.98,1042.15
8742,48781678,2023-01-31,,401.55
8743,48781678,2023-02-01,-856.5,-454.95
8744,48781678,2023-02-05,150.73,-304.22
8745,48783408,2023-01-31,,278.34
8746,48783408,2023-02-03,140.36,418.7
8747,48783408,2023-02-04,101.75,520.45
8748,48783408,2023-02-07,185.47,705.92
8749,48783408,2023-02-08,105.53,811.45
8750,48783408,2023-02-09,163.2,974.65
8751,48783408,2023-02-11,87.63,1062.28
8752,48799650,2023-01-31,,160.75
8753,48799650,2023-02-01,83.35,244.1
8754,48799650,2023-02-08,-154.93,89.16999999999999
8755,48831634,2023-01-31,,146.94
8756,48831634,2023-02-04,-90.91,56.03
8757,48831634,2023-02-04,-1593.8,-1537.77
8758,48831634,2023-02-06,141.38,-1396.3899999999999
8759,48831634,2023-02-09,91.85,-1304.54
8760,48831634,2023-02-09,69.64,-1234.9
8761,48831634,2023-02-11,-103.93,-1338.83
8762,48831634,2023-02-11,-1243.0,-2581.83
8763,48831634,2023-02-13,35.46,-2546.37
8764,48831634,2023-02-13,-148.74,-2695.11
8765,48860469,2023-01-31,,730.37
8766,48860469,2023-02-01,-166.48,563.89
8767,48860469,2023-02-07,195.55,759.44
8768,48860469,2023-02-08,-55.57,703.87
8769,48860469,2023-02-08,-103.37,600.5
8770,48860469,2023-02-10,-167.13,433.37
8771,48875351,2023-01-31,,239.7
8772,48875351,2023-02-12,100.25,339.95
8773,48886521,2023-01-31,,827.29
8774,48886521,2023-02-01,134.06,961.3499999999999
8775,48886521,2023-02-03,98.44,1059.79
8776,48886521,2023-02-04,184.38,1244.17
8777,48886521,2023-02-05,-101.6,1142.57
8778,48886521,2023-02-08,33.64,1176.21
8779,48906756,2023-01-31,,996.87
8780,48906756,2023-02-02,36.6,1033.47
8781,48906756,2023-02-02,-34.56,998.91
8782,48906756,2023-02-05,637.3,1636.21
8783,48906756,2023-02-09,-229.85,1406.36
8784,48911149,2023-01-31,,580.54
8785,48911149,2023-02-05,144.63,725.17
8786,48911149,2023-02-09,82.08,807.25
8787,48911149,2023-02-11,-518.1,289.15
8788,48930319,2023-01-31,,595.65
8789,48930319,2023-02-01,167.53,763.18
8790,48930319,2023-02-04,76.06,839.24
8791,48930319,2023-02-05,-68.53,770.71
8792,48930319,2023-02-05,-177.45,593.26
8793,48930319,2023-02-08,23.59,616.85
8794,48930319,2023-02-12,51.05,667.9
8795,48940493,2023-01-31,,394.19
8796,48940493,2023-02-02,217.51,611.7
8797,48940493,2023-02-02,-22.64,589.06
8798,48940493,2023-02-04,125.73,714.79
8799,48940493,2023-02-04,90.44,805.23
8800,48940493,2023-02-05,216.4,1021.63
8801,48940493,2023-02-05,174.7,1196.33
8802,48940493,2023-02-07,-106.64,1089.69
8803,48940493,2023-02-08,149.31,1239.0
8804,48940493,2023-02-08,-66.57,1172.43
8805,48940493,2023-02-08,-967.3,205.1300000000001
8806,48940493,2023-02-12,970.8,1175.93
8807,48940493,2023-02-12,-175.32,1000.6100000000001
8808,48976336,2023-01-31,,400.12
8809,48976336,2023-02-01,-2027.7,-1627.58
8810,48976336,2023-02-03,-59.2,-1686.7800000000002
8811,48976336,2023-02-06,58.17,-1628.6100000000001
8812,48976336,2023-02-07,-218.78,-1847.39
8813,48976336,2023-02-08,-91.24,-1938.63
8814,48976336,2023-02-10,117.56,-1821.0700000000002
8815,49031081,2023-01-31,,788.18
8816,49031081,2023-02-02,131.8,919.98
8817,49031081,2023-02-03,127.58,1047.56
8818,49031081,2023-02-04,-97.05,950.51
8819,49031081,2023-02-08,76.81,1027.32
8820,49031081,2023-02-09,-94.81,932.51
8821,49031081,2023-02-10,134.24,1066.75
8822,49031081,2023-02-10,81.26,1148.01
8823,49031081,2023-02-12,-137.83,1010.18
8824,49031081,2023-02-14,-58.59,951.5899999999999
8825,49031379,2023-01-31,,373.63
8826,49031379,2023-02-01,67.01,440.64
8827,49031379,2023-02-03,135.44,576.0799999999999
8828,49031379,2023-02-03,96.51,672.59
8829,49031379,2023-02-07,46.14,718.73
8830,49031379,2023-02-08,-119.48,599.25
8831,49031379,2023-02-10,-129.69,469.56
8832,49039474,2023-01-31,,574.7
8833,49039474,2023-02-01,89.56,664.26
8834,49039474,2023-02-03,143.42,807.6800000000001
8835,49039474,2023-02-04,56.75,864.4300000000001
8836,49039474,2023-02-05,-1168.4,-303.97
8837,49039474,2023-02-07,24.41,-279.56
8838,49039474,2023-02-11,-1815.0,-2094.56
8839,49071892,2023-01-31,,909.58
8840,49071892,2023-02-04,132.12,1041.7
8841,49071892,2023-02-04,-95.76,945.94
8842,49071892,2023-02-06,50.78,996.72
8843,49071892,2023-02-08,113.3,1110.02
8844,49071892,2023-02-09,-93.18,1016.84
8845,49071892,2023-02-10,-141.83,875.01
8846,49075324,2023-01-31,,301.39
8847,49075324,2023-02-03,-40.55,260.84
8848,49075324,2023-02-03,-716.6,-455.76000000000005
8849,49075324,2023-02-06,73.4,-382.36
8850,49075324,2023-02-10,55.08,-327.28000000000003
8851,49095464,2023-01-31,,1.3
8852,49095464,2023-02-01,91.66,92.96
8853,49095464,2023-02-01,-146.39,-53.42999999999999
8854,49095464,2023-02-06,-149.41,-202.83999999999997
8855,49095464,2023-02-06,-168.59,-371.43
8856,49095464,2023-02-11,43.12,-328.31
8857,49095464,2023-02-11,-155.81,-484.12
8858,49095464,2023-02-12,-140.22,-624.34
8859,49095464,2023-02-13,140.3,-484.03999999999996
8860,49095464,2023-02-13,119.03,-365.01
8861,49095464,2023-02-13,-1237.4,-1602.41
8862,49127699,2023-01-31,,155.53
8863,49127699,2023-02-01,83.63,239.16
8864,49127699,2023-02-07,89.31,328.47
8865,49127699,2023-02-08,110.78,439.25
8866,49127699,2023-02-08,-122.65,316.6
8867,49127699,2023-02-09,108.53,425.13
8868,49127699,2023-02-11,-130.19,294.94
8869,49157903,2023-01-31,,601.62
8870,49157903,2023-02-03,-993.7,-392.08000000000004
8871,49157903,2023-02-05,175.05,-217.03000000000003
8872,49157903,2023-02-06,-103.08,-320.11
8873,49157903,2023-02-12,94.16,-225.95000000000005
8874,49172838,2023-01-31,,136.96
8875,49172838,2023-02-03,-113.68,23.28
8876,49172838,2023-02-10,24.85,48.13
8877,49172838,2023-02-11,-96.47,-48.339999999999996
8878,49172838,2023-02-13,1545.5,1497.16
8879,49172838,2023-02-14,141.48,1638.64
8880,49186099,2023-01-31,,208.24
8881,49186099,2023-02-01,118.24,326.48
8882,49186099,2023-02-01,90.07,416.55
8883,49186099,2023-02-04,92.27,508.82
8884,49216581,2023-01-31,,911.91
8885,49216581,2023-02-01,-754.9,157.01
8886,49216581,2023-02-07,1147.4,1304.41
8887,49216581,2023-02-10,-1812.5,-508.0899999999999
8888,49216581,2023-02-13,138.94,-369.1499999999999
8889,49216581,2023-02-13,-127.19,-496.3399999999999
8890,49216581,2023-02-13,-569.6,-1065.94
8891,49253709,2023-01-31,,473.46
8892,49253709,2023-02-01,65.02,538.48
8893,49253709,2023-02-01,-120.88,417.59999999999997
8894,49253709,2023-02-03,134.37,551.97
8895,49253709,2023-02-04,129.16,681.13
8896,49253709,2023-02-04,107.78,788.91
8897,49253709,2023-02-05,-209.45,579.46
8898,49253709,2023-02-07,129.29,708.75
8899,49253709,2023-02-12,151.37,860.12
8900,49253709,2023-02-12,-52.81,807.31
8901,49253709,2023-02-12,-87.33,719.98
8902,49253709,2023-02-13,-109.33,610.65
8903,49310474,2023-01-31,,929.16
8904,49310474,2023-02-01,131.27,1060.43
8905,49310474,2023-02-01,-84.68,975.75
8906,49310474,2023-02-06,-79.45,896.3
8907,49310474,2023-02-07,124.51,1020.81
8908,49310474,2023-02-07,-49.81,971.0
8909,49310474,2023-02-13,165.82,1136.82
8910,49310474,2023-02-14,32.96,1169.78
8911,49310474,2023-02-14,-88.77,1081.01
8912,49400211,2023-01-31,,460.24
8913,49400211,2023-02-01,212.62,672.86
8914,49400211,2023-02-02,155.92,828.78
8915,49400211,2023-02-08,192.5,1021.28
8916,49400211,2023-02-09,67.33,1088.61
8917,49400211,2023-02-10,-102.74,985.87
8918,49410021,2023-01-31,,508.72
8919,49410021,2023-02-01,112.52,621.24
8920,49410021,2023-02-06,-121.6,499.64000000000004
8921,49410021,2023-02-12,-129.45,370.19000000000005
8922,49410021,2023-02-14,-72.61,297.58000000000004
8923,49427302,2023-01-31,,468.73
8924,49427302,2023-02-03,79.37,548.1
8925,49427302,2023-02-04,-76.17,471.93
8926,49427302,2023-02-06,1045.4,1517.3300000000002
8927,49427302,2023-02-06,-93.16,1424.17
8928,49427302,2023-02-07,51.11,1475.2800000000002
8929,49427302,2023-02-08,81.34,1556.6200000000001
8930,49427302,2023-02-11,-112.24,1444.38
8931,49427302,2023-02-12,49.41,1493.7900000000002
8932,49441522,2023-01-31,,75.3
8933,49441522,2023-02-01,159.64,234.94
8934,49441522,2023-02-02,-132.64,102.30000000000001
8935,49441522,2023-02-03,183.44,285.74
8936,49441522,2023-02-09,35.02,320.76
8937,49441522,2023-02-10,10.96,331.72
8938,49441522,2023-02-11,-152.11,179.61
8939,49454023,2023-01-31,,798.72
8940,49454023,2023-02-01,780.9,1579.62
8941,49454023,2023-02-02,-50.17,1529.45
8942,49454023,2023-02-02,-92.61,1436.84
8943,49454023,2023-02-02,-123.95,1312.89
8944,49454023,2023-02-03,111.24,1424.13
8945,49454023,2023-02-06,155.88,1580.01
8946,49454023,2023-02-07,1070.1,2650.1099999999997
8947,49454023,2023-02-08,-751.9,1898.21
8948,49454023,2023-02-10,-86.78,1811.4299999999998
8949,49454023,2023-02-12,57.5,1868.9299999999998
8950,49459559,2023-01-31,,467.56
8951,49459559,2023-02-07,808.1,1275.66
8952,49459559,2023-02-11,-96.16,1179.5
8953,49459559,2023-02-12,-144.16,1035.34
8954,49459559,2023-02-13,-107.55,927.79
8955,49459559,2023-02-14,68.56,996.35
8956,49467252,2023-01-31,,444.92
8957,49467252,2023-02-04,64.43,509.35
8958,49467252,2023-02-05,59.15,568.5
8959,49467252,2023-02-06,-51.78,516.72
8960,49467252,2023-02-10,-17.18,499.54
8961,49516533,2023-01-31,,7.4
8962,49516533,2023-02-02,-65.53,-58.13
8963,49516533,2023-02-02,-65.93,-124.06
8964,49516533,2023-02-04,-578.6,-702.6600000000001
8965,49516533,2023-02-05,61.84,-640.8199999999999
8966,49516533,2023-02-07,42.04,-598.78
8967,49516533,2023-02-08,-141.86,-740.64
8968,49516533,2023-02-09,-106.29,-846.93
8969,49516533,2023-02-11,187.53,-659.4
8970,49516533,2023-02-11,-20.99,-680.39
8971,49516533,2023-02-13,-1188.4,-1868.79
8972,49520335,2023-01-31,,198.79
8973,49520335,2023-02-01,77.78,276.57
8974,49520335,2023-02-03,-104.62,171.95
8975,49520335,2023-02-08,-14.84,157.10999999999999
8976,49520335,2023-02-10,1795.9,1953.01
8977,49520335,2023-02-12,88.2,2041.21
8978,49520335,2023-02-14,-88.67,1952.54
8979,49533543,2023-01-31,,190.64
8980,49533543,2023-02-04,-45.03,145.60999999999999
8981,49533543,2023-02-04,-164.38,-18.77000000000001
8982,49533543,2023-02-05,-986.7,-1005.47
8983,49533543,2023-02-11,57.11,-948.36
8984,49533543,2023-02-11,-77.77,-1026.13
8985,49533543,2023-02-11,-139.2,-1165.33
8986,49534905,2023-01-31,,383.91
8987,49534905,2023-02-07,106.1,490.01
8988,49536707,2023-01-31,,37.3
8989,49536707,2023-02-01,-136.75,-99.45
8990,49536707,2023-02-02,-104.98,-204.43
8991,49536707,2023-02-03,-120.86,-325.29
8992,49536707,2023-02-03,-173.01,-498.3
8993,49536707,2023-02-05,147.37,-350.93
8994,49536707,2023-02-08,35.81,-315.12
8995,49536707,2023-02-11,-113.2,-428.32
8996,49536707,2023-02-14,-101.69,-530.01
8997,49536707,2023-02-14,-120.83,-650.84
8998,49536707,2023-02-14,-228.87,-879.71
8999,49540328,2023-01-31,,458.12
9000,49540328,2023-02-02,-98.11,360.01
9001,49540328,2023-02-04,-122.19,237.82
9002,49540328,2023-02-05,-93.03,144.79000000000002
9003,49540328,2023-02-09,110.51,255.3
9004,49540328,2023-02-13,-172.54,82.76000000000002
9005,49550154,2023-01-31,,178.14
9006,49550154,2023-02-01,-122.7,55.43999999999998
9007,49550154,2023-02-05,76.04,131.48
9008,49550154,2023-02-08,-63.41,68.07
9009,49550154,2023-02-08,-79.16,-11.090000000000003
9010,49550154,2023-02-10,-179.95,-191.04
9011,49550154,2023-02-13,151.76,-39.28
9012,49550154,2023-02-14,166.38,127.1
9013,49581833,2023-01-31,,117.56
9014,49581833,2023-02-01,-52.0,65.56
9015,49581833,2023-02-02,-185.74,-120.18
9016,49581833,2023-02-02,-1640.2,-1760.38
9017,49581833,2023-02-04,-56.75,-1817.13
9018,49581833,2023-02-13,1013.4,-803.7300000000001
9019,49581833,2023-02-14,-138.71,-942.4400000000002
9020,49696722,2023-01-31,,142.69
9021,49696722,2023-02-02,153.46,296.15
9022,49696722,2023-02-04,-88.15,208.0
9023,49696722,2023-02-07,-127.37,80.63
9024,49696722,2023-02-11,126.93,207.56
9025,49696722,2023-02-13,1291.4,1498.96
9026,49696722,2023-02-13,-44.2,1454.76
9027,49834565,2023-01-31,,51.12
9028,49834565,2023-02-03,72.44,123.56
9029,49834565,2023-02-12,-76.93,46.629999999999995
9030,49840526,2023-01-31,,461.64
9031,49840526,2023-02-03,95.71,557.35
9032,49840526,2023-02-05,-200.77,356.58
9033,49840526,2023-02-08,2591.7,2948.2799999999997
9034,49840526,2023-02-09,1530.9,4479.18
9035,49840526,2023-02-09,229.85,4709.03
9036,49840526,2023-02-09,168.65,4877.68
9037,49840526,2023-02-09,-58.39,4819.29
9038,49840526,2023-02-10,107.56,4926.849999999999
9039,49941860,2023-01-31,,655.66
9040,49941860,2023-02-01,60.93,716.5899999999999
9041,49941860,2023-02-03,66.9,783.49
9042,49941860,2023-02-08,-34.93,748.56
9043,49961732,2023-01-31,,673.71
9044,49961732,2023-02-01,99.06,772.77
9045,49961732,2023-02-01,49.48,822.25
9046,49961732,2023-02-08,48.01,870.26
9047,49961732,2023-02-08,-133.54,736.72
9048,49961732,2023-02-09,22.93,759.65
9049,49961732,2023-02-11,107.51,867.1600000000001
9050,49961732,2023-02-11,-68.14,799.02
9051,49966528,2023-01-31,,641.18
9052,49966528,2023-02-01,133.29,774.4699999999999
9053,49966528,2023-02-03,-92.73,681.7399999999999
9054,49966528,2023-02-04,-115.54,566.1999999999999
9055,49966528,2023-02-05,176.37,742.5699999999999
9056,49966528,2023-02-06,152.43,895.0
9057,49966528,2023-02-06,-161.12,733.8799999999999
9058,49966528,2023-02-07,180.28,914.16
9059,49966528,2023-02-09,115.5,1029.6599999999999
9060,49966528,2023-02-12,114.03,1143.69
9061,50018070,2023-01-31,,450.64
9062,50018070,2023-02-03,-656.3,-205.65999999999997
9063,50018070,2023-02-05,112.93,-92.72999999999996
9064,50018070,2023-02-08,-92.25,-184.97999999999996
9065,50018070,2023-02-10,-90.3,-275.28
9066,50024545,2023-01-31,,867.21
9067,50024545,2023-02-03,84.79,952.0
9068,50024545,2023-02-07,-113.13,838.87
9069,50024545,2023-02-07,-605.2,233.66999999999996
9070,50024545,2023-02-09,180.04,413.7099999999999
9071,50024545,2023-02-11,-122.19,291.52
9072,50024545,2023-02-11,-1733.6,-1442.08
9073,50024545,2023-02-13,-37.47,-1479.55
9074,50024545,2023-02-13,-71.7,-1551.25
9075,50031425,2023-01-31,,695.18
9076,50031425,2023-02-03,493.5,1188.6799999999998
9077,50031425,2023-02-03,115.16,1303.84
9078,50031425,2023-02-07,124.56,1428.3999999999999
9079,50031425,2023-02-10,180.01,1608.4099999999999
9080,50031425,2023-02-12,-124.59,1483.82
9081,50031425,2023-02-14,42.03,1525.85
9082,50114041,2023-01-31,,60.83
9083,50114041,2023-02-06,-152.43,-91.60000000000001
9084,50115324,2023-01-31,,329.32
9085,50115324,2023-02-01,80.86,410.18
9086,50115324,2023-02-03,46.85,457.03
9087,50115324,2023-02-03,-130.53,326.5
9088,50115324,2023-02-08,120.55,447.05
9089,50115324,2023-02-12,170.71,617.76
9090,50115324,2023-02-13,33.78,651.54
9091,50115324,2023-02-13,-130.18,521.36
9092,50115324,2023-02-13,-813.5,-292.14
9093,50122119,2023-01-31,,264.61
9094,50122119,2023-02-01,774.6,1039.21
9095,50122119,2023-02-03,-33.17,1006.0400000000001
9096,50122119,2023-02-12,18.99,1025.03
9097,50122119,2023-02-12,-970.8,54.23000000000013
9098,50132654,2023-01-31,,562.17
9099,50132654,2023-02-02,177.5,739.67
9100,50132654,2023-02-04,-97.84,641.8299999999999
9101,50132654,2023-02-05,168.74,810.5699999999999
9102,50132654,2023-02-07,88.86,899.43
9103,50132654,2023-02-08,63.1,962.53
9104,50132654,2023-02-09,-89.08,873.4499999999999
9105,50132654,2023-02-12,117.48,990.93
9106,50132654,2023-02-14,-88.1,902.8299999999999
9107,50150279,2023-01-31,,567.24
9108,50150279,2023-02-05,-74.52,492.72
9109,50150279,2023-02-06,106.53,599.25
9110,50150279,2023-02-09,62.92,662.1700000000001
9111,50161801,2023-01-31,,180.69
9112,50161801,2023-02-02,174.75,355.44
9113,50161801,2023-02-02,100.46,455.9
9114,50161801,2023-02-03,172.24,628.14
9115,50161801,2023-02-03,108.09,736.23
9116,50161801,2023-02-03,89.51,825.74
9117,50161801,2023-02-07,113.43,939.17
9118,50161801,2023-02-08,78.98,1018.15
9119,50161801,2023-02-09,-188.3,829.85
9120,50161801,2023-02-10,144.1,973.95
9121,50161801,2023-02-11,105.27,1079.22
9122,50161801,2023-02-14,1674.0,2753.2200000000003
9123,50217872,2023-01-31,,667.95
9124,50217872,2023-02-02,65.93,733.8800000000001
9125,50217872,2023-02-03,-625.5,108.38000000000011
9126,50217872,2023-02-07,-70.62,37.760000000000105
9127,50217872,2023-02-08,-120.31,-82.5499999999999
9128,50217872,2023-02-10,-63.32,-145.8699999999999
9129,50217872,2023-02-11,139.07,-6.799999999999898
9130,50217872,2023-02-11,-47.32,-54.1199999999999
9131,50217872,2023-02-13,-119.03,-173.1499999999999
9132,50217872,2023-02-14,735.5,562.3500000000001
9133,50219545,2023-01-31,,548.12
9134,50219545,2023-02-01,1057.7,1605.8200000000002
9135,50219545,2023-02-06,-50.67,1555.1499999999999
9136,50219545,2023-02-07,124.42,1679.57
9137,50219545,2023-02-11,-818.2,861.3699999999999
9138,50219545,2023-02-14,1209.0,2070.37
9139,50231864,2023-01-31,,117.34
9140,50231864,2023-02-02,135.95,253.29
9141,50231864,2023-02-02,-128.36,124.92999999999998
9142,50231864,2023-02-04,-134.46,-9.53000000000003
9143,50231864,2023-02-07,150.57,141.03999999999996
9144,50231864,2023-02-07,29.79,170.82999999999996
9145,50231864,2023-02-10,148.04,318.86999999999995
9146,50231864,2023-02-14,178.04,496.90999999999997
9147,50276595,2023-01-31,,686.91
9148,50276595,2023-02-01,-102.6,584.31
9149,50276595,2023-02-03,-88.33,495.97999999999996
9150,50276595,2023-02-03,-98.41,397.57
9151,50276595,2023-02-04,86.9,484.46999999999997
9152,50276595,2023-02-06,1107.9,1592.3700000000001
9153,50276595,2023-02-11,88.16,1680.5300000000002
9154,50276595,2023-02-11,-81.2,1599.3300000000002
9155,50276595,2023-02-11,-146.95,1452.38
9156,50276595,2023-02-12,-55.85,1396.5300000000002
9157,50324230,2023-01-31,,945.15
9158,50324230,2023-02-05,-64.51,880.64
9159,50324230,2023-02-05,-145.13,735.51
9160,50324230,2023-02-07,-1380.5,-644.99
9161,50324230,2023-02-09,-95.64,-740.63
9162,50335174,2023-01-31,,650.98
9163,50335174,2023-02-05,-99.24,551.74
9164,50335174,2023-02-09,176.84,728.58
9165,50335174,2023-02-09,157.79,886.37
9166,50335174,2023-02-11,194.38,1080.75
9167,50335174,2023-02-14,14.98,1095.73
9168,50360111,2023-01-31,,193.83
9169,50360111,2023-02-02,40.94,234.77
9170,50360111,2023-02-05,183.09,417.86
9171,50360111,2023-02-12,26.59,444.45
9172,50402197,2023-01-31,,717.07
9173,50402197,2023-02-01,-65.02,652.0500000000001
9174,50402197,2023-02-01,-469.6,182.45000000000005
9175,50402197,2023-02-02,-962.8,-780.3499999999999
9176,50402197,2023-02-05,75.06,-705.29
9177,50402197,2023-02-05,69.93,-635.3599999999999
9178,50402197,2023-02-11,167.56,-467.7999999999999
9179,50402197,2023-02-11,66.39,-401.4099999999999
9180,50402197,2023-02-12,-109.08,-510.4899999999999
9181,50428641,2023-01-31,,271.51
9182,50428641,2023-02-05,-102.38,169.13
9183,50428641,2023-02-07,62.85,231.98
9184,50428641,2023-02-07,-119.18,112.79999999999998
9185,50428641,2023-02-09,-126.46,-13.66000000000001
9186,50428641,2023-02-10,186.7,173.03999999999996
9187,50428641,2023-02-13,101.21,274.24999999999994
9188,50463777,2023-01-31,,143.45
9189,50463777,2023-02-04,-83.95,59.499999999999986
9190,50463777,2023-02-08,64.87,124.36999999999999
9191,50463777,2023-02-09,-90.79,33.579999999999984
9192,50463777,2023-02-13,-80.9,-47.32000000000002
9193,50463777,2023-02-14,-73.71,-121.03000000000002
9194,50463777,2023-02-14,-150.33,-271.36
9195,50463777,2023-02-14,-154.58,-425.94000000000005
9196,50520009,2023-01-31,,892.55
9197,50520009,2023-02-04,-68.1,824.4499999999999
9198,50520009,2023-02-06,-136.61,687.8399999999999
9199,50520009,2023-02-08,1808.4,2496.24
9200,50520009,2023-02-12,-68.89,2427.35
9201,50520009,2023-02-13,145.1,2572.45
9202,50520009,2023-02-14,137.73,2710.18
9203,50547726,2023-01-31,,675.06
9204,50547726,2023-02-04,143.88,818.9399999999999
9205,50547726,2023-02-04,46.13,865.0699999999999
9206,50547726,2023-02-07,-1070.1,-205.02999999999997
9207,50547726,2023-02-08,-121.72,-326.75
9208,50547726,2023-02-10,-106.19,-432.93999999999994
9209,50547726,2023-02-11,-132.76,-565.6999999999999
9210,50610780,2023-01-31,,536.41
9211,50610780,2023-02-02,133.59,670.0
9212,50610780,2023-02-02,-166.35,503.65
9213,50610780,2023-02-05,-2112.8,-1609.15
9214,50610780,2023-02-06,-436.1,-2045.25
9215,50610780,2023-02-07,737.4,-1307.8500000000001
9216,50610780,2023-02-08,-251.9,-1559.7500000000002
9217,50610780,2023-02-10,-127.71,-1687.46
9218,50610780,2023-02-12,81.53,-1605.93
9219,50610780,2023-02-13,89.42,-1516.5100000000002
9220,50624960,2023-01-31,,5.03
9221,50624960,2023-02-04,-26.76,-21.73
9222,50624960,2023-02-11,159.09,137.36
9223,50624960,2023-02-11,-119.87,17.49000000000001
9224,50624960,2023-02-12,-113.72,-96.22999999999999
9225,50624960,2023-02-13,167.76,71.53
9226,50624960,2023-02-13,-126.46,-54.92999999999999
9227,50627436,2023-01-31,,183.41
9228,50627436,2023-02-02,30.52,213.93
9229,50627436,2023-02-04,48.4,262.33
9230,50627436,2023-02-05,-103.36,158.97
9231,50627436,2023-02-07,146.5,305.47
9232,50627436,2023-02-07,62.35,367.82
9233,50627436,2023-02-08,473.2,841.02
9234,50627436,2023-02-08,-162.59,678.43
9235,50627436,2023-02-09,-113.82,564.61
9236,50627436,2023-02-10,-90.73,473.88
9237,50627436,2023-02-14,105.03,578.91
9238,50647892,2023-01-31,,540.71
9239,50647892,2023-02-03,121.58,662.2900000000001
9240,50647892,2023-02-04,-180.29,482.00000000000006
9241,50647892,2023-02-05,212.21,694.21
9242,50647892,2023-02-05,95.98,790.19
9243,50647892,2023-02-05,23.88,814.07
9244,50647892,2023-02-06,120.78,934.85
9245,50647892,2023-02-10,94.84,1029.69
9246,50693024,2023-01-31,,171.87
9247,50693024,2023-02-02,147.71,319.58000000000004
9248,50693024,2023-02-05,-100.33,219.25
9249,50693024,2023-02-09,115.1,334.35
9250,50693024,2023-02-09,-54.92,279.43
9251,50693024,2023-02-10,-98.76,180.67000000000002
9252,50693024,2023-02-13,35.47,216.14
9253,50693024,2023-02-14,139.82,355.96
9254,50756739,2023-01-31,,177.65
9255,50756739,2023-02-02,79.3,256.95
9256,50756739,2023-02-06,-159.04,97.91000000000003
9257,50756739,2023-02-07,94.27,192.18
9258,50756739,2023-02-07,78.73,270.91
9259,50756739,2023-02-09,167.25,438.16
9260,50756739,2023-02-12,20.21,458.37
9261,50756739,2023-02-13,106.08,564.45
9262,50756739,2023-02-13,25.66,590.11
9263,50772829,2023-01-31,,47.57
9264,50772829,2023-02-10,115.74,163.31
9265,50772829,2023-02-11,-63.01,100.29999999999998
9266,50772829,2023-02-12,200.04,300.34
9267,50772829,2023-02-12,76.84,377.17999999999995
9268,50772829,2023-02-12,-1278.9,-901.7200000000001
9269,50772829,2023-02-13,79.92,-821.8000000000002
9270,50772829,2023-02-13,66.5,-755.3000000000002
9271,50772829,2023-02-14,836.0,80.69999999999982
9272,50813708,2023-01-31,,339.04
9273,50813708,2023-02-01,172.78,511.82000000000005
9274,50813708,2023-02-03,-140.36,371.46000000000004
9275,50813708,2023-02-04,-97.67,273.79
9276,50813708,2023-02-05,45.47,319.26
9277,50813708,2023-02-05,-108.33,210.93
9278,50813708,2023-02-06,-28.34,182.59
9279,50813708,2023-02-08,167.66,350.25
9280,50813708,2023-02-10,9.75,360.0
9281,50813708,2023-02-13,-84.2,275.8
9282,50837270,2023-01-31,,613.53
9283,50837270,2023-02-02,147.44,760.97
9284,50837270,2023-02-04,-105.81,655.16
9285,50837270,2023-02-12,114.06,769.22
9286,50837270,2023-02-13,-437.5,331.71999999999997
9287,50837270,2023-02-14,66.68,398.4
9288,50880352,2023-01-31,,12.46
9289,50880352,2023-02-05,-133.1,-120.63999999999999
9290,50880352,2023-02-06,-59.59,-180.23
9291,50880352,2023-02-08,19.59,-160.64
9292,50880352,2023-02-09,205.74,45.10000000000002
9293,50887252,2023-01-31,,464.78
9294,50887252,2023-02-03,56.35,521.13
9295,50887252,2023-02-04,-119.53,401.59999999999997
9296,50887252,2023-02-05,772.5,1174.1
9297,50887252,2023-02-06,210.36,1384.46
9298,50887252,2023-02-09,175.48,1559.9399999999998
9299,50887252,2023-02-09,137.17,1697.11
9300,50887252,2023-02-10,104.93,1802.04
9301,50887252,2023-02-14,-129.59,1672.4499999999998
9302,50893310,2023-01-31,,185.13
9303,50893310,2023-02-06,90.19,275.32
9304,50893310,2023-02-08,104.32,379.64
9305,50893310,2023-02-12,130.06,509.7
9306,50893310,2023-02-13,-69.71,439.99
9307,50959802,2023-01-31,,821.37
9308,50959802,2023-02-01,-97.11,724.26
9309,50959802,2023-02-02,1436.3,2160.56
9310,50959802,2023-02-10,-221.22,1939.34
9311,50959802,2023-02-14,1157.1,3096.4399999999996
9312,51079213,2023-01-31,,783.58
9313,51079213,2023-02-01,-70.27,713.3100000000001
9314,51079213,2023-02-03,80.5,793.8100000000001
9315,51079213,2023-02-05,-144.1,649.71
9316,51079213,2023-02-05,-184.06,465.65000000000003
9317,51079213,2023-02-07,-61.01,404.64000000000004
9318,51079213,2023-02-08,187.24,591.8800000000001
9319,51079213,2023-02-11,-26.87,565.0100000000001
9320,51079213,2023-02-14,-70.52,494.49000000000007
9321,51102699,2023-01-31,,626.91
9322,51102699,2023-02-02,-56.94,569.97
9323,51102699,2023-02-08,-168.14,401.83
9324,51102699,2023-02-10,94.45,496.28
9325,51102699,2023-02-12,-66.33,429.95
9326,51102699,2023-02-13,38.04,467.99
9327,51122335,2023-01-31,,219.24
9328,51122335,2023-02-02,-150.2,69.04000000000002
9329,51122335,2023-02-08,42.88,111.92000000000002
9330,51122335,2023-02-10,-88.04,23.880000000000024
9331,51198722,2023-01-31,,559.63
9332,51198722,2023-02-06,-995.2,-435.57000000000005
9333,51198722,2023-02-06,-1045.4,-1480.9700000000003
9334,51198722,2023-02-07,1035.2,-445.7700000000002
9335,51198722,2023-02-07,-19.21,-464.9800000000002
9336,51266306,2023-01-31,,163.99
9337,51266306,2023-02-01,1187.7,1351.69
9338,51266306,2023-02-01,-92.86,1258.8300000000002
9339,51266306,2023-02-04,118.6,1377.43
9340,51266306,2023-02-05,-118.23,1259.2
9341,51272805,2023-01-31,,135.47
9342,51272805,2023-02-01,153.9,289.37
9343,51272805,2023-02-01,-103.94,185.43
9344,51272805,2023-02-03,-718.2,-532.77
9345,51272805,2023-02-05,43.28,-489.49
9346,51272805,2023-02-12,-82.2,-571.6899999999999
9347,51272805,2023-02-13,105.95,-465.74
9348,51298007,2023-01-31,,427.17
9349,51298007,2023-02-04,73.7,500.87
9350,51298007,2023-02-05,-848.7,-347.83000000000004
9351,51298007,2023-02-07,-1613.2,-1961.0300000000002
9352,51298007,2023-02-09,137.44,-1823.59
9353,51298007,2023-02-09,96.82,-1726.77
9354,51298007,2023-02-12,89.55,-1637.22
9355,51298007,2023-02-12,-104.78,-1742.0
9356,51313899,2023-01-31,,189.04
9357,51313899,2023-02-01,-1072.7,-883.6600000000001
9358,51313899,2023-02-02,-52.11,-935.7700000000001
9359,51313899,2023-02-03,1488.0,552.2299999999999
9360,51313899,2023-02-04,128.26,680.4899999999999
9361,51313899,2023-02-05,-119.88,560.6099999999999
9362,51313899,2023-02-06,-91.53,469.0799999999999
9363,51313899,2023-02-07,283.4,752.4799999999999
9364,51313899,2023-02-09,1653.1,2405.58
9365,51325070,2023-01-31,,933.4
9366,51325070,2023-02-01,104.85,1038.25
9367,51325070,2023-02-01,-83.77,954.48
9368,51325070,2023-02-02,-154.85,799.63
9369,51325070,2023-02-03,61.29,860.92
9370,51325070,2023-02-03,4.02,864.9399999999999
9371,51325070,2023-02-04,183.25,1048.19
9372,51325070,2023-02-05,40.03,1088.22
9373,51325070,2023-02-06,53.53,1141.75
9374,51325070,2023-02-06,28.71,1170.46
9375,51325070,2023-02-06,-8.04,1162.42
9376,51325070,2023-02-07,-99.21,1063.21
9377,51325070,2023-02-08,96.43,1159.64
9378,51325070,2023-02-08,31.2,1190.84
9379,51325070,2023-02-11,106.02,1296.8600000000001
9380,51325070,2023-02-12,-99.56,1197.3
9381,51353910,2023-01-31,,523.88
9382,51353910,2023-02-07,-146.17,377.71000000000004
9383,51353910,2023-02-09,40.77,418.48
9384,51358248,2023-01-31,,222.93
9385,51358248,2023-02-02,-179.19,43.74000000000001
9386,51358248,2023-02-10,127.71,171.45
9387,51358248,2023-02-14,130.09,301.54
9388,51358248,2023-02-14,42.94,344.48
9389,51389636,2023-01-31,,917.98
9390,51389636,2023-02-02,-109.29,808.69
9391,51389636,2023-02-02,-177.36,631.3299999999999
9392,51389636,2023-02-09,-79.33,552.0
9393,51398784,2023-01-31,,909.2
9394,51398784,2023-02-07,313.5,1222.7
9395,51398784,2023-02-13,11.11,1233.81
9396,51401655,2023-01-31,,877.47
9397,51401655,2023-02-02,-121.58,755.89
9398,51401655,2023-02-04,97.26,853.1500000000001
9399,51401655,2023-02-04,62.69,915.84
9400,51401655,2023-02-05,200.77,1116.6100000000001
9401,51435617,2023-01-31,,140.46
9402,51435617,2023-02-03,110.67,251.13
9403,51435617,2023-02-05,-87.66,163.47000000000003
9404,51435617,2023-02-06,133.2,296.67
9405,51435617,2023-02-12,-55.39,241.28000000000003
9406,51435617,2023-02-12,-76.51,164.77
9407,51435617,2023-02-13,18.93,183.70000000000002
9408,51450938,2023-01-31,,157.37
9409,51450938,2023-02-06,98.21,255.57999999999998
9410,51450938,2023-02-07,150.92,406.5
9411,51450938,2023-02-10,-67.01,339.49
9412,51471469,2023-01-31,,611.19
9413,51471469,2023-02-05,-103.21,507.9800000000001
9414,51471469,2023-02-10,-1725.1,-1217.12
9415,51471469,2023-02-12,-50.94,-1268.06
9416,51493379,2023-01-31,,436.15
9417,51493379,2023-02-01,69.52,505.66999999999996
9418,51493379,2023-02-08,-49.64,456.03
9419,51504474,2023-01-31,,153.25
9420,51504474,2023-02-01,219.71,372.96000000000004
9421,51504474,2023-02-04,68.14,441.1
9422,51504474,2023-02-04,18.25,459.35
9423,51504474,2023-02-07,-123.24,336.11
9424,51504474,2023-02-08,-1254.7,-918.59
9425,51504474,2023-02-09,134.52,-784.07
9426,51504474,2023-02-12,-126.99,-911.0600000000001
9427,51504474,2023-02-13,-69.63,-980.69
9428,51653690,2023-01-31,,280.41
9429,51653690,2023-02-01,-78.4,202.01000000000002
9430,51653690,2023-02-02,127.6,329.61
9431,51653690,2023-02-06,-179.58,150.03
9432,51653690,2023-02-08,837.3,987.3299999999999
9433,51653868,2023-01-31,,410.88
9434,51653868,2023-02-02,-179.94,230.94
9435,51653868,2023-02-03,104.0,334.94
9436,51653868,2023-02-04,77.66,412.6
9437,51653868,2023-02-06,-138.83,273.77
9438,51653868,2023-02-07,89.6,363.37
9439,51653868,2023-02-07,-43.63,319.73999999999995
9440,51653868,2023-02-09,53.97,373.71
9441,51653868,2023-02-10,1046.8,1420.51
9442,51653868,2023-02-10,-91.66,1328.85
9443,51653868,2023-02-10,-624.8,704.0500000000001
9444,51653868,2023-02-12,-48.09,655.96
9445,51653868,2023-02-13,30.31,686.2700000000001
9446,51653868,2023-02-14,159.73,846.0
9447,51653868,2023-02-14,-132.75,713.25
9448,51718829,2023-01-31,,260.45
9449,51718829,2023-02-04,-905.4,-644.95
9450,51718829,2023-02-05,181.23,-463.7199999999999
9451,51718829,2023-02-05,-860.7,-1324.42
9452,51718829,2023-02-06,-58.84,-1383.26
9453,51718829,2023-02-08,189.92,-1193.34
9454,51718829,2023-02-09,-1043.8,-2237.14
9455,51718829,2023-02-13,813.5,-1423.6399999999999
9456,51718829,2023-02-14,-99.88,-1523.52
9457,51771015,2023-01-31,,876.29
9458,51771015,2023-02-04,87.1,963.39
9459,51771015,2023-02-05,-159.59,803.8
9460,51771015,2023-02-07,100.32,904.1199999999999
9461,51771015,2023-02-11,1035.1,1939.2199999999998
9462,51771015,2023-02-11,147.31,2086.5299999999997
9463,51771015,2023-02-12,115.87,2202.3999999999996
9464,51771015,2023-02-14,-85.81,2116.5899999999997
9465,51774315,2023-01-31,,291.01
9466,51774315,2023-02-06,98.97,389.98
9467,51774315,2023-02-07,38.62,428.59999999999997
9468,51774315,2023-02-10,55.88,484.48
9469,51774315,2023-02-11,-101.84,382.64
9470,51774315,2023-02-12,-78.98,303.65999999999997
9471,51793205,2023-01-31,,715.25
9472,51793205,2023-02-02,1902.2,2617.45
9473,51793205,2023-02-07,-176.26,2441.19
9474,51793205,2023-02-08,-133.59,2307.6
9475,51906599,2023-01-31,,174.48
9476,51906599,2023-02-01,-125.14,49.33999999999999
9477,51906599,2023-02-04,36.24,85.57999999999998
9478,51906599,2023-02-06,-55.84,29.739999999999988
9479,51906599,2023-02-06,-84.58,-54.84000000000001
9480,51906599,2023-02-08,53.25,-1.5900000000000105
9481,51906599,2023-02-10,-86.75,-88.34
9482,51906599,2023-02-13,157.9,69.56
9483,52104303,2023-01-31,,810.97
9484,52104303,2023-02-03,99.85,910.82
9485,52104303,2023-02-04,-77.13,833.69
9486,52104303,2023-02-06,-87.57,746.12
9487,52104303,2023-02-09,-1530.9,-784.7800000000001
9488,52117174,2023-01-31,,932.96
9489,52117174,2023-02-03,-120.56,812.4000000000001
9490,52117174,2023-02-05,-91.78,720.62
9491,52117174,2023-02-08,-43.73,676.89
9492,52117174,2023-02-09,-59.54,617.35
9493,52117174,2023-02-09,-1131.6,-514.2499999999999
9494,52125171,2023-01-31,,973.17
9495,52125171,2023-02-01,112.77,1085.94
9496,52125171,2023-02-02,132.64,1218.58
9497,52125171,2023-02-05,101.6,1320.1799999999998
9498,52125171,2023-02-09,-63.75,1256.4299999999998
9499,52127978,2023-01-31,,84.8
9500,52127978,2023-02-08,-603.0,-518.2
9501,52127978,2023-02-09,-25.95,-544.1500000000001
9502,52127978,2023-02-12,13.57,-530.58
9503,52127978,2023-02-12,-134.36,-664.94
9504,52141048,2023-01-31,,102.68
9505,52141048,2023-02-03,153.58,256.26
9506,52141048,2023-02-04,31.94,288.20000000000005
9507,52141048,2023-02-07,852.6,1140.8000000000002
9508,52141048,2023-02-08,122.19,1262.99
9509,52141048,2023-02-11,144.17,1407.16
9510,52146995,2023-01-31,,322.52
9511,52146995,2023-02-01,69.4,391.91999999999996
9512,52146995,2023-02-02,507.1,899.02
9513,52146995,2023-02-02,-71.52,827.5
9514,52146995,2023-02-05,-49.2,778.3
9515,52146995,2023-02-05,-108.08,670.22
9516,52146995,2023-02-07,135.72,805.94
9517,52146995,2023-02-09,36.71,842.65
9518,52146995,2023-02-11,-93.53,749.12
9519,52146995,2023-02-12,-934.0,-184.88
9520,52146995,2023-02-14,108.65,-76.22999999999999
9521,52203356,2023-01-31,,899.39
9522,52203356,2023-02-03,83.25,982.64
9523,52203356,2023-02-05,189.35,1171.99
9524,52203356,2023-02-05,-168.74,1003.25
9525,52203356,2023-02-08,1316.4,2319.65
9526,52203356,2023-02-11,51.73,2371.38
9527,52213806,2023-01-31,,597.62
9528,52213806,2023-02-12,54.1,651.72
9529,52213806,2023-02-14,97.06,748.78
9530,52213806,2023-02-14,10.22,759.0
9531,52230539,2023-01-31,,394.34
9532,52230539,2023-02-03,-23.24,371.09999999999997
9533,52230539,2023-02-12,197.45,568.55
9534,52230539,2023-02-13,-149.9,418.65
9535,52230539,2023-02-14,-87.3,331.34999999999997
9536,52264506,2023-01-31,,934.07
9537,52264506,2023-02-02,-12.87,921.2
9538,52264506,2023-02-05,139.1,1060.3
9539,52264506,2023-02-06,-105.25,955.0500000000001
9540,52264506,2023-02-08,132.78,1087.83
9541,52264506,2023-02-09,139.7,1227.53
9542,52264506,2023-02-09,-57.45,1170.08
9543,52264506,2023-02-13,-35.46,1134.6200000000001
9544,52264506,2023-02-14,60.97,1195.59
9545,52310499,2023-01-31,,954.51
9546,52310499,2023-02-02,53.0,1007.51
9547,52310499,2023-02-06,81.6,1089.11
9548,52310499,2023-02-14,73.19,1162.3
9549,52317175,2023-01-31,,25.94
9550,52317175,2023-02-10,-90.04,-64.10000000000001
9551,52317175,2023-02-12,-145.55,-209.65000000000003
9552,52317175,2023-02-12,-1145.7,-1355.3500000000001
9553,52317175,2023-02-14,-92.17,-1447.5200000000002
9554,52365238,2023-01-31,,822.17
9555,52365238,2023-02-09,85.45,907.62
9556,52365238,2023-02-12,92.42,1000.04
9557,52366360,2023-01-31,,465.67
9558,52366360,2023-02-02,-61.66,404.01
9559,52366360,2023-02-03,88.74,492.75
9560,52366360,2023-02-06,172.68,665.4300000000001
9561,52366360,2023-02-06,-72.88,592.55
9562,52366360,2023-02-07,-64.41,528.14
9563,52390463,2023-01-31,,172.82
9564,52390463,2023-02-01,147.58,320.4
9565,52390463,2023-02-02,-534.5,-214.10000000000002
9566,52390463,2023-02-03,-79.16,-293.26
9567,52390463,2023-02-03,-220.83,-514.09
9568,52390463,2023-02-04,-30.36,-544.45
9569,52390463,2023-02-14,-117.12,-661.57
9570,52436120,2023-01-31,,904.47
9571,52436120,2023-02-03,109.66,1014.13
9572,52436120,2023-02-07,115.4,1129.53
9573,52436120,2023-02-11,-560.2,569.3299999999999
9574,52442629,2023-01-31,,617.92
9575,52442629,2023-02-03,196.73,814.65
9576,52442629,2023-02-03,-1462.8,-648.15
9577,52442629,2023-02-11,-145.45,-793.5999999999999
9578,52442629,2023-02-12,90.28,-703.3199999999999
9579,52442629,2023-02-14,1290.4,587.0800000000002
9580,52461586,2023-01-31,,596.3
9581,52461586,2023-02-02,755.8,1352.1
9582,52461586,2023-02-06,-59.42,1292.6799999999998
9583,52461586,2023-02-08,101.89,1394.57
9584,52461586,2023-02-08,-1026.8,367.77
9585,52468167,2023-01-31,,369.42
9586,52468167,2023-02-01,-102.76,266.66
9587,52468167,2023-02-02,162.4,429.06
9588,52468167,2023-02-10,48.91,477.97
9589,52480554,2023-01-31,,263.38
9590,52480554,2023-02-04,-130.57,132.81
9591,52480554,2023-02-06,-629.3,-496.48999999999995
9592,52480554,2023-02-10,-85.31,-581.8
9593,52480554,2023-02-11,122.42,-459.37999999999994
9594,52480554,2023-02-12,68.07,-391.30999999999995
9595,52560688,2023-01-31,,622.16
9596,52560688,2023-02-03,55.81,677.97
9597,52560688,2023-02-04,115.54,793.51
9598,52560688,2023-02-10,-1220.5,-426.99
9599,52560688,2023-02-11,-108.41,-535.4
9600,52560688,2023-02-11,-1058.7,-1594.1
9601,52560688,2023-02-12,127.2,-1466.9
9602,52560688,2023-02-12,-115.87,-1582.7700000000002
9603,52747145,2023-01-31,,546.71
9604,52747145,2023-02-02,-107.8,438.91
9605,52747145,2023-02-04,163.28,602.19
9606,52747145,2023-02-09,-155.0,447.19000000000005
9607,52747145,2023-02-11,-107.54,339.65000000000003
9608,52747145,2023-02-12,-165.18,174.47000000000003
9609,52756904,2023-01-31,,428.77
9610,52756904,2023-02-04,-118.08,310.69
9611,52756904,2023-02-05,114.03,424.71999999999997
9612,52756904,2023-02-13,-51.57,373.15
9613,52756904,2023-02-13,-87.03,286.12
9614,52756904,2023-02-14,-67.55,218.57
9615,52805510,2023-01-31,,580.66
9616,52805510,2023-02-09,35.39,616.05
9617,52805510,2023-02-09,-85.32,530.73
9618,52805510,2023-02-10,-153.19,377.53999999999996
9619,52805510,2023-02-13,851.7,1229.24
9620,52814597,2023-01-31,,899.39
9621,52814597,2023-02-01,-1821.6,-922.2099999999999
9622,52814597,2023-02-06,-25.86,-948.0699999999999
9623,52814597,2023-02-10,-831.4,-1779.4699999999998
9624,52814597,2023-02-11,43.89,-1735.58
9625,52814597,2023-02-11,-1129.9,-2865.48
9626,52814597,2023-02-14,7.09,-2858.39
9627,52835507,2023-01-31,,306.68
9628,52835507,2023-02-01,-86.91,219.77
9629,52835507,2023-02-03,-32.77,187.0
9630,52835507,2023-02-05,109.41,296.40999999999997
9631,52835507,2023-02-05,-806.2,-509.7900000000001
9632,52835507,2023-02-08,95.66,-414.1300000000001
9633,52835507,2023-02-10,1098.2,684.0699999999999
9634,52835507,2023-02-13,-262.4,421.66999999999996
9635,52835507,2023-02-14,1053.5,1475.17
9636,52840001,2023-01-31,,746.12
9637,52840001,2023-02-01,88.19,834.31
9638,52840001,2023-02-04,-101.52,732.79
9639,52840001,2023-02-07,814.4,1547.19
9640,52855120,2023-01-31,,880.21
9641,52855120,2023-02-01,160.48,1040.69
9642,52855120,2023-02-02,161.91,1202.6
9643,52855120,2023-02-04,-72.24,1130.3600000000001
9644,52855120,2023-02-09,105.82,1236.18
9645,52855120,2023-02-10,-61.16,1175.02
9646,52855120,2023-02-11,-174.19,1000.83
9647,52855120,2023-02-12,-1640.8,-639.9699999999999
9648,52911248,2023-01-31,,430.16
9649,52911248,2023-02-01,-161.89,268.27000000000004
9650,52911248,2023-02-03,-105.36,162.91000000000003
9651,52911248,2023-02-05,-131.72,31.190000000000055
9652,52911248,2023-02-07,-162.23,-131.03999999999994
9653,52911248,2023-02-08,72.19,-58.84999999999994
9654,52911248,2023-02-10,-83.95,-142.79999999999995
9655,52911248,2023-02-10,-134.99,-277.78999999999996
9656,52911248,2023-02-10,-951.2,-1228.99
9657,52911248,2023-02-10,-2084.1,-3313.09
9658,52911248,2023-02-12,-125.47,-3438.5599999999995
9659,52911248,2023-02-12,-129.73,-3568.2899999999995
9660,52911248,2023-02-13,63.98,-3504.3099999999995
9661,52973634,2023-01-31,,417.09
9662,52973634,2023-02-02,104.98,522.0699999999999
9663,52973634,2023-02-02,80.01,602.0799999999999
9664,52973634,2023-02-03,372.2,974.28
9665,52973634,2023-02-11,6.54,980.8199999999999
9666,52973634,2023-02-11,-129.35,851.47
9667,52973634,2023-02-12,172.13,1023.5999999999999
9668,52973634,2023-02-13,134.58,1158.18
9669,52996436,2023-01-31,,883.35
9670,52996436,2023-02-01,86.03,969.38
9671,52996436,2023-02-03,-173.67,795.71
9672,52996436,2023-02-08,-95.66,700.0500000000001
9673,52996436,2023-02-14,-1290.4,-590.35
9674,53006272,2023-01-31,,761.95
9675,53006272,2023-02-03,134.35,896.3000000000001
9676,53006272,2023-02-06,-90.64,805.6600000000001
9677,53006272,2023-02-08,160.1,965.76
9678,53006272,2023-02-08,-88.99,876.7700000000001
9679,53006272,2023-02-14,157.14,1033.91
9680,53010345,2023-01-31,,131.63
9681,53010345,2023-02-06,-123.61,8.019999999999996
9682,53010345,2023-02-10,169.0,177.01999999999998
9683,53010345,2023-02-10,-145.54,31.47999999999999
9684,53010345,2023-02-14,88.77,120.24999999999999
9685,53046005,2023-01-31,,669.82
9686,53046005,2023-02-01,36.43,706.25
9687,53046005,2023-02-02,52.25,758.5
9688,53046005,2023-02-04,-58.03,700.47
9689,53046005,2023-02-06,-129.51,570.96
9690,53046005,2023-02-13,157.27,728.23
9691,53046005,2023-02-13,74.51,802.7400000000001
9692,53046005,2023-02-13,-125.85,676.8900000000001
9693,53059420,2023-01-31,,531.72
9694,53059420,2023-02-01,-97.79,433.93
9695,53059420,2023-02-02,-129.83,304.1
9696,53059420,2023-02-07,198.21,502.31000000000006
9697,53059420,2023-02-07,140.37,642.6800000000001
9698,53079883,2023-01-31,,489.35
9699,53079883,2023-02-05,-115.08,374.27000000000004
9700,53079883,2023-02-05,-150.73,223.54000000000002
9701,53079883,2023-02-09,-257.1,-33.56
9702,53079883,2023-02-10,-550.8,-584.3599999999999
9703,53079883,2023-02-14,10.57,-573.7899999999998
9704,53085668,2023-01-31,,199.11
9705,53085668,2023-02-05,106.54,305.65000000000003
9706,53085668,2023-02-05,-75.06,230.59000000000003
9707,53085668,2023-02-07,-945.2,-714.61
9708,53085668,2023-02-10,-101.56,-816.1700000000001
9709,53085668,2023-02-11,-117.16,-933.33
9710,53085668,2023-02-14,41.25,-892.08
9711,53085668,2023-02-14,-24.04,-916.12
9712,53086727,2023-01-31,,408.74
9713,53086727,2023-02-02,115.29,524.03
9714,53086727,2023-02-10,-1362.1,-838.0699999999999
9715,53089607,2023-01-31,,567.87
9716,53089607,2023-02-01,161.89,729.76
9717,53089607,2023-02-02,147.42,877.18
9718,53089607,2023-02-05,-176.88,700.3
9719,53089607,2023-02-11,161.33,861.63
9720,53089607,2023-02-12,-137.14,724.49
9721,53089607,2023-02-13,71.18,795.6700000000001
9722,53091928,2023-01-31,,235.6
9723,53091928,2023-02-02,-248.7,-13.099999999999994
9724,53091928,2023-02-06,-128.13,-141.23
9725,53091928,2023-02-07,1741.9,1600.67
9726,53091928,2023-02-07,-166.24,1434.43
9727,53091928,2023-02-09,-114.01,1320.42
9728,53091928,2023-02-11,28.8,1349.22
9729,53091928,2023-02-12,37.22,1386.44
9730,53107499,2023-01-31,,237.09
9731,53107499,2023-02-01,83.86,320.95
9732,53107499,2023-02-09,-58.86,262.09000000000003
9733,53107499,2023-02-13,168.68,430.77
9734,53107499,2023-02-13,-70.54,360.23
9735,53107499,2023-02-14,-40.13,320.1
9736,53161068,2023-01-31,,945.53
9737,53161068,2023-02-02,962.8,1908.33
9738,53161068,2023-02-02,177.36,2085.69
9739,53161068,2023-02-03,62.59,2148.2799999999997
9740,53161068,2023-02-03,-1566.6,581.6800000000001
9741,53161068,2023-02-04,-69.83,511.8500000000001
9742,53161068,2023-02-05,91.56,603.4100000000001
9743,53161068,2023-02-05,-81.18,522.23
9744,53161068,2023-02-05,-480.6,41.63000000000005
9745,53161068,2023-02-07,108.31,149.94000000000005
9746,53161068,2023-02-10,107.66,257.6
9747,53161068,2023-02-10,50.5,308.1
9748,53170488,2023-01-31,,219.2
9749,53170488,2023-02-04,-73.5,145.7
9750,53170488,2023-02-08,50.31,196.01
9751,53192110,2023-01-31,,588.04
9752,53192110,2023-02-06,117.46,705.5
9753,53192110,2023-02-07,-53.78,651.7199999999999
9754,53192110,2023-02-14,-88.36,563.3599999999999
9755,53204515,2023-01-31,,689.65
9756,53204515,2023-02-02,83.33,772.98
9757,53204515,2023-02-04,-136.51,636.47
9758,53204515,2023-02-06,114.15,750.62
9759,53211412,2023-01-31,,69.51
9760,53211412,2023-02-05,93.57,163.07999999999998
9761,53211412,2023-02-07,-101.5,61.58
9762,53211412,2023-02-09,-20.18,41.4
9763,53211412,2023-02-11,41.89,83.28999999999999
9764,53211412,2023-02-11,-197.9,-114.61000000000001
9765,53211412,2023-02-12,121.68,7.069999999999993
9766,53211412,2023-02-13,902.0,909.0699999999999
9767,53211412,2023-02-13,-50.68,858.39
9768,53234515,2023-01-31,,854.67
9769,53234515,2023-02-01,-70.5,784.17
9770,53234515,2023-02-02,54.57,838.74
9771,53234515,2023-02-04,1349.2,2187.94
9772,53234515,2023-02-05,148.33,2336.27
9773,53234515,2023-02-06,8.35,2344.62
9774,53240505,2023-01-31,,188.87
9775,53240505,2023-02-03,119.64,308.51
9776,53240505,2023-02-14,-37.21,271.3
9777,53240505,2023-02-14,-88.35,182.95000000000002
9778,53260868,2023-01-31,,966.85
9779,53260868,2023-02-01,208.23,1175.08
9780,53260868,2023-02-02,134.24,1309.32
9781,53260868,2023-02-07,-1429.1,-119.77999999999997
9782,53260868,2023-02-10,97.78,-21.99999999999997
9783,53260868,2023-02-12,-25.98,-47.979999999999976
9784,53332086,2023-01-31,,273.51
9785,53332086,2023-02-03,-98.44,175.07
9786,53332086,2023-02-06,116.99,292.06
9787,53332086,2023-02-06,114.95,407.01
9788,53332086,2023-02-09,-85.45,321.56
9789,53332086,2023-02-12,-79.05,242.51
9790,53332086,2023-02-14,-59.91,182.6
9791,53366488,2023-01-31,,337.18
9792,53366488,2023-02-01,115.41,452.59000000000003
9793,53366488,2023-02-02,-104.72,347.87
9794,53366488,2023-02-03,110.54,458.41
9795,53366488,2023-02-04,-134.24,324.17
9796,53366488,2023-02-07,107.54,431.71000000000004
9797,53366488,2023-02-10,-102.92,328.79
9798,53366488,2023-02-13,76.11,404.90000000000003
9799,53376344,2023-01-31,,228.65
9800,53376344,2023-02-02,81.01,309.66
9801,53376344,2023-02-03,-133.94,175.72000000000003
9802,53376344,2023-02-04,35.52,211.24000000000004
9803,53376344,2023-02-05,85.78,297.02000000000004
9804,53376344,2023-02-14,1365.0,1662.02
9805,53380359,2023-01-31,,0.81
9806,53380359,2023-02-01,-133.29,-132.48
9807,53380359,2023-02-04,78.39,-54.08999999999999
9808,53380359,2023-02-08,134.23,80.14
9809,53380359,2023-02-08,-49.6,30.54
9810,53380359,2023-02-08,-113.92,-83.38
9811,53380359,2023-02-08,-128.8,-212.18
9812,53380359,2023-02-13,767.3,555.1199999999999
9813,53380359,2023-02-13,384.8,939.9199999999998
9814,53421312,2023-01-31,,937.86
9815,53421312,2023-02-03,-40.39,897.47
9816,53421312,2023-02-04,44.37,941.84
9817,53421312,2023-02-04,-199.43,742.41
9818,53421312,2023-02-07,-13.71,728.7
9819,53421312,2023-02-08,135.45,864.15
9820,53421312,2023-02-11,-69.79,794.36
9821,53421312,2023-02-12,126.99,921.3499999999999
9822,53496996,2023-01-31,,303.15
9823,53496996,2023-02-01,146.28,449.42999999999995
9824,53496996,2023-02-02,74.71,524.14
9825,53496996,2023-02-05,-106.43,417.71
9826,53496996,2023-02-07,95.78,513.49
9827,53496996,2023-02-11,149.19,662.68
9828,53496996,2023-02-12,107.03,769.7099999999999
9829,53502347,2023-01-31,,18.89
9830,53502347,2023-02-01,84.14,103.03
9831,53502347,2023-02-01,-490.9,-387.87
9832,53502347,2023-02-08,-123.06,-510.93
9833,53502347,2023-02-10,133.46,-377.47
9834,53502347,2023-02-14,-208.0,-585.47
9835,53502347,2023-02-14,-1469.3,-2054.77
9836,53513558,2023-01-31,,235.44
9837,53513558,2023-02-02,-100.89,134.55
9838,53513558,2023-02-04,-155.63,-21.079999999999984
9839,53513558,2023-02-05,-700.4,-721.48
9840,53513558,2023-02-08,161.43,-560.05
9841,53513558,2023-02-09,59.28,-500.76999999999987
9842,53518299,2023-01-31,,953.96
9843,53518299,2023-02-01,-116.27,837.69
9844,53518299,2023-02-08,46.43,884.12
9845,53518299,2023-02-10,-134.33,749.79
9846,53538823,2023-01-31,,750.37
9847,53538823,2023-02-05,-78.82,671.55
9848,53538823,2023-02-06,23.13,694.6800000000001
9849,53538823,2023-02-06,-405.7,288.98
9850,53538823,2023-02-08,-57.77,231.21
9851,53634705,2023-01-31,,853.12
9852,53634705,2023-02-05,151.27,1004.39
9853,53634705,2023-02-05,63.21,1067.6
9854,53634705,2023-02-14,-223.99,843.61
9855,53665038,2023-01-31,,624.95
9856,53665038,2023-02-02,27.52,652.47
9857,53665038,2023-02-07,-27.75,624.72
9858,53665038,2023-02-09,-255.62,369.1
9859,53665038,2023-02-13,113.04,482.14000000000004
9860,53727603,2023-01-31,,517.25
9861,53727603,2023-02-02,124.68,641.9300000000001
9862,53727603,2023-02-04,92.05,733.98
9863,53727603,2023-02-08,63.18,797.16
9864,53727603,2023-02-10,-2476.1,-1678.94
9865,53727603,2023-02-11,-1137.9,-2816.84
9866,53727603,2023-02-13,66.54,-2750.3
9867,53727603,2023-02-13,-75.37,-2825.67
9868,53753986,2023-01-31,,252.69
9869,53753986,2023-02-03,-120.33,132.36
9870,53753986,2023-02-04,-1059.1,-926.7399999999999
9871,53753986,2023-02-06,-165.67,-1092.4099999999999
9872,53753986,2023-02-11,80.75,-1011.6599999999999
9873,53753986,2023-02-12,860.8,-150.8599999999999
9874,53754887,2023-01-31,,162.05
9875,53754887,2023-02-02,102.25,264.3
9876,53754887,2023-02-06,149.07,413.37
9877,53754887,2023-02-09,54.92,468.29
9878,53762957,2023-01-31,,245.78
9879,53762957,2023-02-01,-101.12,144.66
9880,53762957,2023-02-09,-179.65,-34.99000000000001
9881,53762957,2023-02-10,149.19,114.19999999999999
9882,53762957,2023-02-10,-100.16,14.039999999999992
9883,53762957,2023-02-11,134.16,148.2
9884,53762957,2023-02-11,-108.92,39.27999999999999
9885,53762957,2023-02-11,-142.72,-103.44000000000001
9886,53762957,2023-02-12,-150.86,-254.3
9887,53762957,2023-02-14,51.9,-202.4
9888,53762957,2023-02-14,-155.82,-358.22
9889,53764356,2023-01-31,,447.88
9890,53764356,2023-02-01,83.37,531.25
9891,53764356,2023-02-02,197.62,728.87
9892,53764356,2023-02-02,-74.82,654.05
9893,53764356,2023-02-04,136.2,790.25
9894,53764356,2023-02-04,-75.94,714.31
9895,53764356,2023-02-07,-84.19,630.12
9896,53764356,2023-02-08,-144.78,485.34000000000003
9897,53764356,2023-02-10,65.52,550.86
9898,53764356,2023-02-11,-159.34,391.52
9899,53764356,2023-02-12,-179.93,211.58999999999997
9900,53831793,2023-01-31,,799.66
9901,53831793,2023-02-06,-143.57,656.0899999999999
9902,53831793,2023-02-08,-110.44,545.65
9903,53831793,2023-02-08,-159.35,386.29999999999995
9904,53831793,2023-02-09,103.19,489.49
9905,53831793,2023-02-10,135.89,625.38
9906,53831793,2023-02-13,1226.1,1851.48
9907,53831793,2023-02-13,127.43,1978.91
9908,53845552,2023-01-31,,285.52
9909,53845552,2023-02-06,967.8,1253.32
9910,53845552,2023-02-09,-82.54,1170.78
9911,53845615,2023-01-31,,597.04
9912,53845615,2023-02-05,-47.51,549.53
9913,53845615,2023-02-06,71.0,620.53
9914,53845615,2023-02-06,-63.7,556.8299999999999
9915,53845615,2023-02-07,-100.78,456.04999999999995
9916,53845615,2023-02-07,-151.21,304.84
9917,53845615,2023-02-10,7.29,312.13
9918,53845615,2023-02-10,-1052.9,-740.7700000000001
9919,53858816,2023-01-31,,539.38
9920,53858816,2023-02-01,-92.2,447.18
9921,53858816,2023-02-03,-98.53,348.65
9922,53858816,2023-02-05,33.32,381.96999999999997
9923,53858816,2023-02-05,-105.91,276.06
9924,53858816,2023-02-09,-156.03,120.03
9925,53858816,2023-02-11,1231.3,1351.33
9926,53858816,2023-02-12,-113.78,1237.55
9927,53884266,2023-01-31,,21.72
9928,53884266,2023-02-12,185.51,207.23
9929,53884266,2023-02-13,-85.84,121.38999999999999
9930,53884266,2023-02-13,-107.98,13.409999999999982
9931,53884626,2023-01-31,,478.38
9932,53884626,2023-02-02,-1413.6,-935.2199999999999
9933,53884626,2023-02-03,115.71,-819.5099999999999
9934,53884626,2023-02-07,-88.86,-908.3699999999999
9935,53884626,2023-02-09,134.0,-774.3699999999999
9936,53884626,2023-02-13,1525.2,750.8300000000002
9937,53884626,2023-02-13,74.01,824.8400000000001
9938,53887772,2023-01-31,,541.43
9939,53887772,2023-02-02,65.2,606.63
9940,53887772,2023-02-02,-109.3,497.3299999999999
9941,53887772,2023-02-04,-136.2,361.13
9942,53887772,2023-02-06,-55.36,305.77
9943,53887772,2023-02-06,-114.95,190.81999999999996
9944,53887772,2023-02-11,-42.19,148.62999999999997
9945,53887772,2023-02-11,-142.53,6.099999999999966
9946,53887772,2023-02-14,102.09,108.18999999999997
9947,53959112,2023-01-31,,103.99
9948,53959112,2023-02-06,159.06,263.05
9949,53959112,2023-02-06,60.77,323.82
9950,53959112,2023-02-07,135.7,459.52
9951,53959112,2023-02-07,-71.14,388.38
9952,53959112,2023-02-08,52.99,441.37
9953,53959112,2023-02-09,102.59,543.96
9954,53959112,2023-02-10,-74.94,469.02
9955,53960481,2023-01-31,,490.82
9956,53960481,2023-02-04,103.05,593.87
9957,53960481,2023-02-06,102.12,695.99
9958,53960481,2023-02-08,74.39,770.38
9959,53971767,2023-01-31,,958.87
9960,53971767,2023-02-01,-124.24,834.63
9961,53971767,2023-02-02,-61.97,772.66
9962,53977562,2023-01-31,,398.76
9963,53977562,2023-02-02,-15.93,382.83
9964,53977562,2023-02-06,-140.83,241.99999999999997
9965,53977562,2023-02-06,-173.03,68.96999999999997
9966,53977562,2023-02-07,113.03,181.99999999999997
9967,53977562,2023-02-08,-149.31,32.68999999999997
9968,53977562,2023-02-14,145.08,177.76999999999998
9969,53977562,2023-02-14,-25.28,152.48999999999998
9970,54032229,2023-01-31,,176.12
9971,54032229,2023-02-03,-87.5,88.62
9972,54032229,2023-02-05,148.46,237.08
9973,54032229,2023-02-08,74.13,311.21000000000004
9974,54032229,2023-02-09,-96.2,215.01
9975,54032229,2023-02-13,-1503.4,-1288.39
9976,54033811,2023-01-31,,534.83
9977,54033811,2023-02-01,-188.33,346.5
9978,54033811,2023-02-03,-62.89,283.61
9979,54033811,2023-02-03,-148.95,134.66000000000003
9980,54033811,2023-02-06,114.86,249.52000000000004
9981,54033811,2023-02-06,28.63,278.15000000000003
9982,54033811,2023-02-08,133.59,411.74
9983,54033811,2023-02-09,64.47,476.21000000000004
9984,54067346,2023-01-31,,180.91
9985,54067346,2023-02-02,96.8,277.71
9986,54067346,2023-02-08,91.53,369.24
9987,54067346,2023-02-10,57.19,426.43
9988,54067346,2023-02-11,1635.6,2062.0299999999997
9989,54067346,2023-02-11,-158.58,1903.45
9990,54067346,2023-02-12,-25.82,1877.6299999999999
9991,54071589,2023-01-31,,765.81
9992,54071589,2023-02-03,-117.22,648.5899999999999
9993,54071589,2023-02-09,-107.22,541.3699999999999
9994,54071589,2023-02-11,119.83,661.1999999999999
9995,54071589,2023-02-11,58.94,720.14
9996,54071589,2023-02-11,-726.2,-6.060000000000059
9997,54137851,2023-01-31,,30.67
9998,54137851,2023-02-05,-81.18,-50.510000000000005
9999,54137851,2023-02-13,71.54,21.03
10000,54154999,2023-01-31,,962.14
10001,54154999,2023-02-01,107.18,1069.32
10002,54154999,2023-02-02,-49.14,1020.18
10003,54154999,2023-02-03,-41.91,978.27
10004,54154999,2023-02-05,27.88,1006.15
10005,54154999,2023-02-05,-142.79,863.36
10006,54154999,2023-02-07,102.54,965.9
10007,54154999,2023-02-07,39.54,1005.44
10008,54154999,2023-02-08,35.13,1040.57
10009,54189995,2023-01-31,,401.27
10010,54189995,2023-02-03,-13.61,387.65999999999997
10011,54189995,2023-02-04,97.67,485.33
10012,54189995,2023-02-09,158.61,643.94
10013,54189995,2023-02-14,117.23,761.17
10014,54189995,2023-02-14,-143.03,618.14
10015,54230889,2023-01-31,,597.31
10016,54230889,2023-02-09,-12.69,584.6199999999999
10017,54230889,2023-02-11,75.03,659.65
10018,54278560,2023-01-31,,161.8
10019,54278560,2023-02-01,-167.46,-5.659999999999997
10020,54278560,2023-02-07,92.55,86.89
10021,54278560,2023-02-08,-134.23,-47.33999999999999
10022,54288062,2023-01-31,,336.75
10023,54288062,2023-02-03,104.89,441.64
10024,54288062,2023-02-03,-46.54,395.1
10025,54288062,2023-02-04,153.16,548.26
10026,54288062,2023-02-04,-1266.4,-718.1400000000001
10027,54288062,2023-02-07,152.25,-565.8900000000001
10028,54288062,2023-02-14,120.16,-445.73000000000013
10029,54288062,2023-02-14,-136.73,-582.46
10030,54300071,2023-01-31,,317.35
10031,54300071,2023-02-01,588.3,905.65
10032,54300071,2023-02-03,111.46,1017.11
10033,54300071,2023-02-03,87.44,1104.55
10034,54300071,2023-02-05,58.45,1163.0
10035,54300071,2023-02-05,-82.64,1080.36
10036,54300071,2023-02-06,-93.21,987.15
10037,54300071,2023-02-08,154.2,1141.35
10038,54300071,2023-02-09,1576.6,2717.95
10039,54300071,2023-02-12,-117.45,2600.5
10040,54300071,2023-02-12,-134.97,2465.5299999999997
10041,54300071,2023-02-13,1535.7,4001.2299999999996
10042,54300071,2023-02-13,173.36,4174.59
10043,54301151,2023-01-31,,408.16
10044,54301151,2023-02-07,-480.0,-71.83999999999997
10045,54301151,2023-02-12,1619.3,1547.46
10046,54307382,2023-01-31,,452.52
10047,54307382,2023-02-02,97.69,550.21
10048,54307382,2023-02-03,-160.1,390.11
10049,54307382,2023-02-07,-114.28,275.83
10050,54307382,2023-02-07,-153.27,122.55999999999997
10051,54307382,2023-02-13,-535.9,-413.34000000000003
10052,54349805,2023-01-31,,752.49
10053,54349805,2023-02-02,-96.32,656.1700000000001
10054,54349805,2023-02-04,99.5,755.6700000000001
10055,54349805,2023-02-07,-115.39,640.28
10056,54349805,2023-02-08,687.1,1327.38
10057,54349805,2023-02-09,62.59,1389.97
10058,54349805,2023-02-09,10.05,1400.02
10059,54349805,2023-02-09,-148.56,1251.46
10060,54349805,2023-02-10,-149.81,1101.65
10061,54349805,2023-02-13,59.45,1161.1
10062,54377130,2023-01-31,,425.86
10063,54377130,2023-02-03,-91.66,334.20000000000005
10064,54377130,2023-02-04,-16.51,317.69
10065,54377130,2023-02-05,124.37,442.06
10066,54377130,2023-02-06,123.37,565.4300000000001
10067,54377130,2023-02-08,-1119.6,-554.1699999999998
10068,54377130,2023-02-11,27.58,-526.5899999999998
10069,54377130,2023-02-12,-183.41,-709.9999999999998
10070,54377538,2023-01-31,,845.93
10071,54377538,2023-02-02,75.99,921.92
10072,54377538,2023-02-02,-91.57,830.3499999999999
10073,54377538,2023-02-02,-1145.1,-314.75
10074,54377538,2023-02-07,178.2,-136.55
10075,54377538,2023-02-11,112.1,-24.450000000000017
10076,54405539,2023-01-31,,397.2
10077,54405539,2023-02-03,106.8,504.0
10078,54405539,2023-02-03,87.6,591.6
10079,54405539,2023-02-04,-80.75,510.84999999999997
10080,54405539,2023-02-10,189.51,700.3599999999999
10081,54405539,2023-02-11,-78.29,622.0699999999999
10082,54405539,2023-02-13,-84.66,537.41
10083,54452317,2023-01-31,,358.39
10084,54452317,2023-02-04,-33.69,324.7
10085,54452317,2023-02-05,56.72,381.41999999999996
10086,54452317,2023-02-06,140.78,522.2
10087,54452317,2023-02-07,106.48,628.68
10088,54452317,2023-02-07,-98.66,530.02
10089,54452317,2023-02-09,-859.1,-329.08000000000004
10090,54452317,2023-02-11,139.14,-189.94000000000005
10091,54458410,2023-01-31,,973.1
10092,54458410,2023-02-04,-129.56,843.54
10093,54458410,2023-02-09,138.8,982.34
10094,54458410,2023-02-10,-87.63,894.71
10095,54458410,2023-02-12,68.8,963.51
10096,54458410,2023-02-13,-97.77,865.74
10097,54541943,2023-01-31,,433.92
10098,54541943,2023-02-02,156.5,590.4200000000001
10099,54541943,2023-02-03,-77.36,513.0600000000001
10100,54541943,2023-02-08,1686.0,2199.06
10101,54541943,2023-02-09,-74.96,2124.1
10102,54541943,2023-02-10,202.69,2326.79
10103,54541943,2023-02-11,121.09,2447.88
10104,54541943,2023-02-14,58.63,2506.5099999999998
10105,54565625,2023-01-31,,472.76
10106,54565625,2023-02-01,148.64,621.4
10107,54565625,2023-02-03,-79.68,541.72
10108,54565625,2023-02-06,1947.3,2489.02
10109,54565625,2023-02-07,-62.17,2426.85
10110,54565625,2023-02-08,104.18,2531.03
10111,54565625,2023-02-09,-109.08,2421.95
10112,54565625,2023-02-10,-152.17,2269.78
10113,54565625,2023-02-11,42.95,2312.73
10114,54565625,2023-02-11,-170.89,2141.84
10115,54565625,2023-02-11,-246.42,1895.42
10116,54565625,2023-02-13,70.85,1966.27
10117,54565625,2023-02-13,-77.52,1888.75
10118,54565625,2023-02-14,-100.41,1788.3400000000001
10119,54570251,2023-01-31,,430.68
10120,54570251,2023-02-03,109.86,540.54
10121,54570251,2023-02-03,-79.51,461.03
10122,54570251,2023-02-04,25.74,486.77
10123,54570251,2023-02-06,-105.34,381.43
10124,54570251,2023-02-09,-129.85,251.57999999999998
10125,54570251,2023-02-09,-166.16,85.41999999999999
10126,54570251,2023-02-14,-51.9,33.51999999999999
10127,54589543,2023-01-31,,817.51
10128,54589543,2023-02-02,-1117.0,-299.49
10129,54589543,2023-02-06,977.0,677.51
10130,54589543,2023-02-08,96.45,773.96
10131,54589543,2023-02-10,154.39,928.3499999999999
10132,54589543,2023-02-12,-106.92,821.43
10133,54589543,2023-02-12,-180.17,641.26
10134,54589543,2023-02-13,-125.92,515.34
10135,54673873,2023-01-31,,71.58
10136,54673873,2023-02-05,73.99,145.57
10137,54673873,2023-02-11,55.02,200.59
10138,54673873,2023-02-11,-32.2,168.39
10139,54673873,2023-02-14,134.69,303.08
10140,54720837,2023-01-31,,166.15
10141,54720837,2023-02-04,133.55,299.70000000000005
10142,54720837,2023-02-05,-142.54,157.16000000000003
10143,54720837,2023-02-10,121.97,279.13
10144,54720837,2023-02-11,-409.8,-130.66999999999996
10145,54720837,2023-02-13,125.97,-4.69999999999996
10146,54720837,2023-02-13,93.53,88.83000000000004
10147,54786481,2023-01-31,,96.87
10148,54786481,2023-02-04,-146.68,-49.81
10149,54786481,2023-02-07,134.29,84.47999999999999
10150,54786481,2023-02-08,68.63,153.10999999999999
10151,54786481,2023-02-09,36.48,189.58999999999997
10152,54786481,2023-02-11,121.25,310.84
10153,54786481,2023-02-12,-37.05,273.78999999999996
10154,54786481,2023-02-13,-99.06,174.72999999999996
10155,54824933,2023-01-31,,721.47
10156,54824933,2023-02-05,-130.71,590.76
10157,54824933,2023-02-09,1549.1,2139.8599999999997
10158,54824933,2023-02-10,106.03,2245.89
10159,54824933,2023-02-10,11.9,2257.79
10160,54824933,2023-02-12,-120.78,2137.0099999999998
10161,54852109,2023-01-31,,521.7
10162,54852109,2023-02-09,993.4,1515.1
10163,54852109,2023-02-13,70.25,1585.35
10164,54868017,2023-01-31,,789.86
10165,54868017,2023-02-06,49.33,839.19
10166,54868017,2023-02-08,165.57,1004.76
10167,54868017,2023-02-08,-1024.6,-19.839999999999918
10168,54868017,2023-02-10,158.94,139.10000000000008
10169,54868017,2023-02-11,181.68,320.7800000000001
10170,54868017,2023-02-11,-143.78,177.00000000000009
10171,54868017,2023-02-13,-148.43,28.57000000000008
10172,54878364,2023-01-31,,80.24
10173,54878364,2023-02-03,85.24,165.48
10174,54878364,2023-02-07,-1689.7,-1524.22
10175,54878364,2023-02-08,63.42,-1460.8
10176,54910290,2023-01-31,,11.12
10177,54910290,2023-02-04,950.2,961.32
10178,54910290,2023-02-06,-48.88,912.44
10179,54910290,2023-02-06,-51.05,861.3900000000001
10180,54910290,2023-02-06,-120.17,741.22
10181,54910290,2023-02-07,-129.66,611.5600000000001
10182,54910290,2023-02-08,85.98,697.5400000000001
10183,54910290,2023-02-09,-62.92,634.6200000000001
10184,54910290,2023-02-12,165.42,800.0400000000001
10185,54932317,2023-01-31,,378.86
10186,54932317,2023-02-04,15.32,394.18
10187,54932317,2023-02-06,52.94,447.12
10188,54932317,2023-02-08,10.18,457.3
10189,54932317,2023-02-09,82.57,539.87
10190,54932317,2023-02-10,-116.53,423.34000000000003
10191,54932317,2023-02-11,-858.7,-435.36
10192,54932317,2023-02-13,44.84,-390.52
10193,54932317,2023-02-14,-158.33,-548.85
10194,54937975,2023-01-31,,218.66
10195,54937975,2023-02-07,-62.35,156.31
10196,54937975,2023-02-09,-37.53,118.78
10197,54937975,2023-02-11,-1507.4,-1388.6200000000001
10198,54937975,2023-02-14,195.92,-1192.7
10199,54937975,2023-02-14,96.78,-1095.92
10200,54958511,2023-01-31,,454.61
10201,54958511,2023-02-06,-157.18,297.43
10202,54958511,2023-02-08,-44.34,253.09
10203,54958511,2023-02-09,180.82,433.90999999999997
10204,54958511,2023-02-12,-81.37,352.53999999999996
10205,54958587,2023-01-31,,874.83
10206,54958587,2023-02-03,-106.51,768.32
10207,54958587,2023-02-04,-81.63,686.69
10208,54958587,2023-02-06,-50.78,635.9100000000001
10209,54958587,2023-02-07,-117.45,518.46
10210,54958587,2023-02-08,110.15,628.61
10211,54958587,2023-02-08,-50.71,577.9000000000001
10212,54958587,2023-02-14,-112.23,465.6700000000001
10213,54997427,2023-01-31,,825.84
10214,54997427,2023-02-02,-37.62,788.22
10215,54997427,2023-02-08,-110.6,677.62
10216,55009163,2023-01-31,,435.8
10217,55009163,2023-02-05,123.78,559.58
10218,55009163,2023-02-07,-77.09,482.49
10219,55009163,2023-02-08,-44.05,438.44
10220,55009163,2023-02-08,-187.67,250.77000000000004
10221,55009163,2023-02-10,137.34,388.11
10222,55009163,2023-02-10,86.61,474.72
10223,55009163,2023-02-13,-23.17,451.55000000000007
10224,55022533,2023-01-31,,341.29
10225,55022533,2023-02-05,-35.44,305.85
10226,55022533,2023-02-05,-174.7,131.15000000000003
10227,55022533,2023-02-07,140.77,271.9200000000001
10228,55022533,2023-02-09,-98.03,173.89000000000004
10229,55088029,2023-01-31,,920.53
10230,55088029,2023-02-01,-152.86,767.67
10231,55088029,2023-02-03,556.5,1324.17
10232,55088029,2023-02-11,122.71,1446.8799999999999
10233,55106431,2023-01-31,,460.48
10234,55106431,2023-02-04,163.15,623.63
10235,55106431,2023-02-04,150.02,773.6500000000001
10236,55106431,2023-02-08,101.87,875.52
10237,55122249,2023-01-31,,43.86
10238,55122249,2023-02-11,-66.07,-22.209999999999994
10239,55122249,2023-02-12,84.75,62.540000000000006
10240,55122249,2023-02-14,152.84,215.38
10241,55122249,2023-02-14,68.84,284.22
10242,55168205,2023-01-31,,578.4
10243,55168205,2023-02-01,-78.1,500.29999999999995
10244,55168205,2023-02-04,-120.38,379.91999999999996
10245,55168205,2023-02-06,95.11,475.03
10246,55168205,2023-02-07,88.15,563.18
10247,55168205,2023-02-13,66.15,629.33
10248,55168205,2023-02-14,24.04,653.37
10249,55168205,2023-02-14,-1137.7,-484.33000000000004
10250,55304418,2023-01-31,,968.71
10251,55304418,2023-02-07,-88.15,880.5600000000001
10252,55304418,2023-02-08,-107.41,773.1500000000001
10253,55304418,2023-02-09,57.36,830.51
10254,55304418,2023-02-10,-1795.9,-965.3900000000001
10255,55304418,2023-02-11,-1214.6,-2179.99
10256,55304418,2023-02-12,158.82,-2021.17
10257,55304418,2023-02-13,-871.5,-2892.67
10258,55341552,2023-01-31,,768.94
10259,55341552,2023-02-02,755.3,1524.24
10260,55341552,2023-02-02,48.35,1572.59
10261,55341552,2023-02-04,567.7,2140.29
10262,55341552,2023-02-09,-168.65,1971.64
10263,55341552,2023-02-12,-70.46,1901.18
10264,55341552,2023-02-13,-142.04,1759.14
10265,55353228,2023-01-31,,923.38
10266,55353228,2023-02-05,-540.8,382.58000000000004
10267,55353228,2023-02-09,-29.71,352.87000000000006
10268,55353228,2023-02-11,-132.96,219.91000000000003
10269,55353228,2023-02-13,105.18,325.09000000000003
10270,55397453,2023-01-31,,820.88
10271,55397453,2023-02-01,96.77,917.65
10272,55397453,2023-02-02,1413.6,2331.25
10273,55397453,2023-02-06,198.2,2529.45
10274,55397453,2023-02-07,121.46,2650.91
10275,55397453,2023-02-07,-132.91,2518.0
10276,55397453,2023-02-08,143.22,2661.22
10277,55397453,2023-02-08,80.46,2741.68
10278,55397453,2023-02-08,-151.99,2589.69
10279,55397453,2023-02-14,194.38,2784.07
10280,55398856,2023-01-31,,663.43
10281,55398856,2023-02-01,-645.5,17.92999999999995
10282,55398856,2023-02-02,884.3,902.2299999999999
10283,55398856,2023-02-03,95.54,997.7699999999999
10284,55398856,2023-02-04,-19.13,978.6399999999999
10285,55398856,2023-02-07,47.31,1025.9499999999998
10286,55398856,2023-02-11,-88.16,937.79
10287,55398856,2023-02-12,139.58,1077.37
10288,55459151,2023-01-31,,451.21
10289,55459151,2023-02-02,-162.1,289.11
10290,55459151,2023-02-06,161.61,450.72
10291,55459151,2023-02-06,-78.08,372.64
10292,55459151,2023-02-09,-46.3,326.34000000000003
10293,55459151,2023-02-09,-897.0,-570.66
10294,55459151,2023-02-14,144.85,-425.80999999999995
10295,55459151,2023-02-14,64.45,-361.35999999999996
10296,55472786,2023-01-31,,634.29
10297,55513887,2023-01-31,,722.45
10298,55513887,2023-02-02,-116.43,606.02
10299,55513887,2023-02-03,-74.5,531.52
10300,55513887,2023-02-11,218.81,750.33
10301,55513887,2023-02-11,-50.13,700.2
10302,55513887,2023-02-13,116.37,816.57
10303,55513887,2023-02-14,-76.32,740.25
10304,55552232,2023-01-31,,953.87
10305,55552232,2023-02-01,152.59,1106.46
10306,55552232,2023-02-06,51.75,1158.21
10307,55552232,2023-02-06,-167.46,990.75
10308,55552232,2023-02-10,-679.8,310.95000000000005
10309,55552232,2023-02-12,-149.57,161.38000000000005
10310,55590263,2023-01-31,,605.12
10311,55590263,2023-02-01,189.32,794.44
10312,55590263,2023-02-03,-215.09,579.35
10313,55590263,2023-02-07,116.74,696.09
10314,55590263,2023-02-07,-76.2,619.89
10315,55590263,2023-02-09,78.22,698.11
10316,55607955,2023-01-31,,274.23
10317,55607955,2023-02-07,-89.17,185.06
10318,55607955,2023-02-12,-0.94,184.12
10319,55607955,2023-02-13,53.93,238.05
10320,55714753,2023-01-31,,703.59
10321,55714753,2023-02-03,-64.43,639.1600000000001
10322,55714753,2023-02-06,-30.38,608.78
10323,55714753,2023-02-07,38.04,646.82
10324,55714753,2023-02-10,-26.55,620.27
10325,55753843,2023-01-31,,524.57
10326,55753843,2023-02-04,-158.04,366.5300000000001
10327,55753843,2023-02-05,-147.75,218.78000000000006
10328,55753843,2023-02-10,-194.97,23.81000000000006
10329,55753843,2023-02-11,-127.25,-103.43999999999994
10330,55791547,2023-01-31,,758.17
10331,55791547,2023-02-07,-85.35,672.8199999999999
10332,55791547,2023-02-08,1565.7,2238.52
10333,55791547,2023-02-09,58.39,2296.91
10334,55791547,2023-02-11,-125.71,2171.2
10335,55791547,2023-02-13,188.62,2359.82
10336,55795603,2023-01-31,,241.17
10337,55795603,2023-02-02,-112.16,129.01
10338,55795603,2023-02-04,-482.7,-353.69
10339,55795603,2023-02-08,179.3,-174.39
10340,55795603,2023-02-10,-40.02,-214.41
10341,55795603,2023-02-12,-272.8,-487.21000000000004
10342,55819086,2023-01-31,,608.13
10343,55819086,2023-02-01,209.89,818.02
10344,55819086,2023-02-01,90.71,908.73
10345,55819086,2023-02-03,510.1,1418.83
10346,55819086,2023-02-03,218.15,1636.98
10347,55819086,2023-02-03,-130.36,1506.62
10348,55819086,2023-02-04,88.18,1594.8
10349,55819086,2023-02-09,-135.23,1459.57
10350,55819086,2023-02-10,98.96,1558.53
10351,55819086,2023-02-13,-51.71,1506.82
10352,55819086,2023-02-14,84.96,1591.78
10353,55912413,2023-01-31,,297.61
10354,55912413,2023-02-03,77.0,374.61
10355,55912413,2023-02-03,-90.58,284.03000000000003
10356,55912413,2023-02-11,-102.08,181.95000000000002
10357,55912413,2023-02-13,97.05,279.0
10358,55912413,2023-02-13,-25.66,253.34
10359,55916056,2023-01-31,,377.36
10360,55916056,2023-02-06,1338.0,1715.3600000000001
10361,55916056,2023-02-06,143.44,1858.8000000000002
10362,55916056,2023-02-06,-60.08,1798.72
10363,55916056,2023-02-06,-178.4,1620.3200000000002
10364,55916056,2023-02-08,103.03,1723.3500000000001
10365,55916056,2023-02-10,-79.86,1643.49
10366,55975906,2023-01-31,,112.69
10367,55975906,2023-02-03,-94.79,17.89999999999999
10368,55975906,2023-02-04,-44.5,-26.60000000000001
10369,55975906,2023-02-05,74.28,47.67999999999999
10370,55975906,2023-02-14,148.63,196.31
10371,55986027,2023-01-31,,38.94
10372,55986027,2023-02-03,-100.38,-61.44
10373,55986027,2023-02-05,98.72,37.28
10374,55986027,2023-02-06,-840.3,-803.02
10375,55986027,2023-02-09,-94.29,-897.31
10376,55986027,2023-02-11,-90.72,-988.03
10377,55986027,2023-02-12,-39.77,-1027.8
10378,55986027,2023-02-13,-1619.8,-2647.6
10379,55986093,2023-01-31,,586.34
10380,55986093,2023-02-07,1298.9,1885.2400000000002
10381,55986093,2023-02-08,-88.74,1796.5000000000002
10382,55986093,2023-02-11,139.86,1936.3600000000001
10383,55986093,2023-02-14,-7.29,1929.0700000000002
10384,55986093,2023-02-14,-135.61,1793.4600000000003
10385,56041976,2023-01-31,,56.45
10386,56041976,2023-02-04,55.94,112.39
10387,56041976,2023-02-07,-122.99,-10.599999999999994
10388,56041976,2023-02-08,107.83,97.23
10389,56041976,2023-02-09,93.51,190.74
10390,56041976,2023-02-10,-10.96,179.78
10391,56070421,2023-01-31,,286.85
10392,56070421,2023-02-03,-65.15,221.70000000000002
10393,56070421,2023-02-13,113.44,335.14
10394,56094156,2023-01-31,,531.43
10395,56094156,2023-02-07,-140.77,390.65999999999997
10396,56094156,2023-02-08,258.6,649.26
10397,56094156,2023-02-09,-45.07,604.1899999999999
10398,56094156,2023-02-10,193.16,797.35
10399,56094156,2023-02-13,1237.4,2034.75
10400,56116199,2023-01-31,,615.98
10401,56116199,2023-02-01,-129.83,486.15
10402,56116199,2023-02-03,-35.32,450.83
10403,56116199,2023-02-06,-126.54,324.28999999999996
10404,56116199,2023-02-10,91.04,415.33
10405,56120063,2023-01-31,,94.32
10406,56120063,2023-02-02,179.69,274.01
10407,56120063,2023-02-04,-89.11,184.89999999999998
10408,56120063,2023-02-06,137.1,322.0
10409,56120063,2023-02-07,122.13,444.13
10410,56120063,2023-02-07,98.42,542.55
10411,56120063,2023-02-08,-174.24,368.31
10412,56120063,2023-02-11,-41.23,327.08
10413,56189750,2023-01-31,,365.48
10414,56189750,2023-02-07,-121.65,243.83
10415,56189750,2023-02-10,-50.54,193.29000000000002
10416,56189750,2023-02-12,155.17,348.46000000000004
10417,56189750,2023-02-14,2237.0,2585.46
10418,56297850,2023-01-31,,320.47
10419,56297850,2023-02-01,-114.68,205.79000000000002
10420,56297850,2023-02-05,52.34,258.13
10421,56297850,2023-02-08,30.53,288.66
10422,56297850,2023-02-12,-21.61,267.05
10423,56422161,2023-01-31,,990.84
10424,56422161,2023-02-07,46.29,1037.13
10425,56422161,2023-02-08,62.89,1100.02
10426,56422161,2023-02-09,110.83,1210.85
10427,56422161,2023-02-10,38.38,1249.23
10428,56422161,2023-02-14,195.84,1445.07
10429,56422161,2023-02-14,95.91,1540.98
10430,56453199,2023-01-31,,605.38
10431,56453199,2023-02-01,-71.22,534.16
10432,56453199,2023-02-08,-105.53,428.63
10433,56453199,2023-02-08,-697.8,-269.16999999999996
10434,56453199,2023-02-10,-55.02,-324.18999999999994
10435,56458213,2023-01-31,,731.3
10436,56458213,2023-02-01,-588.3,143.0
10437,56458213,2023-02-02,-1351.2,-1208.2
10438,56458213,2023-02-06,-141.23,-1349.43
10439,56458213,2023-02-10,-120.81,-1470.24
10440,56458213,2023-02-12,-121.0,-1591.24
10441,56458213,2023-02-14,181.24,-1410.0
10442,56468624,2023-01-31,,655.33
10443,56468624,2023-02-03,16.2,671.5300000000001
10444,56468624,2023-02-03,-88.74,582.7900000000001
10445,56468624,2023-02-08,92.38,675.1700000000001
10446,56468624,2023-02-12,910.1,1585.27
10447,56468624,2023-02-13,-68.93,1516.3400000000001
10448,56483442,2023-01-31,,151.85
10449,56483442,2023-02-02,-1298.8,-1146.95
10450,56483442,2023-02-10,163.18,-983.77
10451,56573058,2023-01-31,,34.66
10452,56573058,2023-02-01,129.52,164.18
10453,56573058,2023-02-02,-61.2,102.98
10454,56573058,2023-02-04,163.58,266.56
10455,56573058,2023-02-04,37.75,304.31000000000006
10456,56573058,2023-02-06,48.88,353.19000000000005
10457,56573058,2023-02-07,-137.57,215.62000000000003
10458,56573058,2023-02-09,-118.82,96.80000000000004
10459,56573058,2023-02-12,907.1,1003.9000000000001
10460,56573058,2023-02-12,214.19,1218.0900000000001
10461,56573058,2023-02-13,-53.93,1164.16
10462,56609826,2023-01-31,,14.24
10463,56609826,2023-02-05,174.96,189.20000000000002
10464,56609826,2023-02-09,134.28,323.48
10465,56609826,2023-02-12,-136.93,186.55
10466,56609826,2023-02-14,87.3,273.85
10467,56723864,2023-01-31,,246.21
10468,56723864,2023-02-01,-128.49,117.72
10469,56723864,2023-02-02,137.59,255.31
10470,56723864,2023-02-03,164.36,419.67
10471,56723864,2023-02-06,167.46,587.13
10472,56723864,2023-02-07,-76.84,510.29
10473,56723864,2023-02-11,117.62,627.9100000000001
10474,56723864,2023-02-11,69.79,697.7
10475,56723864,2023-02-12,-104.46,593.24
10476,56723864,2023-02-14,-70.03,523.21
10477,56751728,2023-01-31,,610.52
10478,56751728,2023-02-02,-93.7,516.8199999999999
10479,56751728,2023-02-02,-128.71,388.10999999999996
10480,56751728,2023-02-06,83.83,471.93999999999994
10481,56751728,2023-02-07,-63.12,408.81999999999994
10482,56751728,2023-02-08,-974.3,-565.48
10483,56751728,2023-02-13,-120.16,-685.64
10484,56759680,2023-01-31,,479.7
10485,56759680,2023-02-11,90.65,570.35
10486,56760248,2023-01-31,,571.55
10487,56760248,2023-02-03,56.89,628.4399999999999
10488,56760248,2023-02-03,5.38,633.8199999999999
10489,56760248,2023-02-03,-49.32,584.5
10490,56760248,2023-02-06,111.41,695.91
10491,56760248,2023-02-06,-109.59,586.3199999999999
10492,56760248,2023-02-06,-173.92,412.4
10493,56760248,2023-02-08,-38.27,374.13
10494,56760248,2023-02-09,89.08,463.21
10495,56760248,2023-02-12,-101.83,361.38
10496,56760248,2023-02-13,357.3,718.6800000000001
10497,56842874,2023-01-31,,22.02
10498,56842874,2023-02-06,-69.2,-47.18000000000001
10499,56842874,2023-02-12,-127.2,-174.38
10500,56843498,2023-01-31,,509.55
10501,56843498,2023-02-01,122.7,632.25
10502,56843498,2023-02-02,104.79,737.04
10503,56843498,2023-02-04,101.52,838.5600000000001
10504,56843498,2023-02-05,-160.23,678.33
10505,56843498,2023-02-05,-1345.1,-666.7699999999999
10506,56843498,2023-02-09,1156.9,490.1300000000002
10507,56843498,2023-02-09,135.23,625.3600000000002
10508,56843498,2023-02-13,-121.9,503.4600000000002
10509,56875373,2023-01-31,,633.79
10510,56875373,2023-02-01,-71.73,562.06
10511,56875373,2023-02-03,103.79,665.8499999999999
10512,56875373,2023-02-04,-100.66,565.1899999999999
10513,56875373,2023-02-07,-69.39,495.79999999999995
10514,56875373,2023-02-11,159.77,655.5699999999999
10515,56878640,2023-01-31,,846.85
10516,56878640,2023-02-03,139.16,986.01
10517,56878640,2023-02-05,99.24,1085.25
10518,56878640,2023-02-10,121.71,1206.96
10519,56878640,2023-02-12,36.64,1243.6
10520,56878640,2023-02-12,-151.09,1092.51
10521,56899079,2023-01-31,,445.39
10522,56899079,2023-02-09,-827.3,-381.90999999999997
10523,56922739,2023-01-31,,174.07
10524,56922739,2023-02-03,-220.14,-46.06999999999999
10525,56922739,2023-02-05,102.17,56.10000000000001
10526,56922739,2023-02-07,-80.94,-24.83999999999999
10527,56922739,2023-02-11,-107.01,-131.85
10528,56936624,2023-01-31,,503.74
10529,56936624,2023-02-02,1921.4,2425.1400000000003
10530,56936624,2023-02-03,73.31,2498.4500000000003
10531,56936624,2023-02-03,-101.8,2396.65
10532,56936624,2023-02-07,105.18,2501.83
10533,56936624,2023-02-12,125.27,2627.1
10534,56936624,2023-02-14,-166.38,2460.7200000000003
10535,56946115,2023-01-31,,298.13
10536,56946115,2023-02-02,-45.22,252.91
10537,56946115,2023-02-07,74.35,327.26
10538,56946115,2023-02-12,-92.42,234.83999999999997
10539,57027965,2023-01-31,,979.57
10540,57027965,2023-02-02,103.75,1083.3200000000002
10541,57027965,2023-02-02,-111.9,971.4200000000001
10542,57027965,2023-02-02,-115.29,856.13
10543,57027965,2023-02-05,-109.24,746.8900000000001
10544,57027965,2023-02-06,-197.61,549.28
10545,57027965,2023-02-08,-92.59,456.69000000000005
10546,57027965,2023-02-09,54.69,511.38
10547,57027965,2023-02-10,-210.62,300.76
10548,57027965,2023-02-11,151.02,451.78000000000003
10549,57027965,2023-02-14,-127.34,324.44000000000005
10550,57043647,2023-01-31,,552.06
10551,57043647,2023-02-01,-103.35,448.7099999999999
10552,57043647,2023-02-03,124.18,572.89
10553,57043647,2023-02-03,58.81,631.6999999999999
10554,57043647,2023-02-09,-53.56,578.14
10555,57043647,2023-02-11,152.46,730.5999999999999
10556,57043647,2023-02-12,14.26,744.86
10557,57043647,2023-02-13,107.17,852.03
10558,57043647,2023-02-13,-1207.6,-355.56999999999994
10559,57063886,2023-01-31,,384.17
10560,57063886,2023-02-04,134.46,518.63
10561,57063886,2023-02-07,33.98,552.61
10562,57063886,2023-02-09,-110.14,442.47
10563,57063886,2023-02-10,182.75,625.22
10564,57063886,2023-02-13,-98.44,526.78
10565,57071366,2023-01-31,,911.45
10566,57071366,2023-02-01,80.58,992.0300000000001
10567,57071366,2023-02-01,76.18,1068.21
10568,57071366,2023-02-03,96.63,1164.8400000000001
10569,57071366,2023-02-03,-19.89,1144.95
10570,57071366,2023-02-08,88.56,1233.51
10571,57071366,2023-02-09,-55.83,1177.68
10572,57071366,2023-02-09,-125.68,1052.0
10573,57071366,2023-02-11,49.96,1101.96
10574,57084496,2023-01-31,,58.05
10575,57084496,2023-02-01,1058.7,1116.75
10576,57084496,2023-02-01,802.6,1919.35
10577,57084496,2023-02-04,-121.83,1797.52
10578,57084496,2023-02-07,18.61,1816.13
10579,57084496,2023-02-10,8.85,1824.98
10580,57084496,2023-02-10,-82.33,1742.65
10581,57084496,2023-02-12,-1251.2,491.45000000000005
10582,57084496,2023-02-14,-63.0,428.45000000000005
10583,57096259,2023-01-31,,540.54
10584,57096259,2023-02-02,168.98,709.52
10585,57096259,2023-02-03,101.3,810.8199999999999
10586,57096259,2023-02-05,77.95,888.77
10587,57096259,2023-02-05,-907.1,-18.33000000000004
10588,57096259,2023-02-06,-24.84,-43.170000000000044
10589,57096259,2023-02-09,97.89,54.719999999999956
10590,57108303,2023-01-31,,737.04
10591,57108303,2023-02-03,118.63,855.67
10592,57108303,2023-02-04,-1795.8,-940.13
10593,57108303,2023-02-05,49.78,-890.35
10594,57108303,2023-02-13,97.98,-792.37
10595,57121657,2023-01-31,,847.9
10596,57121657,2023-02-01,135.55,983.45
10597,57121657,2023-02-05,54.79,1038.24
10598,57121657,2023-02-08,796.3,1834.54
10599,57121657,2023-02-08,100.27,1934.81
10600,57121657,2023-02-08,-9.98,1924.83
10601,57121657,2023-02-12,-65.93,1858.8999999999999
10602,57121657,2023-02-12,-134.36,1724.54
10603,57121657,2023-02-13,154.58,1879.12
10604,57121657,2023-02-14,96.98,1976.1
10605,57133159,2023-01-31,,734.4
10606,57133159,2023-02-09,102.35,836.75
10607,57133159,2023-02-13,128.11,964.86
10608,57145139,2023-01-31,,708.46
10609,57145139,2023-02-02,-62.33,646.13
10610,57145139,2023-02-04,-186.01,460.12000000000006
10611,57145139,2023-02-05,-1233.7,-773.5799999999999
10612,57145139,2023-02-07,143.04,-630.54
10613,57145139,2023-02-07,108.88,-521.66
10614,57145139,2023-02-07,-81.96,-603.6199999999999
10615,57145139,2023-02-08,-100.27,-703.8899999999999
10616,57148382,2023-01-31,,638.49
10617,57148382,2023-02-01,81.16,719.65
10618,57148382,2023-02-04,-126.18,593.47
10619,57148382,2023-02-05,-155.64,437.83000000000004
10620,57148382,2023-02-06,-876.5,-438.66999999999996
10621,57148382,2023-02-07,-85.25,-523.92
10622,57148382,2023-02-10,105.08,-418.84
10623,57148382,2023-02-12,144.16,-274.67999999999995
10624,57160773,2023-01-31,,802.9
10625,57160773,2023-02-01,96.2,899.1
10626,57160773,2023-02-03,-472.5,426.59999999999997
10627,57160773,2023-02-05,119.28,545.88
10628,57160773,2023-02-08,-77.84,468.03999999999996
10629,57160773,2023-02-10,167.51,635.55
10630,57160773,2023-02-13,-45.56,589.99
10631,57186194,2023-01-31,,824.69
10632,57186194,2023-02-01,-106.33,718.36
10633,57186194,2023-02-02,-109.06,609.3000000000001
10634,57186194,2023-02-05,-111.92,497.38000000000005
10635,57186194,2023-02-09,-181.31,316.07000000000005
10636,57186194,2023-02-13,48.13,364.20000000000005
10637,57186194,2023-02-14,158.38,522.58
10638,57186194,2023-02-14,-756.9,-234.31999999999994
10639,57224848,2023-01-31,,30.59
10640,57224848,2023-02-02,96.85,127.44
10641,57224848,2023-02-02,-74.5,52.94
10642,57224848,2023-02-05,-77.0,-24.060000000000002
10643,57224848,2023-02-07,85.73,61.67
10644,57224848,2023-02-10,-1987.3,-1925.6299999999999
10645,57224848,2023-02-12,-27.74,-1953.37
10646,57224848,2023-02-12,-112.58,-2065.95
10647,57273397,2023-01-31,,403.21
10648,57273397,2023-02-06,154.24,557.45
10649,57273397,2023-02-06,-134.08,423.37
10650,57273397,2023-02-09,36.49,459.85999999999996
10651,57273397,2023-02-11,117.16,577.02
10652,57273397,2023-02-11,81.26,658.28
10653,57273397,2023-02-13,-186.3,471.97999999999996
10654,57273397,2023-02-14,-97.09,374.89
10655,57300901,2023-01-31,,302.87
10656,57300901,2023-02-01,-65.35,237.52
10657,57300901,2023-02-03,108.13,345.65
10658,57300901,2023-02-03,-72.03,273.62
10659,57300901,2023-02-04,213.8,487.42
10660,57300901,2023-02-04,-1320.2,-832.78
10661,57300901,2023-02-09,-78.1,-910.88
10662,57300901,2023-02-10,-162.36,-1073.24
10663,57300901,2023-02-12,137.14,-936.1
10664,57300901,2023-02-12,100.81,-835.29
10665,57302841,2023-01-31,,341.02
10666,57302841,2023-02-01,72.19,413.21
10667,57302841,2023-02-08,152.99,566.2
10668,57302841,2023-02-08,-91.11,475.09
10669,57302841,2023-02-13,-134.97,340.12
10670,57372684,2023-01-31,,249.26
10671,57372684,2023-02-01,111.48,360.74
10672,57372684,2023-02-02,237.02,597.76
10673,57372684,2023-02-06,-141.38,456.38
10674,57372684,2023-02-08,-52.45,403.93
10675,57372684,2023-02-10,121.29,525.22
10676,57372684,2023-02-10,-94.14,431.08
10677,57372684,2023-02-12,-93.57,337.51
10678,57395511,2023-01-31,,747.89
10679,57395511,2023-02-02,-151.59,596.3
10680,57395511,2023-02-06,-91.85,504.45
10681,57395511,2023-02-07,120.5,624.95
10682,57395511,2023-02-09,-82.57,542.38
10683,57395511,2023-02-11,85.36,627.74
10684,57395511,2023-02-12,-95.25,532.49
10685,57395511,2023-02-13,123.69,656.18
10686,57395511,2023-02-14,-83.11,573.0699999999999
10687,57413609,2023-01-31,,219.01
10688,57413609,2023-02-08,-30.21,188.79999999999998
10689,57413609,2023-02-12,-68.21,120.59
10690,57426365,2023-01-31,,606.03
10691,57426365,2023-02-01,123.23,729.26
10692,57426365,2023-02-01,94.29,823.55
10693,57426365,2023-02-01,65.35,888.9
10694,57426365,2023-02-03,52.27,941.17
10695,57426365,2023-02-05,6.87,948.04
10696,57426365,2023-02-05,-76.24,871.8
10697,57426365,2023-02-06,-126.49,745.31
10698,57426365,2023-02-10,52.93,798.24
10699,57426365,2023-02-12,-100.61,697.63
10700,57426365,2023-02-14,37.59,735.22
10701,57436108,2023-01-31,,899.46
10702,57436108,2023-02-02,49.76,949.22
10703,57436108,2023-02-02,-98.78,850.44
10704,57436108,2023-02-04,-1349.2,-498.76
10705,57436108,2023-02-05,-129.49,-628.25
10706,57436108,2023-02-10,-103.49,-731.74
10707,57436108,2023-02-13,127.61,-604.13
10708,57446648,2023-01-31,,542.41
10709,57446648,2023-02-02,179.19,721.5999999999999
10710,57446648,2023-02-06,1201.1,1922.6999999999998
10711,57446648,2023-02-09,123.62,2046.3199999999997
10712,57446648,2023-02-12,129.84,2176.16
10713,57450523,2023-01-31,,609.41
10714,57450523,2023-02-03,82.41,691.8199999999999
10715,57450523,2023-02-06,-82.1,609.72
10716,57450523,2023-02-08,59.47,669.1899999999999
10717,57450523,2023-02-11,-77.75,591.4399999999999
10718,57450523,2023-02-11,-991.6,-400.1600000000001
10719,57450523,2023-02-12,137.83,-262.33000000000004
10720,57507102,2023-01-31,,374.17
10721,57507102,2023-02-01,-84.14,290.03000000000003
10722,57507102,2023-02-09,-31.87,258.16
10723,57507102,2023-02-11,-148.04,110.12000000000003
10724,57507102,2023-02-12,31.75,141.87000000000003
10725,57507102,2023-02-13,116.22,258.09000000000003
10726,57507102,2023-02-14,74.72,332.81000000000006
10727,57584855,2023-01-31,,37.86
10728,57584855,2023-02-01,-83.37,-45.510000000000005
10729,57584855,2023-02-07,-125.24,-170.75
10730,57584855,2023-02-09,155.0,-15.75
10731,57584855,2023-02-11,81.2,65.45
10732,57584855,2023-02-11,-51.18,14.270000000000003
10733,57584855,2023-02-12,-56.96,-42.69
10734,57610201,2023-01-31,,931.52
10735,57610201,2023-02-03,-676.5,255.01999999999998
10736,57610201,2023-02-04,97.9,352.91999999999996
10737,57610201,2023-02-06,-58.71,294.21
10738,57610201,2023-02-11,-56.37,237.83999999999997
10739,57610201,2023-02-12,25.98,263.82
10740,57610201,2023-02-12,-145.68,118.13999999999999
10741,57610201,2023-02-13,-158.29,-40.150000000000006
10742,57610201,2023-02-14,64.87,24.72
10743,57612494,2023-01-31,,499.3
10744,57612494,2023-02-05,109.6,608.9
10745,57612494,2023-02-12,103.32,712.22
10746,57612494,2023-02-12,-44.09,668.13
10747,57675131,2023-01-31,,410.85
10748,57675131,2023-02-02,90.07,500.92
10749,57675131,2023-02-04,112.22,613.14
10750,57675131,2023-02-07,123.24,736.38
10751,57675131,2023-02-07,-150.92,585.46
10752,57687949,2023-01-31,,542.92
10753,57687949,2023-02-01,119.2,662.12
10754,57687949,2023-02-03,-88.02,574.0999999999999
10755,57687949,2023-02-07,211.2,785.3
10756,57687949,2023-02-08,-119.51,665.79
10757,57687949,2023-02-09,682.6,1348.3899999999999
10758,57687949,2023-02-12,143.47,1491.86
10759,57687949,2023-02-13,-94.69,1397.17
10760,57717550,2023-01-31,,832.39
10761,57717550,2023-02-01,119.21,951.6
10762,57717550,2023-02-01,-103.68,847.92
10763,57717550,2023-02-03,-125.77,722.15
10764,57717550,2023-02-09,61.13,783.28
10765,57790631,2023-01-31,,893.46
10766,57790631,2023-02-01,-105.16,788.3000000000001
10767,57790631,2023-02-09,-71.26,717.0400000000001
10768,57790631,2023-02-11,166.8,883.84
10769,57790631,2023-02-14,-1139.7,-255.86
10770,57886631,2023-01-31,,369.6
10771,57886631,2023-02-05,61.09,430.69000000000005
10772,57886631,2023-02-06,543.9,974.59
10773,57886631,2023-02-07,52.98,1027.57
10774,57886631,2023-02-08,-114.36,913.21
10775,57886631,2023-02-11,110.5,1023.71
10776,57886631,2023-02-11,-154.67,869.0400000000001
10777,57886631,2023-02-12,-85.93,783.11
10778,57886631,2023-02-13,-143.14,639.97
10779,57897038,2023-01-31,,399.72
10780,57897038,2023-02-01,-38.67,361.05
10781,57897038,2023-02-02,46.31,407.36
10782,57897038,2023-02-04,118.34,525.7
10783,57897038,2023-02-06,119.61,645.3100000000001
10784,57897038,2023-02-09,-1653.1,-1007.7899999999998
10785,57897038,2023-02-11,-88.41,-1096.1999999999998
10786,57941886,2023-01-31,,270.81
10787,57941886,2023-02-02,224.12,494.93
10788,57941886,2023-02-02,166.1,661.03
10789,57941886,2023-02-06,-154.07,506.96000000000004
10790,57941886,2023-02-08,-59.97,446.99
10791,57941886,2023-02-12,38.42,485.41
10792,57941886,2023-02-14,-37.37,448.04
10793,57948925,2023-01-31,,194.11
10794,57948925,2023-02-03,-95.29,98.82000000000001
10795,57948925,2023-02-04,-1465.5,-1366.68
10796,57948925,2023-02-07,182.69,-1183.99
10797,57948925,2023-02-09,-7.12,-1191.1100000000001
10798,57948925,2023-02-09,-96.17,-1287.28
10799,57948925,2023-02-13,-1505.7,-2792.98
10800,57975842,2023-01-31,,101.94
10801,57975842,2023-02-10,181.0,282.94
10802,58009817,2023-01-31,,887.22
10803,58009817,2023-02-02,121.1,1008.32
10804,58009817,2023-02-03,-144.92,863.4000000000001
10805,58009817,2023-02-04,150.76,1014.1600000000001
10806,58009817,2023-02-05,-56.62,957.5400000000001
10807,58009817,2023-02-06,-64.67,892.87
10808,58009817,2023-02-08,111.05,1003.9200000000001
10809,58009817,2023-02-08,-22.97,980.95
10810,58009817,2023-02-12,-1354.4,-373.45000000000005
10811,58099419,2023-01-31,,185.74
10812,58099419,2023-02-01,-152.29,33.45000000000002
10813,58099419,2023-02-05,144.17,177.62
10814,58099419,2023-02-14,-80.0,97.62
10815,58126511,2023-01-31,,940.27
10816,58126511,2023-02-03,76.11,1016.38
10817,58126511,2023-02-03,-85.3,931.0799999999999
10818,58126511,2023-02-04,1639.2,2570.2799999999997
10819,58126511,2023-02-05,-148.33,2421.95
10820,58126511,2023-02-07,-98.77,2323.18
10821,58126511,2023-02-08,88.99,2412.17
10822,58126511,2023-02-09,-45.7,2366.47
10823,58126511,2023-02-11,-121.16,2245.31
10824,58126511,2023-02-13,108.27,2353.58
10825,58126511,2023-02-14,90.11,2443.69
10826,58126511,2023-02-14,36.2,2479.89
10827,58176810,2023-01-31,,219.07
10828,58176810,2023-02-02,-25.85,193.22
10829,58176810,2023-02-03,-105.11,88.10999999999999
10830,58176810,2023-02-05,113.3,201.40999999999997
10831,58176810,2023-02-09,-104.33,97.07999999999998
10832,58176810,2023-02-14,133.71,230.79
10833,58182495,2023-01-31,,223.57
10834,58182495,2023-02-05,-949.6,-726.03
10835,58182495,2023-02-12,-158.82,-884.8500000000001
10836,58216756,2023-01-31,,642.13
10837,58216756,2023-02-02,115.09,757.22
10838,58216756,2023-02-02,51.0,808.22
10839,58216756,2023-02-03,625.5,1433.72
10840,58216756,2023-02-06,120.17,1553.89
10841,58216756,2023-02-09,-79.05,1474.8400000000001
10842,58216756,2023-02-11,-91.03,1383.81
10843,58216756,2023-02-12,-1690.9,-307.09000000000015
10844,58216756,2023-02-13,-167.82,-474.91000000000014
10845,58249518,2023-01-31,,14.63
10846,58249518,2023-02-07,56.84,71.47
10847,58249518,2023-02-12,-84.03,-12.560000000000002
10848,58254002,2023-01-31,,94.53
10849,58254002,2023-02-01,-91.66,2.8700000000000045
10850,58254002,2023-02-11,184.66,187.53
10851,58254002,2023-02-11,161.25,348.78
10852,58254002,2023-02-11,45.84,394.62
10853,58254002,2023-02-11,-165.77,228.85
10854,58254002,2023-02-13,-1258.1,-1029.25
10855,58254002,2023-02-14,-37.59,-1066.84
10856,58254002,2023-02-14,-141.17,-1208.01
10857,58258401,2023-01-31,,873.05
10858,58258401,2023-02-03,154.95,1028.0
10859,58258401,2023-02-06,-119.58,908.42
10860,58258401,2023-02-06,-178.88,729.54
10861,58258401,2023-02-07,-124.51,605.03
10862,58258401,2023-02-12,-105.2,499.8299999999999
10863,58265755,2023-01-31,,494.05
10864,58265755,2023-02-01,156.89,650.94
10865,58265755,2023-02-02,-124.21,526.73
10866,58265755,2023-02-03,178.54,705.27
10867,58265755,2023-02-03,-127.44,577.8299999999999
10868,58265755,2023-02-07,-114.81,463.02
10869,58265755,2023-02-08,-173.81,289.21
10870,58265755,2023-02-14,116.74,405.95
10871,58290957,2023-01-31,,580.25
10872,58290957,2023-02-06,-157.11,423.14
10873,58290957,2023-02-10,-134.24,288.9
10874,58304487,2023-01-31,,5.31
10875,58304487,2023-02-03,59.2,64.51
10876,58304487,2023-02-03,-115.75,-51.239999999999995
10877,58304487,2023-02-04,95.13,43.89
10878,58304487,2023-02-09,-146.33,-102.44000000000001
10879,58304487,2023-02-13,-86.65,-189.09000000000003
10880,58305943,2023-01-31,,970.56
10881,58305943,2023-02-01,58.02,1028.58
10882,58305943,2023-02-02,-164.6,863.98
10883,58305943,2023-02-04,118.08,982.06
10884,58305943,2023-02-04,99.93,1081.99
10885,58305943,2023-02-07,-122.53,959.4599999999999
10886,58305943,2023-02-07,-124.42,835.04
10887,58305943,2023-02-08,-122.18,712.8599999999999
10888,58305943,2023-02-09,-138.85,574.01
10889,58305943,2023-02-10,-114.0,460.01
10890,58306431,2023-01-31,,576.56
10891,58306431,2023-02-01,-102.89,473.66999999999996
10892,58306431,2023-02-02,103.47,577.14
10893,58306431,2023-02-03,-123.38,453.75999999999993
10894,58306431,2023-02-04,35.39,489.15
10895,58306431,2023-02-06,742.3,1231.4499999999998
10896,58306431,2023-02-12,-78.91,1152.54
10897,58306431,2023-02-12,-202.22,950.3199999999999
10898,58306431,2023-02-13,67.88,1018.1999999999999
10899,58306431,2023-02-14,-1485.6,-467.4
10900,58332273,2023-01-31,,299.3
10901,58332273,2023-02-06,-179.82,119.48000000000002
10902,58332273,2023-02-09,73.05,192.53000000000003
10903,58332273,2023-02-12,19.96,212.49
10904,58345258,2023-01-31,,749.07
10905,58345258,2023-02-02,144.51,893.58
10906,58345258,2023-02-06,561.3,1454.88
10907,58345258,2023-02-08,-947.8,507.08000000000004
10908,58345258,2023-02-11,69.7,576.7800000000001
10909,58345258,2023-02-13,817.7,1394.48
10910,58362636,2023-01-31,,89.45
10911,58362636,2023-02-06,-39.83,49.620000000000005
10912,58362636,2023-02-07,129.66,179.28
10913,58362636,2023-02-08,120.31,299.59000000000003
10914,58362636,2023-02-12,95.84,395.43
10915,58384131,2023-01-31,,327.68
10916,58384131,2023-02-01,158.57,486.25
10917,58384131,2023-02-05,-72.1,414.15
10918,58384131,2023-02-09,-70.47,343.68
10919,58384131,2023-02-09,-147.12,196.56
10920,58385320,2023-01-31,,693.52
10921,58385320,2023-02-05,-89.23,604.29
10922,58385320,2023-02-05,-121.41,482.88
10923,58385320,2023-02-05,-197.01,285.87
10924,58385320,2023-02-06,583.7,869.57
10925,58385320,2023-02-10,-79.87,789.7
10926,58400012,2023-01-31,,606.79
10927,58400012,2023-02-01,71.73,678.52
10928,58400012,2023-02-11,59.1,737.62
10929,58434725,2023-01-31,,365.9
10930,58434725,2023-02-03,-47.74,318.15999999999997
10931,58434725,2023-02-03,-87.65,230.50999999999996
10932,58434725,2023-02-09,-69.99,160.51999999999998
10933,58434725,2023-02-11,62.47,222.98999999999995
10934,58434725,2023-02-14,91.73,314.71999999999997
10935,58458443,2023-01-31,,903.64
10936,58458443,2023-02-03,-87.05,816.59
10937,58458443,2023-02-07,-180.63,635.96
10938,58489789,2023-01-31,,460.5
10939,58489789,2023-02-02,39.87,500.37
10940,58489789,2023-02-02,-120.72,379.65
10941,58489789,2023-02-04,-54.57,325.08
10942,58489789,2023-02-06,-97.09,227.99
10943,58489789,2023-02-07,-109.32,118.67000000000002
10944,58489789,2023-02-10,98.63,217.3
10945,58489789,2023-02-14,-108.48,108.82000000000001
10946,58491429,2023-01-31,,937.47
10947,58491429,2023-02-05,-77.95,859.52
10948,58491429,2023-02-06,-1486.9,-627.3800000000001
10949,58491429,2023-02-07,-103.74,-731.1200000000001
10950,58491429,2023-02-10,-93.02,-824.1400000000001
10951,58533748,2023-01-31,,490.86
10952,58533748,2023-02-04,-113.49,377.37
10953,58533748,2023-02-08,-80.13,297.24
10954,58533748,2023-02-14,90.86,388.1
10955,58533748,2023-02-14,-139.82,248.28000000000003
10956,58533748,2023-02-14,-321.9,-73.61999999999995
10957,58547184,2023-01-31,,218.22
10958,58547184,2023-02-02,1586.6,1804.82
10959,58547184,2023-02-02,61.66,1866.48
10960,58547184,2023-02-04,-14.63,1851.85
10961,58547184,2023-02-05,83.83,1935.6799999999998
10962,58547184,2023-02-06,107.61,2043.29
10963,58547184,2023-02-11,-69.84,1973.4499999999998
10964,58547184,2023-02-11,-142.41,1831.04
10965,58558145,2023-01-31,,495.35
10966,58558145,2023-02-10,-114.24,381.11
10967,58558145,2023-02-11,-91.38,289.73
10968,58558145,2023-02-13,91.8,381.53000000000003
10969,58586275,2023-01-31,,916.97
10970,58586275,2023-02-07,979.3,1896.27
10971,58586275,2023-02-07,-41.64,1854.6299999999999
10972,58586275,2023-02-10,-102.06,1752.57
10973,58586275,2023-02-12,-121.68,1630.8899999999999
10974,58668564,2023-01-31,,813.28
10975,58668564,2023-02-01,-105.85,707.43
10976,58668564,2023-02-08,-90.09,617.3399999999999
10977,58668564,2023-02-11,1125.0,1742.34
10978,58668564,2023-02-12,-108.96,1633.3799999999999
10979,58668564,2023-02-14,57.83,1691.21
10980,58683711,2023-01-31,,12.76
10981,58683711,2023-02-01,-115.4,-102.64
10982,58683711,2023-02-05,41.55,-61.09
10983,58683711,2023-02-10,126.49,65.39999999999999
10984,58683711,2023-02-10,88.53,153.93
10985,58683711,2023-02-14,0.36,154.29
10986,58703801,2023-01-31,,520.81
10987,58703801,2023-02-09,-100.78,420.03
10988,58703801,2023-02-10,165.41,585.4399999999999
10989,58703801,2023-02-12,-166.9,418.53999999999996
10990,58703801,2023-02-13,53.93,472.4699999999999
10991,58720727,2023-01-31,,471.56
10992,58720727,2023-02-03,-142.86,328.7
10993,58720727,2023-02-04,108.24,436.94
10994,58720727,2023-02-05,-62.37,374.57
10995,58720727,2023-02-08,-92.11,282.46
10996,58720727,2023-02-11,-49.96,232.49999999999997
10997,58720727,2023-02-11,-142.67,89.82999999999998
10998,58720727,2023-02-12,-113.6,-23.77000000000001
10999,58720727,2023-02-13,-80.64,-104.41000000000001
11000,58720727,2023-02-14,-1650.9,-1755.3100000000002
11001,58728550,2023-01-31,,250.26
11002,58728550,2023-02-04,-37.8,212.45999999999998
11003,58728550,2023-02-11,114.61,327.07
11004,58785108,2023-01-31,,473.41
11005,58785108,2023-02-01,61.87,535.28
11006,58785108,2023-02-04,104.53,639.8100000000001
11007,58785108,2023-02-04,-64.43,575.38
11008,58785108,2023-02-07,-883.6,-308.22
11009,58785108,2023-02-11,-32.04,-340.26000000000005
11010,58785108,2023-02-13,186.3,-153.96
11011,58810775,2023-01-31,,747.44
11012,58810775,2023-02-01,-62.0,685.44
11013,58810775,2023-02-05,114.97,800.4100000000001
11014,58810775,2023-02-05,-20.17,780.24
11015,58810775,2023-02-07,151.21,931.45
11016,58810775,2023-02-13,-97.59,833.86
11017,58811985,2023-01-31,,616.7
11018,58811985,2023-02-08,1024.6,1641.3
11019,58811985,2023-02-09,155.76,1797.06
11020,58811985,2023-02-12,-126.97,1670.09
11021,58811985,2023-02-14,85.37,1755.46
11022,58822254,2023-01-31,,79.7
11023,58822254,2023-02-02,-1559.2,-1479.5
11024,58822254,2023-02-03,-436.5,-1916.0
11025,58822254,2023-02-04,129.56,-1786.44
11026,58822254,2023-02-08,42.43,-1744.01
11027,58822254,2023-02-10,129.11,-1614.9
11028,58830897,2023-01-31,,834.24
11029,58830897,2023-02-02,-22.54,811.7
11030,58830897,2023-02-04,-55.94,755.76
11031,58830897,2023-02-05,-110.92,644.84
11032,58830897,2023-02-06,-117.02,527.82
11033,58830897,2023-02-11,152.47,680.29
11034,58830897,2023-02-12,-214.19,466.1
11035,58830897,2023-02-14,137.92,604.02
11036,58837121,2023-01-31,,160.48
11037,58837121,2023-02-04,97.06,257.53999999999996
11038,58837121,2023-02-05,-163.32,94.22
11039,58837121,2023-02-07,75.03,169.25
11040,58837121,2023-02-08,-80.72,88.53
11041,58837121,2023-02-11,111.96,200.49
11042,58837121,2023-02-11,-50.91,149.57999999999998
11043,58837121,2023-02-14,103.18,252.76
11044,58873428,2023-01-31,,191.58
11045,58873428,2023-02-07,39.09,230.67000000000002
11046,58874842,2023-01-31,,347.73
11047,58874842,2023-02-01,-53.09,294.64
11048,58874842,2023-02-07,-183.11,111.53
11049,58874842,2023-02-08,106.37,217.9
11050,58874842,2023-02-09,154.04,371.94
11051,58874842,2023-02-10,57.64,429.58
11052,58874842,2023-02-14,86.86,516.44
11053,58897654,2023-01-31,,210.05
11054,58897654,2023-02-04,113.97,324.02
11055,58897654,2023-02-05,193.2,517.22
11056,58925998,2023-01-31,,855.45
11057,58925998,2023-02-05,166.03,1021.48
11058,58925998,2023-02-09,56.12,1077.6000000000001
11059,58925998,2023-02-10,155.67,1233.27
11060,58925998,2023-02-11,100.88,1334.15
11061,58925998,2023-02-12,1261.6,2595.75
11062,58930654,2023-01-31,,661.48
11063,58930654,2023-02-03,136.43,797.9100000000001
11064,58930654,2023-02-04,-158.41,639.5
11065,58930654,2023-02-09,-45.0,594.5
11066,58930654,2023-02-13,-93.39,501.11
11067,58930654,2023-02-13,-109.04,392.07000000000005
11068,58937028,2023-01-31,,626.96
11069,58937028,2023-02-12,86.73,713.69
11070,58995891,2023-01-31,,12.92
11071,58995891,2023-02-03,-118.76,-105.84
11072,58995891,2023-02-08,-50.31,-156.15
11073,58995891,2023-02-09,125.24,-30.91000000000001
11074,58995891,2023-02-10,-106.62,-137.53000000000003
11075,59110895,2023-01-31,,605.5
11076,59110895,2023-02-09,-1260.0,-654.5
11077,59128512,2023-01-31,,305.71
11078,59128512,2023-02-01,158.92,464.63
11079,59128512,2023-02-03,94.28,558.91
11080,59128512,2023-02-07,1380.5,1939.4099999999999
11081,59128512,2023-02-08,122.81,2062.22
11082,59128512,2023-02-09,109.28,2171.5
11083,59128512,2023-02-10,70.74,2242.24
11084,59128512,2023-02-13,67.31,2309.5499999999997
11085,59128512,2023-02-13,-128.0,2181.5499999999997
11086,59135815,2023-01-31,,240.6
11087,59135815,2023-02-01,-800.0,-559.4
11088,59135815,2023-02-04,436.5,-122.89999999999998
11089,59135815,2023-02-06,-108.14,-231.03999999999996
11090,59135815,2023-02-10,-1202.5,-1433.54
11091,59152169,2023-01-31,,148.6
11092,59152169,2023-02-01,70.5,219.1
11093,59152169,2023-02-05,124.52,343.62
11094,59152169,2023-02-05,-57.18,286.44
11095,59152169,2023-02-08,92.83,379.27
11096,59152169,2023-02-09,-1160.0,-780.73
11097,59152169,2023-02-12,89.7,-691.03
11098,59167707,2023-01-31,,904.43
11099,59167707,2023-02-01,-109.32,795.1099999999999
11100,59167707,2023-02-06,49.47,844.5799999999999
11101,59167707,2023-02-06,-60.85,783.7299999999999
11102,59167707,2023-02-10,-95.08,688.65
11103,59198134,2023-01-31,,122.62
11104,59198134,2023-02-06,168.59,291.21000000000004
11105,59198134,2023-02-09,-104.28,186.93
11106,59198134,2023-02-13,-135.45,51.48000000000002
11107,59198134,2023-02-13,-1291.4,-1239.92
11108,59201002,2023-01-31,,780.85
11109,59201002,2023-02-01,199.99,980.84
11110,59201002,2023-02-01,96.35,1077.19
11111,59201002,2023-02-04,-44.05,1033.14
11112,59201002,2023-02-08,-163.95,869.19
11113,59201002,2023-02-12,-742.0,127.19000000000005
11114,59235925,2023-01-31,,647.8
11115,59235925,2023-02-01,-66.43,581.3699999999999
11116,59235925,2023-02-04,111.18,692.55
11117,59235925,2023-02-06,84.1,776.65
11118,59235925,2023-02-08,42.92,819.5699999999999
11119,59235925,2023-02-08,-64.27,755.3
11120,59235925,2023-02-09,-101.53,653.77
11121,59235925,2023-02-11,152.0,805.77
11122,59238438,2023-01-31,,105.1
11123,59238438,2023-02-01,12.97,118.07
11124,59238438,2023-02-07,-49.76,68.31
11125,59238438,2023-02-09,85.32,153.63
11126,59238438,2023-02-12,-1799.2,-1645.5700000000002
11127,59252971,2023-01-31,,803.65
11128,59252971,2023-02-05,85.62,889.27
11129,59252971,2023-02-07,-1741.9,-852.6300000000001
11130,59252971,2023-02-13,131.61,-721.0200000000001
11131,59252971,2023-02-14,-169.73,-890.7500000000001
11132,59265775,2023-01-31,,695.02
11133,59265775,2023-02-01,55.85,750.87
11134,59265775,2023-02-04,81.94,832.81
11135,59265775,2023-02-05,74.37,907.18
11136,59265775,2023-02-11,68.33,975.51
11137,59265775,2023-02-12,-130.06,845.45
11138,59265775,2023-02-12,-153.05,692.4
11139,59265775,2023-02-14,142.86,835.26
11140,59379884,2023-01-31,,139.54
11141,59379884,2023-02-05,81.18,220.72
11142,59379884,2023-02-10,-156.94,63.78
11143,59379884,2023-02-11,-65.4,-1.6200000000000045
11144,59379884,2023-02-12,564.4,562.78
11145,59379884,2023-02-13,-84.91,477.87
11146,59405362,2023-01-31,,503.89
11147,59405362,2023-02-01,136.51,640.4
11148,59405362,2023-02-01,76.9,717.3
11149,59405362,2023-02-05,-144.79,572.51
11150,59405362,2023-02-08,-195.9,376.61
11151,59405362,2023-02-09,645.9,1022.51
11152,59405362,2023-02-10,-66.94,955.5699999999999
11153,59405362,2023-02-11,43.44,999.01
11154,59432049,2023-01-31,,387.57
11155,59432049,2023-02-01,142.99,530.56
11156,59432049,2023-02-04,578.7,1109.26
11157,59432049,2023-02-05,1121.5,2230.76
11158,59432049,2023-02-06,129.93,2360.69
11159,59432049,2023-02-06,117.11,2477.8
11160,59432049,2023-02-06,-106.77,2371.03
11161,59432049,2023-02-08,66.67,2437.7
11162,59432049,2023-02-08,-125.79,2311.91
11163,59432049,2023-02-11,-175.69,2136.22
11164,59432049,2023-02-14,-34.07,2102.15
11165,59450573,2023-01-31,,888.65
11166,59450573,2023-02-05,80.26,968.91
11167,59450573,2023-02-09,-47.96,920.9499999999999
11168,59450573,2023-02-10,-86.27,834.68
11169,59455653,2023-01-31,,4.64
11170,59455653,2023-02-04,7.74,12.379999999999999
11171,59455653,2023-02-06,-129.93,-117.55000000000001
11172,59455653,2023-02-11,148.32,30.769999999999982
11173,59455653,2023-02-12,-1261.7,-1230.93
11174,59510370,2023-01-31,,523.1
11175,59510370,2023-02-03,32.77,555.87
11176,59510370,2023-02-04,-97.19,458.68000000000006
11177,59510370,2023-02-06,12.77,471.45000000000005
11178,59510370,2023-02-10,-62.26,409.19000000000005
11179,59510370,2023-02-14,-53.96,355.23
11180,59529922,2023-01-31,,516.09
11181,59529922,2023-02-01,-129.91,386.18000000000006
11182,59529922,2023-02-03,-104.89,281.29
11183,59529922,2023-02-04,105.37,386.66
11184,59529922,2023-02-06,104.58,491.24
11185,59529922,2023-02-07,-1.77,489.47
11186,59529922,2023-02-09,36.06,525.5300000000001
11187,59529922,2023-02-10,-121.92,403.61
11188,59529922,2023-02-10,-156.22,247.39000000000004
11189,59529922,2023-02-13,-102.31,145.08000000000004
11190,59529922,2023-02-14,89.67,234.75000000000006
11191,59575867,2023-01-31,,576.66
11192,59575867,2023-02-03,5.14,581.8
11193,59575867,2023-02-10,-159.2,422.59999999999997
11194,59575867,2023-02-13,103.44,526.04
11195,59591324,2023-01-31,,509.65
11196,59591324,2023-02-05,806.2,1315.85
11197,59591324,2023-02-05,-181.42,1134.43
11198,59591324,2023-02-12,53.98,1188.41
11199,59591324,2023-02-13,156.89,1345.3
11200,59591324,2023-02-13,135.45,1480.75
11201,59640238,2023-01-31,,993.42
11202,59640238,2023-02-05,129.51,1122.9299999999998
11203,59640238,2023-02-08,-185.22,937.7099999999999
11204,59640238,2023-02-09,-127.23,810.4799999999999
11205,59640238,2023-02-11,137.43,947.91
11206,59653557,2023-01-31,,649.61
11207,59653557,2023-02-04,-106.46,543.15
11208,59653557,2023-02-06,-37.9,505.25
11209,59653557,2023-02-06,-1524.9,-1019.6500000000001
11210,59653557,2023-02-08,-117.35,-1137.0
11211,59663741,2023-01-31,,642.86
11212,59663741,2023-02-03,68.43,711.29
11213,59663741,2023-02-05,118.22,829.51
11214,59663741,2023-02-05,113.1,942.61
11215,59663741,2023-02-06,97.36,1039.97
11216,59663741,2023-02-07,-199.41,840.56
11217,59663741,2023-02-09,127.72,968.28
11218,59663741,2023-02-10,-51.27,917.01
11219,59663741,2023-02-10,-1484.2,-567.19
11220,59663741,2023-02-11,-85.89,-653.08
11221,59663741,2023-02-14,30.0,-623.08
11222,59684752,2023-01-31,,14.43
11223,59684752,2023-02-01,-119.45,-105.02000000000001
11224,59684752,2023-02-05,-108.03,-213.05
11225,59684752,2023-02-05,-159.46,-372.51
11226,59684752,2023-02-06,-27.93,-400.44
11227,59684752,2023-02-06,-154.3,-554.74
11228,59684752,2023-02-08,108.02,-446.72
11229,59684752,2023-02-08,-92.84,-539.5600000000001
11230,59684752,2023-02-09,-108.23,-647.79
11231,59684752,2023-02-12,-130.68,-778.47
11232,59684752,2023-02-13,2359.1,1580.6299999999999
11233,59705091,2023-01-31,,631.05
11234,59705091,2023-02-02,1091.2,1722.25
11235,59705091,2023-02-04,-46.93,1675.32
11236,59705091,2023-02-04,-102.22,1573.1
11237,59705091,2023-02-07,111.37,1684.47
11238,59705091,2023-02-08,62.19,1746.66
11239,59705091,2023-02-08,53.32,1799.98
11240,59705091,2023-02-11,-1677.5,122.48000000000002
11241,59705091,2023-02-13,-73.31,49.170000000000016
11242,59737910,2023-01-31,,523.19
11243,59737910,2023-02-03,99.14,622.33
11244,59737910,2023-02-09,132.58,754.9100000000001
11245,59737910,2023-02-11,80.51,835.4200000000001
11246,59737910,2023-02-11,-139.86,695.5600000000001
11247,59855808,2023-01-31,,172.54
11248,59855808,2023-02-02,-157.41,15.129999999999995
11249,59855808,2023-02-05,100.23,115.36
11250,59855808,2023-02-06,-204.86,-89.50000000000001
11251,59855808,2023-02-09,53.95,-35.55000000000001
11252,59855808,2023-02-10,-905.0,-940.55
11253,59855808,2023-02-12,-58.39,-998.9399999999999
11254,59855808,2023-02-13,1397.6,398.65999999999997
11255,59855808,2023-02-14,-179.57,219.08999999999997
11256,59867000,2023-01-31,,62.01
11257,59867000,2023-02-02,116.89,178.9
11258,59867000,2023-02-06,110.54,289.44
11259,59867000,2023-02-08,-36.78,252.66
11260,59867000,2023-02-08,-124.32,128.34
11261,59867000,2023-02-12,-845.0,-716.66
11262,59876714,2023-01-31,,938.46
11263,59876714,2023-02-01,469.6,1408.06
11264,59876714,2023-02-02,132.84,1540.9
11265,59876714,2023-02-07,134.11,1675.01
11266,59876714,2023-02-07,-101.89,1573.1200000000001
11267,59876714,2023-02-11,117.41,1690.53
11268,59876714,2023-02-12,-166.15,1524.38
11269,59876714,2023-02-13,-1535.7,-11.319999999999936
11270,59933973,2023-01-31,,29.98
11271,59933973,2023-02-02,-144.06,-114.08
11272,59933973,2023-02-07,-148.28,-262.36
11273,59933973,2023-02-12,65.93,-196.42999999999998
11274,59961433,2023-01-31,,267.05
11275,59961433,2023-02-01,47.33,314.38
11276,59961433,2023-02-01,-177.63,136.75
11277,59961433,2023-02-05,907.1,1043.85
11278,59961433,2023-02-09,-77.09,966.76
11279,59961433,2023-02-14,147.72,1114.48
11280,59980709,2023-01-31,,781.42
11281,59980709,2023-02-01,99.56,880.98
11282,59980709,2023-02-03,-8.49,872.49
11283,59980709,2023-02-06,1194.9,2067.3900000000003
11284,59984692,2023-01-31,,818.03
11285,59984692,2023-02-03,-913.8,-95.76999999999998
11286,59984692,2023-02-05,33.96,-61.80999999999998
11287,59984692,2023-02-05,-111.66,-173.46999999999997
11288,59984692,2023-02-05,-175.68,-349.15
11289,59984692,2023-02-10,119.92,-229.22999999999996
11290,59984692,2023-02-14,7.29,-221.93999999999997
11291,59989722,2023-01-31,,816.77
11292,59989722,2023-02-07,-853.6,-36.83000000000004
11293,59989722,2023-02-09,-78.22,-115.05000000000004
11294,59989722,2023-02-10,672.0,556.9499999999999
11295,60017511,2023-01-31,,859.48
11296,60017511,2023-02-03,41.91,901.39
11297,60017511,2023-02-03,-60.17,841.22
11298,60017511,2023-02-04,1131.3,1972.52
11299,60017511,2023-02-04,-131.11,1841.4099999999999
11300,60017511,2023-02-05,678.7,2520.11
11301,60017511,2023-02-11,1363.6,3883.71
11302,60017511,2023-02-11,56.16,3939.87
11303,60017511,2023-02-13,69.25,4009.12
11304,60114464,2023-01-31,,972.56
11305,60114464,2023-02-03,-43.75,928.81
11306,60114464,2023-02-09,-178.61,750.1999999999999
11307,60114464,2023-02-10,1640.4,2390.6
11308,60114464,2023-02-10,1275.4,3666.0
11309,60114464,2023-02-10,1188.3,4854.3
11310,60114464,2023-02-11,-1777.8,3076.5
11311,60114464,2023-02-13,-153.62,2922.88
11312,60138058,2023-01-31,,686.46
11313,60138058,2023-02-03,113.46,799.9200000000001
11314,60138058,2023-02-04,59.13,859.0500000000001
11315,60138058,2023-02-07,149.99,1009.0400000000001
11316,60138058,2023-02-08,14.01,1023.0500000000001
11317,60138058,2023-02-09,45.0,1068.05
11318,60138058,2023-02-09,-110.11,957.94
11319,60138058,2023-02-10,-97.78,860.1600000000001
11320,60138058,2023-02-10,-1526.7,-666.54
11321,60184250,2023-01-31,,70.89
11322,60184250,2023-02-03,-146.39,-75.49999999999999
11323,60184250,2023-02-04,106.07,30.570000000000007
11324,60184250,2023-02-05,1526.1,1556.6699999999998
11325,60184250,2023-02-06,80.07,1636.7399999999998
11326,60184250,2023-02-09,-73.11,1563.6299999999999
11327,60184250,2023-02-11,-43.44,1520.1899999999998
11328,60184250,2023-02-14,-114.54,1405.6499999999999
11329,60189055,2023-01-31,,814.54
11330,60189055,2023-02-02,71.52,886.06
11331,60189055,2023-02-04,-629.0,257.05999999999995
11332,60189055,2023-02-05,-62.74,194.31999999999994
11333,60189055,2023-02-08,136.06,330.37999999999994
11334,60189055,2023-02-10,160.72,491.0999999999999
11335,60189055,2023-02-12,129.45,620.55
11336,60193174,2023-01-31,,740.53
11337,60193174,2023-02-02,1327.5,2068.0299999999997
11338,60193174,2023-02-04,-108.21,1959.82
11339,60193174,2023-02-04,-204.89,1754.93
11340,60193174,2023-02-05,-27.15,1727.78
11341,60193174,2023-02-10,101.72,1829.5
11342,60193174,2023-02-10,68.91,1898.41
11343,60193174,2023-02-12,-127.05,1771.36
11344,60193174,2023-02-13,51.71,1823.07
11345,60202402,2023-01-31,,783.7
11346,60202402,2023-02-03,-18.28,765.4200000000001
11347,60202402,2023-02-05,-963.3,-197.87999999999988
11348,60202402,2023-02-12,82.91,-114.96999999999989
11349,60202402,2023-02-12,-89.48,-204.44999999999987
11350,60202402,2023-02-12,-89.55,-293.9999999999999
11351,60202402,2023-02-13,789.4,495.4000000000001
11352,60220702,2023-01-31,,937.23
11353,60220702,2023-02-03,-37.49,899.74
11354,60220702,2023-02-05,-102.96,796.78
11355,60220702,2023-02-07,98.61,895.39
11356,60220702,2023-02-10,-76.48,818.9100000000001
11357,60220702,2023-02-12,-128.94,689.97
11358,60222199,2023-01-31,,350.4
11359,60222199,2023-02-08,537.9,888.3
11360,60222199,2023-02-11,83.49,971.79
11361,60222199,2023-02-12,-893.8,77.99000000000001
11362,60238192,2023-01-31,,307.97
11363,60238192,2023-02-02,120.45,428.42
11364,60238192,2023-02-03,-95.05,333.37
11365,60238192,2023-02-05,-62.49,270.88000000000005
11366,60238192,2023-02-12,202.22,473.1
11367,60238192,2023-02-13,-8.94,464.16
11368,60238192,2023-02-14,69.61,533.77
11369,60238192,2023-02-14,58.12,591.89
11370,60367416,2023-01-31,,754.86
11371,60367416,2023-02-03,-164.14,590.72
11372,60367416,2023-02-04,-96.78,493.94000000000005
11373,60367416,2023-02-05,154.98,648.9200000000001
11374,60367416,2023-02-07,-104.75,544.1700000000001
11375,60367416,2023-02-10,76.15,620.32
11376,60367416,2023-02-10,4.42,624.74
11377,60367416,2023-02-11,165.41,790.15
11378,60367416,2023-02-11,51.94,842.09
11379,60371134,2023-01-31,,444.57
11380,60371134,2023-02-04,125.07,569.64
11381,60371134,2023-02-07,93.89,663.53
11382,60371134,2023-02-14,-95.91,567.62
11383,60383549,2023-01-31,,268.15
11384,60383549,2023-02-01,38.67,306.82
11385,60383549,2023-02-06,141.54,448.35999999999996
11386,60383549,2023-02-09,73.11,521.4699999999999
11387,60383549,2023-02-14,131.83,653.3
11388,60417212,2023-01-31,,653.31
11389,60417212,2023-02-01,-69.4,583.91
11390,60417212,2023-02-01,-974.4,-390.49
11391,60417212,2023-02-04,-117.96,-508.45
11392,60417212,2023-02-05,471.4,-37.05000000000001
11393,60417212,2023-02-07,-26.93,-63.98000000000001
11394,60417212,2023-02-09,-9.69,-73.67000000000002
11395,60417212,2023-02-10,-98.96,-172.63
11396,60417212,2023-02-11,134.17,-38.460000000000036
11397,60417212,2023-02-11,104.89,66.42999999999996
11398,60417212,2023-02-12,82.59,149.01999999999998
11399,60417212,2023-02-13,-145.9,3.1199999999999477
11400,60417212,2023-02-14,-151.47,-148.35000000000005
11401,60459342,2023-01-31,,734.15
11402,60459342,2023-02-02,-108.85,625.3
11403,60459342,2023-02-03,-36.57,588.73
11404,60459342,2023-02-07,103.43,692.16
11405,60459342,2023-02-07,77.09,769.25
11406,60459342,2023-02-10,-145.86,623.39
11407,60459342,2023-02-11,-134.17,489.22
11408,60459342,2023-02-12,-134.05,355.16999999999996
11409,60459342,2023-02-13,-30.31,324.86
11410,60522190,2023-01-31,,965.46
11411,60522190,2023-02-02,51.61,1017.07
11412,60522190,2023-02-08,1589.0,2606.07
11413,60522190,2023-02-10,-61.2,2544.8700000000003
11414,60659147,2023-01-31,,323.85
11415,60659147,2023-02-01,-140.1,183.75000000000003
11416,60659147,2023-02-03,-136.92,46.83000000000004
11417,60659147,2023-02-06,98.87,145.70000000000005
11418,60659147,2023-02-10,103.49,249.19000000000005
11419,60659147,2023-02-11,-99.35,149.84000000000003
11420,60659147,2023-02-13,14.32,164.16000000000005
11421,60659147,2023-02-13,-72.13,92.03000000000006
11422,60667043,2023-01-31,,937.62
11423,60667043,2023-02-03,-19.83,917.79
11424,60667043,2023-02-04,-165.76,752.03
11425,60667043,2023-02-04,-861.1,-109.06999999999994
11426,60667043,2023-02-06,-308.7,-417.7699999999999
11427,60667043,2023-02-09,96.08,-321.68999999999994
11428,60667043,2023-02-09,88.81,-232.87999999999994
11429,60667043,2023-02-09,-148.39,-381.2699999999999
11430,60667043,2023-02-11,-1199.0,-1580.27
11431,60667043,2023-02-14,122.9,-1457.37
11432,60684197,2023-01-31,,752.92
11433,60684197,2023-02-03,-179.13,573.79
11434,60684197,2023-02-04,140.43,714.22
11435,60684197,2023-02-06,76.95,791.17
11436,60684197,2023-02-11,60.22,851.39
11437,60684197,2023-02-12,-41.59,809.8
11438,60707792,2023-01-31,,220.35
11439,60707792,2023-02-01,122.51,342.86
11440,60707792,2023-02-01,-126.01,216.85
11441,60707792,2023-02-05,99.42,316.27
11442,60707792,2023-02-06,-154.81,161.45999999999998
11443,60707792,2023-02-14,-56.24,105.21999999999997
11444,60707792,2023-02-14,-159.73,-54.51000000000002
11445,60711202,2023-01-31,,869.92
11446,60711202,2023-02-03,-165.39,704.53
11447,60711202,2023-02-07,-260.82,443.71
11448,60711202,2023-02-08,-191.64,252.07
11449,60711202,2023-02-14,93.66,345.73
11450,60730902,2023-01-31,,243.72
11451,60730902,2023-02-01,-17.61,226.11
11452,60730902,2023-02-02,-85.17,140.94
11453,60730902,2023-02-03,-13.52,127.42
11454,60730902,2023-02-03,-56.31,71.11
11455,60730902,2023-02-03,-67.03,4.079999999999998
11456,60730902,2023-02-06,-44.47,-40.39
11457,60730902,2023-02-10,192.26,151.87
11458,60730902,2023-02-10,-88.33,63.540000000000006
11459,60730902,2023-02-12,-95.07,-31.529999999999987
11460,60751083,2023-01-31,,115.23
11461,60751083,2023-02-04,-129.92,-14.689999999999984
11462,60751083,2023-02-05,129.71,115.02000000000002
11463,60751083,2023-02-05,-23.88,91.14000000000003
11464,60751083,2023-02-07,85.77,176.91000000000003
11465,60751083,2023-02-08,782.7,959.6100000000001
11466,60751083,2023-02-09,96.28,1055.89
11467,60751083,2023-02-10,123.72,1179.6100000000001
11468,60755797,2023-01-31,,207.78
11469,60755797,2023-02-03,-164.56,43.22
11470,60755797,2023-02-07,93.07,136.29
11471,60755797,2023-02-08,-33.32,102.97
11472,60755797,2023-02-12,-16.56,86.41
11473,60755797,2023-02-13,1856.7,1943.1100000000001
11474,60755797,2023-02-14,-64.87,1878.2400000000002
11475,60789634,2023-01-31,,379.4
11476,60789634,2023-02-03,174.25,553.65
11477,60789634,2023-02-05,116.03,669.68
11478,60789634,2023-02-05,65.25,734.93
11479,60789634,2023-02-09,161.02,895.95
11480,60789634,2023-02-12,146.05,1042.0
11481,60789634,2023-02-12,-49.38,992.62
11482,60789634,2023-02-12,-140.82,851.8
11483,60789634,2023-02-13,-78.14,773.66
11484,60819695,2023-01-31,,38.96
11485,60819695,2023-02-03,92.73,131.69
11486,60819695,2023-02-04,-121.97,9.720000000000013
11487,60819695,2023-02-04,-207.89,-198.16999999999996
11488,60819695,2023-02-09,-96.94,-295.10999999999996
11489,60819695,2023-02-11,88.2,-206.90999999999997
11490,60819695,2023-02-14,111.2,-95.70999999999995
11491,60860851,2023-01-31,,17.96
11492,60860851,2023-02-02,-15.19,2.7700000000000014
11493,60860851,2023-02-04,-142.92,-140.14999999999998
11494,60860851,2023-02-07,-1372.5,-1512.65
11495,60860851,2023-02-10,194.97,-1317.68
11496,60860851,2023-02-10,-114.32,-1432.0
11497,60860851,2023-02-10,-152.92,-1584.92
11498,60866500,2023-01-31,,523.13
11499,60866500,2023-02-03,-77.14,445.99
11500,60866500,2023-02-05,-116.03,329.96
11501,60866500,2023-02-06,68.31,398.27
11502,60866500,2023-02-09,-125.74,272.53
11503,60866500,2023-02-11,156.49,429.02
11504,60866500,2023-02-11,-79.43,349.59000000000003
11505,60916657,2023-01-31,,893.41
11506,60916657,2023-02-03,117.51,1010.92
11507,60916657,2023-02-05,-76.57,934.35
11508,60916657,2023-02-06,-56.09,878.26
11509,60916657,2023-02-11,71.24,949.5
11510,60916657,2023-02-12,50.94,1000.4399999999999
11511,60930856,2023-01-31,,445.07
11512,60930856,2023-02-03,-46.85,398.21999999999997
11513,60930856,2023-02-04,-131.69,266.53
11514,60930856,2023-02-07,-52.98,213.55
11515,60930856,2023-02-12,123.5,337.05
11516,60930856,2023-02-12,68.26,405.31
11517,60930856,2023-02-14,64.87,470.18
11518,60955647,2023-01-31,,546.28
11519,60955647,2023-02-11,34.52,580.8
11520,60955647,2023-02-14,126.46,707.26
11521,60966485,2023-01-31,,774.41
11522,60966485,2023-02-01,63.28,837.6899999999999
11523,60966485,2023-02-01,-116.0,721.6899999999999
11524,60966485,2023-02-04,187.19,908.88
11525,60966485,2023-02-05,-151.29,757.5899999999999
11526,60966485,2023-02-06,-193.24,564.3499999999999
11527,60966485,2023-02-07,-56.84,507.51
11528,60966485,2023-02-10,-155.39,352.12
11529,60966485,2023-02-12,57.89,410.01
11530,60966485,2023-02-14,149.95,559.96
11531,60996794,2023-01-31,,27.98
11532,60996794,2023-02-04,63.46,91.44
11533,60996794,2023-02-08,-903.3,-811.8599999999999
11534,60996794,2023-02-11,-66.62,-878.4799999999999
11535,60996794,2023-02-13,-1525.2,-2403.68
11536,61087394,2023-01-31,,112.81
11537,61087394,2023-02-01,121.69,234.5
11538,61087394,2023-02-07,156.4,390.9
11539,61087394,2023-02-07,-38.29,352.61
11540,61087394,2023-02-08,-1621.0,-1268.3899999999999
11541,61087394,2023-02-12,-52.46,-1320.85
11542,61087394,2023-02-13,-101.58,-1422.4299999999998
11543,61087394,2023-02-13,-105.17,-1527.6
11544,61087394,2023-02-14,-1879.5,-3407.1
11545,61101757,2023-01-31,,992.2
11546,61152319,2023-01-31,,471.31
11547,61152319,2023-02-01,-75.45,395.86
11548,61152319,2023-02-04,-82.25,313.61
11549,61152319,2023-02-07,61.01,374.62
11550,61152319,2023-02-08,57.93,432.55
11551,61152319,2023-02-13,-79.81,352.74
11552,61178950,2023-01-31,,104.88
11553,61178950,2023-02-04,79.62,184.5
11554,61178950,2023-02-09,-95.74,88.76
11555,61178950,2023-02-10,150.39,239.14999999999998
11556,61178950,2023-02-13,-1023.0,-783.85
11557,61178950,2023-02-14,-685.5,-1469.35
11558,61181609,2023-01-31,,44.55
11559,61181609,2023-02-01,-146.28,-101.73
11560,61181609,2023-02-03,-321.6,-423.33000000000004
11561,61181609,2023-02-04,-114.54,-537.87
11562,61181609,2023-02-09,-80.63,-618.5
11563,61181609,2023-02-11,-106.62,-725.12
11564,61181609,2023-02-12,-108.99,-834.11
11565,61181609,2023-02-14,-89.9,-924.01
11566,61279456,2023-01-31,,814.3
11567,61279456,2023-02-02,-93.31,720.99
11568,61279456,2023-02-04,133.05,854.04
11569,61279456,2023-02-04,-72.97,781.0699999999999
11570,61279456,2023-02-06,-22.45,758.62
11571,61279456,2023-02-09,-180.82,577.8
11572,61279456,2023-02-11,-94.12,483.67999999999995
11573,61279456,2023-02-12,134.18,617.86
11574,61279456,2023-02-12,-56.08,561.78
11575,61279456,2023-02-12,-81.44,480.34
11576,61279456,2023-02-13,-116.67,363.66999999999996
11577,61279456,2023-02-13,-1406.7,-1043.0300000000002
11578,61419726,2023-01-31,,932.41
11579,61419726,2023-02-02,176.64,1109.05
11580,61419726,2023-02-03,131.74,1240.79
11581,61419726,2023-02-07,-105.53,1135.26
11582,61419726,2023-02-09,-85.81,1049.45
11583,61419726,2023-02-09,-149.64,899.81
11584,61419726,2023-02-10,-213.8,686.01
11585,61423373,2023-01-31,,87.17
11586,61423373,2023-02-09,-411.3,-324.13
11587,61423373,2023-02-10,-655.8,-979.93
11588,61423373,2023-02-11,113.52,-866.41
11589,61450849,2023-01-31,,890.19
11590,61450849,2023-02-01,-646.2,243.99
11591,61450849,2023-02-02,-6.47,237.52
11592,61450849,2023-02-04,-121.04,116.48
11593,61450849,2023-02-06,-133.12,-16.64
11594,61450849,2023-02-07,-54.63,-71.27000000000001
11595,61450849,2023-02-08,94.96,23.689999999999998
11596,61450849,2023-02-08,68.6,92.28999999999999
11597,61450849,2023-02-08,-41.56,50.72999999999999
11598,61493381,2023-01-31,,569.94
11599,61493381,2023-02-01,-12.97,556.97
11600,61493381,2023-02-05,-54.53,502.44000000000005
11601,61493381,2023-02-06,-113.47,388.97
11602,61493381,2023-02-08,-203.33,185.64000000000004
11603,61493381,2023-02-09,-77.58,108.06000000000004
11604,61493381,2023-02-12,-182.63,-74.56999999999995
11605,61493381,2023-02-14,-81.5,-156.06999999999994
11606,61512912,2023-01-31,,328.0
11607,61512912,2023-02-08,-138.88,189.12
11608,61512912,2023-02-11,-38.45,150.67000000000002
11609,61512912,2023-02-11,-165.41,-14.740000000000009
11610,61555609,2023-01-31,,505.76
11611,61555609,2023-02-02,-150.57,355.19
11612,61555609,2023-02-03,-90.12,265.07
11613,61555609,2023-02-09,77.33,342.4
11614,61555609,2023-02-13,1503.2,1845.6
11615,61578713,2023-01-31,,209.89
11616,61578713,2023-02-05,88.55,298.44
11617,61578713,2023-02-05,34.76,333.2
11618,61578713,2023-02-07,-81.64,251.55999999999997
11619,61578713,2023-02-07,-106.48,145.07999999999998
11620,61578713,2023-02-09,-112.05,33.02999999999997
11621,61578713,2023-02-10,-95.62,-62.59000000000003
11622,61582769,2023-01-31,,325.47
11623,61582769,2023-02-02,87.06,412.53000000000003
11624,61582769,2023-02-08,69.56,482.09000000000003
11625,61582769,2023-02-11,-124.32,357.77000000000004
11626,61582769,2023-02-13,-123.64,234.13000000000005
11627,61582769,2023-02-14,167.84,401.97
11628,61593392,2023-01-31,,621.21
11629,61593392,2023-02-10,-92.09,529.12
11630,61593392,2023-02-11,-41.89,487.23
11631,61634340,2023-01-31,,83.85
11632,61634340,2023-02-01,-148.64,-64.78999999999999
11633,61634340,2023-02-03,-60.33,-125.11999999999999
11634,61634340,2023-02-04,-238.96,-364.08
11635,61634340,2023-02-07,-109.13,-473.21000000000004
11636,61634340,2023-02-12,-94.0,-567.21
11637,61634340,2023-02-13,-70.25,-637.46
11638,61642813,2023-01-31,,760.74
11639,61642813,2023-02-02,177.88,938.62
11640,61642813,2023-02-04,-73.67,864.95
11641,61642813,2023-02-10,221.22,1086.17
11642,61642813,2023-02-13,81.39,1167.56
11643,61642813,2023-02-13,-68.67,1098.89
11644,61644310,2023-01-31,,709.97
11645,61644310,2023-02-04,-72.42,637.5500000000001
11646,61644310,2023-02-05,-89.72,547.83
11647,61644310,2023-02-06,-110.71,437.12
11648,61644310,2023-02-08,-106.37,330.75
11649,61644310,2023-02-13,136.4,467.15000000000003
11650,61644310,2023-02-13,87.58,554.73
11651,61649729,2023-01-31,,848.76
11652,61649729,2023-02-03,-26.28,822.48
11653,61649729,2023-02-07,156.28,978.76
11654,61649729,2023-02-10,149.53,1128.29
11655,61661386,2023-01-31,,524.42
11656,61661386,2023-02-07,-125.96,398.46
11657,61661386,2023-02-11,-126.05,272.40999999999997
11658,61676204,2023-01-31,,88.85
11659,61676204,2023-02-04,134.22,223.07
11660,61676204,2023-02-04,90.09,313.15999999999997
11661,61676204,2023-02-04,-75.65,237.51
11662,61676204,2023-02-06,-43.35,194.16
11663,61676204,2023-02-07,-7.57,186.58999999999997
11664,61676204,2023-02-09,49.06,235.64999999999998
11665,61676204,2023-02-13,89.3,324.95
11666,61682186,2023-01-31,,959.96
11667,61682186,2023-02-02,154.85,1114.81
11668,61682186,2023-02-10,-26.43,1088.38
11669,61682186,2023-02-10,-99.28,989.1
11670,61682186,2023-02-11,659.5,1648.6
11671,61682186,2023-02-12,-19.98,1628.6200000000001
11672,61682186,2023-02-12,-61.6,1567.02
11673,61682186,2023-02-13,1132.5,2699.52
11674,61687835,2023-01-31,,739.0
11675,61687835,2023-02-03,147.6,886.6
11676,61687835,2023-02-03,-102.16,784.44
11677,61687835,2023-02-06,-163.9,620.54
11678,61687835,2023-02-06,-561.3,59.24000000000001
11679,61687835,2023-02-08,56.13,115.37
11680,61687835,2023-02-08,9.19,124.56000000000002
11681,61687835,2023-02-09,652.0,776.5600000000001
11682,61687835,2023-02-10,-212.1,564.46
11683,61687835,2023-02-11,165.77,730.23
11684,61687835,2023-02-11,142.29,872.5200000000001
11685,61687835,2023-02-12,62.63,935.1500000000001
11686,61720005,2023-01-31,,687.35
11687,61720005,2023-02-02,-49.63,637.72
11688,61720005,2023-02-03,-75.28,562.44
11689,61720005,2023-02-05,72.33,634.77
11690,61720005,2023-02-05,-0.49,634.28
11691,61720005,2023-02-08,-107.47,526.8100000000001
11692,61720005,2023-02-09,105.86,632.6700000000001
11693,61720005,2023-02-10,-204.71,427.96000000000004
11694,61720005,2023-02-12,-50.65,377.31000000000006
11695,61720005,2023-02-13,-38.26,339.05000000000007
11696,61724951,2023-01-31,,656.25
11697,61724951,2023-02-03,33.4,689.65
11698,61724951,2023-02-07,-99.73,589.92
11699,61724951,2023-02-08,-69.75,520.17
11700,61724951,2023-02-09,139.86,660.03
11701,61724951,2023-02-09,65.77,725.8
11702,61724951,2023-02-10,107.4,833.2
11703,61724951,2023-02-12,207.6,1040.8
11704,61724951,2023-02-13,-1127.3,-86.5
11705,61781801,2023-01-31,,699.78
11706,61781801,2023-02-03,71.27,771.05
11707,61781801,2023-02-07,182.27,953.3199999999999
11708,61781801,2023-02-07,-84.97,868.35
11709,61781801,2023-02-08,1428.0,2296.35
11710,61781801,2023-02-08,1051.4,3347.75
11711,61781801,2023-02-09,49.68,3397.43
11712,61781801,2023-02-14,81.5,3478.93
11713,61847987,2023-01-31,,874.22
11714,61847987,2023-02-04,75.65,949.87
11715,61847987,2023-02-06,-86.9,862.97
11716,61847987,2023-02-08,-2017.7,-1154.73
11717,61847987,2023-02-11,-89.18,-1243.91
11718,61847987,2023-02-14,67.85,-1176.06
11719,61860337,2023-01-31,,892.77
11720,61860337,2023-02-05,-97.37,795.4
11721,61860337,2023-02-06,64.67,860.0699999999999
11722,61860337,2023-02-07,-132.98,727.0899999999999
11723,61860337,2023-02-09,-1679.2,-952.1100000000001
11724,61860337,2023-02-11,107.49,-844.6200000000001
11725,61860337,2023-02-12,-102.73,-947.3500000000001
11726,61884944,2023-01-31,,123.93
11727,61884944,2023-02-03,156.2,280.13
11728,61884944,2023-02-03,96.42,376.55
11729,61884944,2023-02-04,189.33,565.88
11730,61884944,2023-02-05,-997.4,-431.52
11731,61884944,2023-02-08,193.89,-237.63
11732,61884944,2023-02-10,-106.29,-343.92
11733,61884944,2023-02-12,985.9,641.98
11734,61884944,2023-02-14,131.36,773.3399999999999
11735,61941956,2023-01-31,,137.19
11736,61941956,2023-02-03,-48.48,88.71000000000001
11737,61941956,2023-02-04,-64.48,24.22999999999999
11738,61941956,2023-02-09,52.73,76.95999999999998
11739,61941956,2023-02-09,-181.01,-104.05000000000001
11740,61979134,2023-01-31,,574.77
11741,61979134,2023-02-03,-15.12,559.65
11742,61979134,2023-02-03,-106.43,453.21999999999997
11743,61979134,2023-02-04,-101.39,351.83
11744,61979134,2023-02-09,143.27,495.09999999999997
11745,61999896,2023-01-31,,788.63
11746,61999896,2023-02-05,1475.4,2264.03
11747,61999896,2023-02-05,106.71,2370.7400000000002
11748,61999896,2023-02-06,739.3,3110.04
11749,61999896,2023-02-06,-63.49,3046.55
11750,61999896,2023-02-06,-123.77,2922.78
11751,61999896,2023-02-08,51.04,2973.82
11752,61999896,2023-02-11,510.2,3484.0200000000004
11753,61999896,2023-02-11,132.76,3616.78
11754,61999896,2023-02-13,137.58,3754.36
11755,62077439,2023-01-31,,333.47
11756,62077439,2023-02-01,345.3,678.77
11757,62077439,2023-02-05,-166.03,512.74
11758,62077439,2023-02-06,-96.82,415.9200000000001
11759,62077439,2023-02-07,110.79,526.71
11760,62077439,2023-02-08,-123.3,403.4100000000001
11761,62077439,2023-02-09,-121.95,281.46000000000004
11762,62077439,2023-02-10,-958.6,-677.14
11763,62077439,2023-02-12,491.6,-185.53999999999996
11764,62141083,2023-01-31,,17.63
11765,62141083,2023-02-02,104.03,121.66
11766,62141083,2023-02-05,168.21,289.87
11767,62141083,2023-02-07,94.93,384.8
11768,62141083,2023-02-11,-46.65,338.15000000000003
11769,62141083,2023-02-13,-113.41,224.74
11770,62147353,2023-01-31,,783.96
11771,62147353,2023-02-04,-65.13,718.83
11772,62147353,2023-02-10,54.73,773.5600000000001
11773,62147353,2023-02-12,109.65,883.21
11774,62147353,2023-02-12,-31.75,851.46
11775,62147353,2023-02-14,-144.85,706.61
11776,62158499,2023-01-31,,581.72
11777,62158499,2023-02-02,89.46,671.1800000000001
11778,62158499,2023-02-04,89.95,761.13
11779,62158499,2023-02-05,-821.8,-60.66999999999996
11780,62158499,2023-02-08,163.95,103.28000000000003
11781,62158499,2023-02-11,-121.47,-18.18999999999997
11782,62158499,2023-02-13,104.56,86.37000000000003
11783,62158499,2023-02-13,-17.92,68.45000000000003
11784,62158499,2023-02-13,-901.5,-833.05
11785,62191488,2023-01-31,,652.76
11786,62191488,2023-02-01,115.85,768.61
11787,62191488,2023-02-01,-79.2,689.41
11788,62191488,2023-02-03,115.62,805.03
11789,62191488,2023-02-08,14.52,819.55
11790,62191488,2023-02-09,112.76,932.31
11791,62191488,2023-02-09,-4.38,927.93
11792,62213525,2023-01-31,,45.68
11793,62213525,2023-02-01,948.2,993.88
11794,62213525,2023-02-04,-143.01,850.87
11795,62213525,2023-02-04,-1702.7,-851.83
11796,62213525,2023-02-07,336.2,-515.6300000000001
11797,62213525,2023-02-07,-139.96,-655.59
11798,62213525,2023-02-10,90.86,-564.73
11799,62213525,2023-02-10,-114.59,-679.32
11800,62222306,2023-01-31,,304.45
11801,62222306,2023-02-02,-108.46,195.99
11802,62222306,2023-02-03,-60.47,135.51999999999998
11803,62222306,2023-02-03,-89.93,45.58999999999999
11804,62222306,2023-02-04,-1639.2,-1593.6100000000001
11805,62222306,2023-02-10,-9.75,-1603.3600000000001
11806,62227017,2023-01-31,,177.72
11807,62227017,2023-02-02,128.31,306.03
11808,62227017,2023-02-09,-112.93,193.1
11809,62227017,2023-02-13,122.16,315.26
11810,62251465,2023-01-31,,304.55
11811,62251465,2023-02-01,-96.35,208.20000000000002
11812,62251465,2023-02-02,15.44,223.64000000000001
11813,62251465,2023-02-06,187.58,411.22
11814,62251465,2023-02-07,37.9,449.12
11815,62251465,2023-02-07,-195.55,253.57000000000002
11816,62251465,2023-02-11,127.25,380.82000000000005
11817,62256127,2023-01-31,,784.39
11818,62256127,2023-02-05,-151.27,633.12
11819,62256127,2023-02-07,134.55,767.67
11820,62256127,2023-02-09,-137.44,630.23
11821,62256127,2023-02-11,-100.94,529.29
11822,62256127,2023-02-11,-1363.6,-834.31
11823,62256127,2023-02-12,-1491.7,-2326.01
11824,62276269,2023-01-31,,575.1
11825,62276269,2023-02-02,-142.26,432.84000000000003
11826,62276269,2023-02-04,-126.83,306.01000000000005
11827,62276269,2023-02-08,50.71,356.72
11828,62289297,2023-01-31,,802.44
11829,62289297,2023-02-11,-157.6,644.84
11830,62320219,2023-01-31,,178.4
11831,62320219,2023-02-05,141.51,319.90999999999997
11832,62320219,2023-02-05,112.45,432.36
11833,62320219,2023-02-05,-49.95,382.40999999999997
11834,62320219,2023-02-08,47.37,429.78
11835,62332278,2023-01-31,,970.66
11836,62332278,2023-02-01,119.74,1090.3999999999999
11837,62332278,2023-02-07,-32.06,1058.34
11838,62332278,2023-02-07,-83.68,974.66
11839,62332278,2023-02-10,-145.13,829.53
11840,62332278,2023-02-12,166.15,995.68
11841,62332278,2023-02-12,58.63,1054.31
11842,62332278,2023-02-13,181.54,1235.85
11843,62362650,2023-01-31,,650.79
11844,62362650,2023-02-01,129.83,780.62
11845,62362650,2023-02-01,-466.7,313.91999999999996
11846,62362650,2023-02-05,118.78,432.69999999999993
11847,62362650,2023-02-05,62.8,495.49999999999994
11848,62362650,2023-02-06,-133.3,362.19999999999993
11849,62362650,2023-02-08,191.5,553.6999999999999
11850,62362650,2023-02-08,162.63,716.3299999999999
11851,62362650,2023-02-08,138.18,854.51
11852,62362650,2023-02-08,-85.01,769.4999999999999
11853,62362650,2023-02-11,67.06,836.56
11854,62362650,2023-02-11,-114.77,721.79
11855,62362650,2023-02-13,80.64,802.43
11856,62412215,2023-01-31,,766.15
11857,62412215,2023-02-02,-89.46,676.6899999999999
11858,62412215,2023-02-03,-89.33,587.36
11859,62412215,2023-02-06,1011.5,1598.8600000000001
11860,62412215,2023-02-06,96.82,1695.68
11861,62412215,2023-02-07,-97.95,1597.73
11862,62412215,2023-02-12,1278.9,2876.63
11863,62414886,2023-01-31,,489.04
11864,62414886,2023-02-02,-107.51,381.53000000000003
11865,62414886,2023-02-06,-63.36,318.17
11866,62414886,2023-02-06,-72.35,245.82000000000002
11867,62414886,2023-02-09,-50.28,195.54000000000002
11868,62414886,2023-02-09,-89.43,106.11000000000001
11869,62414886,2023-02-11,-74.36,31.750000000000014
11870,62414886,2023-02-11,-159.77,-128.01999999999998
11871,62414886,2023-02-12,-126.93,-254.95000000000002
11872,62414886,2023-02-13,-132.93,-387.88
11873,62414886,2023-02-13,-789.4,-1177.28
11874,62470872,2023-01-31,,436.81
11875,62470872,2023-02-03,-81.28,355.53
11876,62470872,2023-02-06,78.94,434.47
11877,62470872,2023-02-11,60.09,494.56
11878,62470872,2023-02-13,101.09,595.65
11879,62470872,2023-02-14,-140.8,454.85
11880,62477219,2023-01-31,,715.67
11881,62477219,2023-02-08,-99.5,616.17
11882,62511159,2023-01-31,,347.79
11883,62511159,2023-02-08,-123.12,224.67000000000002
11884,62511159,2023-02-09,33.68,258.35
11885,62511159,2023-02-10,5.2,263.55
11886,62567104,2023-01-31,,53.95
11887,62567104,2023-02-01,-124.73,-70.78
11888,62567104,2023-02-04,-152.48,-223.26
11889,62567104,2023-02-08,-190.37,-413.63
11890,62567104,2023-02-14,113.47,-300.15999999999997
11891,62580854,2023-01-31,,421.59
11892,62580854,2023-02-05,114.23,535.8199999999999
11893,62580854,2023-02-07,-199.97,335.84999999999997
11894,62584374,2023-01-31,,334.08
11895,62584374,2023-02-01,130.11,464.19
11896,62584374,2023-02-05,-101.23,362.96
11897,62584374,2023-02-06,30.38,393.34
11898,62584374,2023-02-12,-518.5,-125.16000000000003
11899,62584374,2023-02-14,-126.17,-251.33000000000004
11900,62671957,2023-01-31,,168.03
11901,62671957,2023-02-01,96.51,264.54
11902,62671957,2023-02-07,101.36,365.9
11903,62671957,2023-02-07,-126.74,239.16000000000003
11904,62671957,2023-02-08,119.16,358.32
11905,62671957,2023-02-09,58.59,416.91
11906,62671957,2023-02-11,1454.9,1871.8100000000002
11907,62671957,2023-02-12,96.6,1968.41
11908,62671957,2023-02-12,-51.66,1916.7500000000002
11909,62716405,2023-01-31,,531.19
11910,62716405,2023-02-02,84.59,615.7800000000001
11911,62716405,2023-02-03,98.24,714.0200000000001
11912,62716405,2023-02-06,15.22,729.24
11913,62716405,2023-02-14,68.51,797.75
11914,62746004,2023-01-31,,638.36
11915,62746004,2023-02-10,97.09,735.45
11916,62746004,2023-02-11,113.8,849.25
11917,62756075,2023-01-31,,896.87
11918,62756075,2023-02-03,436.5,1333.37
11919,62756075,2023-02-03,10.53,1343.9
11920,62756075,2023-02-05,-61.84,1282.06
11921,62756075,2023-02-06,-11.94,1270.12
11922,62756075,2023-02-08,14.84,1284.96
11923,62756075,2023-02-10,-355.2,929.76
11924,62756075,2023-02-12,196.98,1126.74
11925,62756075,2023-02-13,142.99,1269.73
11926,62780588,2023-01-31,,828.86
11927,62780588,2023-02-03,-534.6,294.26
11928,62780588,2023-02-04,72.53,366.78999999999996
11929,62780588,2023-02-06,62.08,428.87
11930,62780588,2023-02-08,106.62,535.49
11931,62780588,2023-02-08,41.57,577.06
11932,62780588,2023-02-10,109.89,686.95
11933,62780588,2023-02-11,663.1,1350.05
11934,62780588,2023-02-12,-233.91,1116.1399999999999
11935,62862427,2023-01-31,,545.14
11936,62862427,2023-02-01,-176.41,368.73
11937,62862427,2023-02-05,19.27,388.0
11938,62862427,2023-02-06,1069.9,1457.9
11939,62862427,2023-02-06,-70.55,1387.3500000000001
11940,62862427,2023-02-10,76.48,1463.8300000000002
11941,62862427,2023-02-11,89.55,1553.38
11942,62862427,2023-02-11,-101.6,1451.7800000000002
11943,62862427,2023-02-13,1756.0,3207.78
11944,62862427,2023-02-14,-76.49,3131.2900000000004
11945,63014981,2023-01-31,,222.98
11946,63014981,2023-02-05,-42.25,180.73
11947,63014981,2023-02-09,-26.32,154.41
11948,63014981,2023-02-09,-132.48,21.930000000000007
11949,63057168,2023-01-31,,159.71
11950,63057168,2023-02-02,104.5,264.21000000000004
11951,63057168,2023-02-09,-16.12,248.09
11952,63057168,2023-02-10,142.78,390.87
11953,63057168,2023-02-10,-92.49,298.38
11954,63102647,2023-01-31,,665.14
11955,63102647,2023-02-01,77.81,742.95
11956,63102647,2023-02-04,76.44,819.39
11957,63102647,2023-02-04,-109.76,709.63
11958,63102647,2023-02-07,113.01,822.64
11959,63102647,2023-02-07,79.0,901.64
11960,63102647,2023-02-07,32.06,933.7
11961,63102647,2023-02-07,-20.07,913.63
11962,63102647,2023-02-09,58.71,972.34
11963,63102647,2023-02-09,-124.1,848.24
11964,63102647,2023-02-11,158.35,1006.5899999999999
11965,63102647,2023-02-11,-152.0,854.5899999999999
11966,63232279,2023-01-31,,931.78
11967,63232279,2023-02-01,118.27,1050.05
11968,63232279,2023-02-02,129.83,1179.88
11969,63232279,2023-02-02,-159.22,1020.66
11970,63232279,2023-02-03,640.4,1661.06
11971,63232279,2023-02-03,-2285.6,-624.54
11972,63232279,2023-02-07,-146.5,-771.04
11973,63232279,2023-02-08,56.83,-714.2099999999999
11974,63232279,2023-02-09,-125.05,-839.26
11975,63232279,2023-02-11,125.55,-713.7099999999999
11976,63232279,2023-02-11,-36.36,-750.0699999999999
11977,63265361,2023-01-31,,935.22
11978,63265361,2023-02-02,-884.3,50.92000000000007
11979,63265361,2023-02-03,96.77,147.69000000000005
11980,63265361,2023-02-05,949.6,1097.29
11981,63265361,2023-02-07,-135.72,961.57
11982,63265361,2023-02-08,-132.99,828.58
11983,63265361,2023-02-10,29.92,858.5000000000001
11984,63265361,2023-02-12,136.93,995.4300000000001
11985,63280767,2023-01-31,,836.58
11986,63280767,2023-02-02,58.65,895.23
11987,63280767,2023-02-03,43.75,938.98
11988,63280767,2023-02-05,-159.79,779.19
11989,63280767,2023-02-07,-852.6,-73.40999999999997
11990,63280767,2023-02-10,79.87,6.460000000000036
11991,63280767,2023-02-14,66.56,73.02000000000004
11992,63298193,2023-01-31,,259.55
11993,63298193,2023-02-08,1374.1,1633.6499999999999
11994,63298193,2023-02-08,1360.9,2994.55
11995,63298193,2023-02-11,45.02,3039.57
11996,63298193,2023-02-12,1111.4,4150.97
11997,63301094,2023-01-31,,532.03
11998,63301094,2023-02-03,-159.23,372.79999999999995
11999,63301094,2023-02-04,25.82,398.62
12000,63301094,2023-02-06,1204.5,1603.12
12001,63301094,2023-02-07,-93.91,1509.2099999999998
12002,63301094,2023-02-10,116.53,1625.7399999999998
12003,63301094,2023-02-10,-5.2,1620.54
12004,63301094,2023-02-11,-130.33,1490.2099999999998
12005,63381038,2023-01-31,,541.91
12006,63381038,2023-02-08,69.06,610.97
12007,63381038,2023-02-13,151.93,762.9
12008,63405199,2023-01-31,,18.35
12009,63405199,2023-02-07,102.26,120.61000000000001
12010,63405199,2023-02-07,-178.2,-57.589999999999975
12011,63405199,2023-02-07,-229.29,-286.88
12012,63405199,2023-02-09,226.54,-60.339999999999975
12013,63405199,2023-02-11,75.1,14.76000000000002
12014,63405199,2023-02-14,-18.62,-3.8599999999999817
12015,63405199,2023-02-14,-71.12,-74.97999999999999
12016,63412767,2023-01-31,,715.41
12017,63412767,2023-02-03,-18.62,696.79
12018,63412767,2023-02-03,-87.36,609.43
12019,63412767,2023-02-03,-153.0,456.42999999999995
12020,63412767,2023-02-05,62.56,518.99
12021,63412767,2023-02-05,-53.81,465.17999999999995
12022,63412767,2023-02-05,-146.21,318.9699999999999
12023,63412767,2023-02-09,128.5,447.4699999999999
12024,63412767,2023-02-11,54.29,501.75999999999993
12025,63412767,2023-02-13,-99.37,402.38999999999993
12026,63486424,2023-01-31,,531.83
12027,63486424,2023-02-04,-0.23,531.6
12028,63486424,2023-02-05,167.77,699.3700000000001
12029,63486424,2023-02-07,92.8,792.1700000000001
12030,63486424,2023-02-10,-55.17,737.0
12031,63486424,2023-02-12,-1224.6,-487.5999999999999
12032,63534397,2023-01-31,,451.25
12033,63534397,2023-02-03,-590.1,-138.85000000000002
12034,63534397,2023-02-06,109.59,-29.26000000000002
12035,63534397,2023-02-07,87.03,57.76999999999998
12036,63534397,2023-02-11,-873.9,-816.13
12037,63556863,2023-01-31,,634.4
12038,63556863,2023-02-01,-0.5,633.9
12039,63556863,2023-02-02,-102.25,531.65
12040,63556863,2023-02-03,130.91,662.56
12041,63556863,2023-02-05,-125.17,537.39
12042,63556863,2023-02-06,1124.1,1661.4899999999998
12043,63556863,2023-02-06,-104.85,1556.6399999999999
12044,63556863,2023-02-08,1127.4,2684.04
12045,63556863,2023-02-09,83.38,2767.42
12046,63556863,2023-02-09,60.16,2827.58
12047,63556863,2023-02-11,-213.76,2613.82
12048,63569270,2023-01-31,,949.8
12049,63569270,2023-02-07,-120.5,829.3
12050,63569270,2023-02-10,30.02,859.3199999999999
12051,63569270,2023-02-11,-1231.3,-371.98
12052,63635633,2023-01-31,,202.35
12053,63635633,2023-02-07,123.36,325.71
12054,63635633,2023-02-09,109.51,435.22
12055,63635633,2023-02-10,-60.41,374.81
12056,63635633,2023-02-13,-74.51,300.3
12057,63714888,2023-01-31,,632.75
12058,63714888,2023-02-01,77.55,710.3
12059,63714888,2023-02-04,-109.43,600.87
12060,63714888,2023-02-04,-523.6,77.26999999999998
12061,63714888,2023-02-11,174.19,251.45999999999998
12062,63714888,2023-02-12,-207.81,43.64999999999998
12063,63714888,2023-02-12,-1143.7,-1100.0500000000002
12064,63714888,2023-02-13,44.57,-1055.48
12065,63714888,2023-02-14,-80.39,-1135.87
12066,63746530,2023-01-31,,874.63
12067,63746530,2023-02-05,986.7,1861.33
12068,63746530,2023-02-06,-57.25,1804.08
12069,63746530,2023-02-07,764.7,2568.78
12070,63746530,2023-02-09,1705.6,4274.38
12071,63746530,2023-02-09,-116.81,4157.57
12072,63746530,2023-02-12,94.08,4251.650000000001
12073,63746530,2023-02-12,-151.29,4100.360000000001
12074,63746530,2023-02-14,150.33,4250.6900000000005
12075,63845700,2023-01-31,,856.95
12076,63845700,2023-02-02,-184.44,672.51
12077,63845700,2023-02-04,-168.29,504.22
12078,63845700,2023-02-06,-59.16,445.06000000000006
12079,63845700,2023-02-09,1606.6,2051.66
12080,63845700,2023-02-11,126.05,2177.71
12081,63845700,2023-02-12,75.56,2253.27
12082,63863096,2023-01-31,,819.23
12083,63863096,2023-02-05,-148.09,671.14
12084,63863096,2023-02-08,167.77,838.9100000000001
12085,63863096,2023-02-08,-72.17,766.74
12086,63959769,2023-01-31,,938.58
12087,63959769,2023-02-03,112.46,1051.04
12088,63959769,2023-02-08,-147.81,903.23
12089,63959769,2023-02-09,48.6,951.83
12090,63959769,2023-02-10,54.78,1006.61
12091,63959769,2023-02-12,-541.9,464.71000000000004
12092,63977699,2023-01-31,,140.44
12093,63977699,2023-02-08,-156.53,-16.090000000000003
12094,63977699,2023-02-10,-60.14,-76.23
12095,63977699,2023-02-11,207.88,131.64999999999998
12096,63977699,2023-02-11,90.03,221.67999999999998
12097,64034275,2023-01-31,,609.61
12098,64034275,2023-02-01,42.27,651.88
12099,64034275,2023-02-01,-55.09,596.79
12100,64034275,2023-02-01,-71.89,524.9
12101,64034275,2023-02-10,-84.47,440.43
12102,64034275,2023-02-11,135.48,575.91
12103,64034275,2023-02-11,99.93,675.84
12104,64034275,2023-02-12,69.44,745.28
12105,64034275,2023-02-12,66.35,811.63
12106,64065043,2023-01-31,,245.44
12107,64065043,2023-02-06,78.47,323.90999999999997
12108,64065043,2023-02-06,67.45,391.36
12109,64065043,2023-02-10,95.62,486.98
12110,64065043,2023-02-13,1619.8,2106.7799999999997
12111,64065043,2023-02-13,47.82,2154.6
12112,64093529,2023-01-31,,748.57
12113,64093529,2023-02-02,131.15,879.72
12114,64093529,2023-02-03,151.73,1031.45
12115,64093529,2023-02-08,155.62,1187.0700000000002
12116,64093529,2023-02-10,93.29,1280.3600000000001
12117,64108699,2023-01-31,,71.97
12118,64108699,2023-02-02,-50.83,21.14
12119,64108699,2023-02-02,-190.87,-169.73000000000002
12120,64108699,2023-02-07,-116.74,-286.47
12121,64108699,2023-02-08,120.11,-166.36
12122,64108699,2023-02-08,-83.5,-249.86
12123,64108699,2023-02-09,-34.17,-284.03000000000003
12124,64108699,2023-02-10,111.68,-172.35000000000002
12125,64108699,2023-02-10,-202.69,-375.04
12126,64108699,2023-02-14,241.71,-133.33
12127,64123632,2023-01-31,,358.39
12128,64123632,2023-02-03,131.87,490.26
12129,64123632,2023-02-06,54.05,544.31
12130,64123632,2023-02-07,993.9,1538.21
12131,64123632,2023-02-07,24.34,1562.55
12132,64123632,2023-02-10,-193.16,1369.3899999999999
12133,64123632,2023-02-12,85.39,1454.78
12134,64160490,2023-01-31,,222.89
12135,64160490,2023-02-02,115.12,338.01
12136,64160490,2023-02-03,146.33,484.34000000000003
12137,64160490,2023-02-03,-228.59,255.75
12138,64160490,2023-02-05,-62.88,192.87
12139,64160490,2023-02-09,-74.87,118.0
12140,64160490,2023-02-10,11.9,129.9
12141,64160490,2023-02-12,18.96,148.86
12142,64160490,2023-02-13,-133.53,15.329999999999984
12143,64160490,2023-02-13,-162.92,-147.59
12144,64160490,2023-02-14,173.88,26.289999999999992
12145,64160490,2023-02-14,85.5,111.78999999999999
12146,64160490,2023-02-14,-122.9,-11.110000000000014
12147,64167315,2023-01-31,,145.11
12148,64167315,2023-02-05,69.19,214.3
12149,64167315,2023-02-06,99.27,313.57
12150,64167315,2023-02-13,59.69,373.26
12151,64167315,2023-02-14,-165.55,207.70999999999998
12152,64168292,2023-01-31,,297.09
12153,64168292,2023-02-03,111.84,408.92999999999995
12154,64168292,2023-02-03,-129.36,279.56999999999994
12155,64168292,2023-02-04,101.49,381.05999999999995
12156,64168292,2023-02-06,-59.58,321.47999999999996
12157,64168292,2023-02-08,132.61,454.09
12158,64168292,2023-02-08,-164.35,289.74
12159,64168292,2023-02-10,25.17,314.90999999999997
12160,64168292,2023-02-10,-182.87,132.03999999999996
12161,64168292,2023-02-13,169.97,302.01
12162,64168292,2023-02-14,1323.7,1625.71
12163,64177019,2023-01-31,,298.31
12164,64177019,2023-02-04,-76.94,221.37
12165,64177019,2023-02-05,-17.88,203.49
12166,64177019,2023-02-06,-89.28,114.21000000000001
12167,64177019,2023-02-09,101.53,215.74
12168,64177019,2023-02-10,116.06,331.8
12169,64177019,2023-02-10,-101.58,230.22000000000003
12170,64226824,2023-01-31,,794.79
12171,64226824,2023-02-05,-112.69,682.0999999999999
12172,64226824,2023-02-11,-104.89,577.2099999999999
12173,64228624,2023-01-31,,508.14
12174,64228624,2023-02-02,-150.88,357.26
12175,64228624,2023-02-04,126.18,483.44
12176,64228624,2023-02-05,110.97,594.41
12177,64228624,2023-02-09,-85.88,508.53
12178,64228624,2023-02-10,93.74,602.27
12179,64228624,2023-02-10,-110.41,491.86
12180,64228624,2023-02-12,1153.9,1645.7600000000002
12181,64237458,2023-01-31,,255.48
12182,64237458,2023-02-01,-75.62,179.85999999999999
12183,64237458,2023-02-02,-55.08,124.77999999999999
12184,64237458,2023-02-05,1295.5,1420.28
12185,64237458,2023-02-05,103.17,1523.45
12186,64237458,2023-02-06,55.36,1578.81
12187,64237458,2023-02-06,-178.82,1399.99
12188,64237458,2023-02-09,-158.77,1241.22
12189,64237458,2023-02-10,59.81,1301.03
12190,64237458,2023-02-10,-672.0,629.03
12191,64237458,2023-02-11,2.2,631.23
12192,64237458,2023-02-12,133.51,764.74
12193,64237458,2023-02-12,-69.4,695.3399999999999
12194,64237458,2023-02-14,105.98,801.3199999999999
12195,64299012,2023-01-31,,509.56
12196,64299012,2023-02-01,128.83,638.39
12197,64299012,2023-02-05,90.59,728.98
12198,64299012,2023-02-06,-47.53,681.45
12199,64299012,2023-02-08,129.37,810.82
12200,64299012,2023-02-10,-20.93,789.89
12201,64299012,2023-02-12,-114.77,675.12
12202,64299012,2023-02-14,146.71,821.83
12203,64299012,2023-02-14,-2620.1,-1798.27
12204,64300289,2023-01-31,,472.59
12205,64300289,2023-02-02,-118.23,354.35999999999996
12206,64300289,2023-02-05,29.05,383.40999999999997
12207,64300289,2023-02-06,-78.61,304.79999999999995
12208,64300289,2023-02-09,168.03,472.83
12209,64300289,2023-02-10,-108.85,363.98
12210,64300289,2023-02-12,-66.55,297.43
12211,64300289,2023-02-12,-73.94,223.49
12212,64303157,2023-01-31,,698.38
12213,64303157,2023-02-01,-9.32,689.06
12214,64303157,2023-02-06,-128.12,560.94
12215,64303157,2023-02-07,96.55,657.49
12216,64303157,2023-02-08,1737.4,2394.8900000000003
12217,64305805,2023-01-31,,181.46
12218,64305805,2023-02-01,126.64,308.1
12219,64305805,2023-02-04,-1649.2,-1341.1
12220,64305805,2023-02-05,-100.57,-1441.67
12221,64305805,2023-02-07,-153.3,-1594.9700000000003
12222,64305805,2023-02-11,102.91,-1492.0600000000002
12223,64305805,2023-02-13,-73.97,-1566.0300000000002
12224,64331821,2023-01-31,,519.62
12225,64331821,2023-02-05,-145.08,374.53999999999996
12226,64331821,2023-02-07,16.72,391.26
12227,64331821,2023-02-09,897.0,1288.26
12228,64331821,2023-02-11,-104.39,1183.87
12229,64331821,2023-02-11,-148.32,1035.55
12230,64331821,2023-02-14,479.9,1515.45
12231,64402841,2023-01-31,,751.76
12232,64402841,2023-02-01,-61.08,690.68
12233,64402841,2023-02-05,109.7,800.38
12234,64402841,2023-02-07,-133.09,667.29
12235,64402841,2023-02-11,93.58,760.87
12236,64402841,2023-02-12,-1411.1,-650.2299999999999
12237,64402841,2023-02-13,52.19,-598.04
12238,64411319,2023-01-31,,619.06
12239,64411319,2023-02-06,128.12,747.18
12240,64411319,2023-02-08,-128.28,618.9
12241,64411319,2023-02-10,-58.75,560.15
12242,64411319,2023-02-11,124.56,684.7099999999999
12243,64411319,2023-02-11,96.47,781.18
12244,64460080,2023-01-31,,313.37
12245,64460080,2023-02-01,-85.99,227.38
12246,64460080,2023-02-02,-61.09,166.29000000000002
12247,64460080,2023-02-03,-119.02,47.27000000000001
12248,64460080,2023-02-03,-156.41,-109.13999999999999
12249,64460080,2023-02-10,191.56,82.42000000000002
12250,64462046,2023-01-31,,847.04
12251,64462046,2023-02-07,-1392.7,-545.6600000000001
12252,64462046,2023-02-10,83.79,-461.87000000000006
12253,64462046,2023-02-10,-715.5,-1177.3700000000001
12254,64486954,2023-01-31,,378.0
12255,64486954,2023-02-05,57.18,435.18
12256,64486954,2023-02-05,-1685.4,-1250.22
12257,64486954,2023-02-08,-117.41,-1367.63
12258,64486954,2023-02-11,-1454.9,-2822.53
12259,64526097,2023-01-31,,491.42
12260,64526097,2023-02-02,61.97,553.39
12261,64526097,2023-02-03,140.51,693.9
12262,64526097,2023-02-04,46.96,740.86
12263,64526097,2023-02-10,-67.56,673.3
12264,64526097,2023-02-11,138.99,812.29
12265,64526097,2023-02-12,28.57,840.86
12266,64526097,2023-02-13,157.41,998.27
12267,64533535,2023-01-31,,535.88
12268,64533535,2023-02-03,-108.5,427.38
12269,64533535,2023-02-07,-162.23,265.15
12270,64533535,2023-02-09,-26.26,238.89000000000001
12271,64533535,2023-02-11,59.16,298.05
12272,64533535,2023-02-13,77.95,376.0
12273,64571970,2023-01-31,,693.34
12274,64571970,2023-02-04,809.4,1502.74
12275,64571970,2023-02-07,-57.59,1445.15
12276,64571970,2023-02-07,-135.14,1310.01
12277,64571970,2023-02-07,-148.81,1161.2
12278,64571970,2023-02-08,-71.81,1089.39
12279,64571970,2023-02-09,-18.36,1071.03
12280,64590882,2023-01-31,,344.01
12281,64590882,2023-02-03,-1505.1,-1161.09
12282,64590882,2023-02-05,71.17,-1089.9199999999998
12283,64590882,2023-02-05,-144.77,-1234.69
12284,64590882,2023-02-07,146.17,-1088.52
12285,64590882,2023-02-14,75.01,-1013.51
12286,64590882,2023-02-14,-54.0,-1067.51
12287,64590882,2023-02-14,-140.07,-1207.58
12288,64610632,2023-01-31,,869.95
12289,64610632,2023-02-04,-35.39,834.5600000000001
12290,64610632,2023-02-05,858.4,1692.96
12291,64610632,2023-02-07,-147.04,1545.92
12292,64610632,2023-02-09,46.29,1592.21
12293,64610632,2023-02-13,-183.43,1408.78
12294,64610632,2023-02-13,-199.57,1209.21
12295,64683004,2023-01-31,,348.86
12296,64683004,2023-02-01,614.1,962.96
12297,64683004,2023-02-04,303.4,1266.3600000000001
12298,64683004,2023-02-04,3.48,1269.84
12299,64683004,2023-02-05,-183.09,1086.75
12300,64683004,2023-02-08,2017.7,3104.45
12301,64683004,2023-02-08,-106.98,2997.4700000000003
12302,64683004,2023-02-09,1658.0,4655.47
12303,64683004,2023-02-11,101.75,4757.22
12304,64683004,2023-02-13,-188.62,4568.6
12305,64683004,2023-02-14,147.85,4716.45
12306,64683004,2023-02-14,107.71,4824.16
12307,64683004,2023-02-14,-26.02,4798.14
12308,64716185,2023-01-31,,391.53
12309,64716185,2023-02-02,80.3,471.83
12310,64716185,2023-02-06,-54.21,417.61999999999995
12311,64716185,2023-02-07,1255.9,1673.52
12312,64716185,2023-02-08,-89.88,1583.6399999999999
12313,64716185,2023-02-13,-153.4,1430.24
12314,64716185,2023-02-14,7.26,1437.5
12315,64769583,2023-01-31,,598.67
12316,64769583,2023-02-02,-115.98,482.68999999999994
12317,64769583,2023-02-04,1705.8,2188.49
12318,64769583,2023-02-07,115.83,2304.32
12319,64769583,2023-02-12,-129.84,2174.48
12320,64893719,2023-01-31,,689.59
12321,64893719,2023-02-03,64.85,754.44
12322,64893719,2023-02-04,-91.88,662.5600000000001
12323,64893719,2023-02-07,126.74,789.3000000000001
12324,64893719,2023-02-08,41.56,830.86
12325,64893719,2023-02-10,-83.89,746.97
12326,64893719,2023-02-10,-119.83,627.14
12327,64901797,2023-01-31,,672.29
12328,64901797,2023-02-06,73.11,745.4
12329,64901797,2023-02-07,-94.93,650.4699999999999
12330,64901797,2023-02-10,-154.39,496.08
12331,64901797,2023-02-14,70.4,566.48
12332,64953936,2023-01-31,,311.46
12333,64953936,2023-02-05,226.81,538.27
12334,64953936,2023-02-08,-34.12,504.15
12335,64953936,2023-02-11,148.4,652.55
12336,64953936,2023-02-13,-710.9,-58.35000000000002
12337,64958880,2023-01-31,,840.8
12338,64958880,2023-02-01,64.89,905.6899999999999
12339,64958880,2023-02-04,87.56,993.25
12340,64958880,2023-02-04,-54.34,938.91
12341,64958880,2023-02-07,-156.28,782.6299999999999
12342,64958880,2023-02-09,142.61,925.24
12343,64958880,2023-02-10,50.54,975.78
12344,64979248,2023-01-31,,202.63
12345,64979248,2023-02-02,-168.67,33.96000000000001
12346,64979248,2023-02-05,46.87,80.83000000000001
12347,64979248,2023-02-10,15.31,96.14
12348,64979248,2023-02-12,622.0,718.14
12349,64979248,2023-02-13,136.67,854.81
12350,64979248,2023-02-14,-44.4,810.41
12351,64990799,2023-01-31,,480.33
12352,64990799,2023-02-02,-102.4,377.92999999999995
12353,64990799,2023-02-03,-62.98,314.95
12354,64990799,2023-02-10,-67.2,247.74999999999997
12355,64990799,2023-02-12,272.8,520.55
12356,64990799,2023-02-12,-52.16,468.39
12357,64990799,2023-02-12,-966.7,-498.31000000000006
12358,65009032,2023-01-31,,984.64
12359,65009032,2023-02-03,220.14,1204.78
12360,65009032,2023-02-04,-128.21,1076.57
12361,65009032,2023-02-06,-140.67,935.9
12362,65009032,2023-02-09,143.28,1079.18
12363,65009032,2023-02-09,95.74,1174.92
12364,65009032,2023-02-10,99.74,1274.6599999999999
12365,65009032,2023-02-10,93.37,1368.03
12366,65009032,2023-02-14,97.59,1465.62
12367,65033625,2023-01-31,,186.26
12368,65033625,2023-02-01,117.4,303.65999999999997
12369,65033625,2023-02-01,80.88,384.53999999999996
12370,65033625,2023-02-05,104.89,489.43
12371,65033625,2023-02-06,-107.96,381.47
12372,65052411,2023-01-31,,877.5
12373,65052411,2023-02-05,-80.22,797.28
12374,65052411,2023-02-06,177.63,974.91
12375,65052411,2023-02-10,48.54,1023.45
12376,65052411,2023-02-11,159.34,1182.79
12377,65052411,2023-02-12,463.1,1645.8899999999999
12378,65052411,2023-02-14,169.73,1815.62
12379,65097827,2023-01-31,,526.75
12380,65097827,2023-02-02,-133.34,393.40999999999997
12381,65097827,2023-02-03,-64.91,328.5
12382,65097827,2023-02-04,-27.43,301.07
12383,65097827,2023-02-05,109.24,410.31
12384,65097827,2023-02-06,738.2,1148.51
12385,65097827,2023-02-09,102.14,1250.65
12386,65097827,2023-02-09,93.18,1343.83
12387,65125795,2023-01-31,,632.35
12388,65125795,2023-02-02,15.19,647.5400000000001
12389,65125795,2023-02-08,38.13,685.6700000000001
12390,65125795,2023-02-14,-66.29,619.38
12391,65143384,2023-01-31,,227.08
12392,65143384,2023-02-04,117.79,344.87
12393,65143384,2023-02-04,8.85,353.72
12394,65143384,2023-02-06,-122.9,230.82
12395,65143384,2023-02-07,-109.89,120.93
12396,65143384,2023-02-07,-119.45,1.480000000000004
12397,65143384,2023-02-07,-1516.3,-1514.82
12398,65143384,2023-02-09,139.36,-1375.46
12399,65143384,2023-02-11,-67.21,-1442.6699999999998
12400,65143384,2023-02-12,-45.77,-1488.4399999999998
12401,65159654,2023-01-31,,761.19
12402,65159654,2023-02-05,-148.44,612.75
12403,65159654,2023-02-08,-123.43,489.32000000000005
12404,65159654,2023-02-10,113.36,602.6800000000001
12405,65159654,2023-02-12,-221.72,380.96000000000004
12406,65159654,2023-02-14,37.21,418.17
12407,65159654,2023-02-14,-665.3,-247.12999999999994
12408,65199307,2023-01-31,,68.09
12409,65199307,2023-02-01,161.85,229.94
12410,65199307,2023-02-01,142.91,372.85
12411,65199307,2023-02-02,1097.6,1470.4499999999998
12412,65199307,2023-02-06,89.47,1559.9199999999998
12413,65199307,2023-02-10,-58.45,1501.4699999999998
12414,65199307,2023-02-12,96.4,1597.87
12415,65199307,2023-02-13,63.47,1661.34
12416,65200379,2023-01-31,,4.27
12417,65200379,2023-02-03,37.15,41.42
12418,65200379,2023-02-04,-68.44,-27.019999999999996
12419,65200379,2023-02-05,66.67,39.650000000000006
12420,65200379,2023-02-06,-101.4,-61.75
12421,65200379,2023-02-08,-116.58,-178.32999999999998
12422,65200379,2023-02-10,193.12,14.79000000000002
12423,65200379,2023-02-10,158.38,173.17000000000002
12424,65200379,2023-02-10,-83.52,89.65000000000002
12425,65200379,2023-02-11,-171.55,-81.89999999999999
12426,65200379,2023-02-12,-66.35,-148.25
12427,65200379,2023-02-12,-1682.4,-1830.65
12428,65220738,2023-01-31,,873.56
12429,65220738,2023-02-01,-89.8,783.76
12430,65220738,2023-02-03,-1121.6,-337.8399999999999
12431,65220738,2023-02-04,158.98,-178.85999999999993
12432,65220738,2023-02-05,-1533.5,-1712.36
12433,65220738,2023-02-06,633.0,-1079.36
12434,65220738,2023-02-11,-663.1,-1742.46
12435,65225040,2023-01-31,,826.42
12436,65225040,2023-02-05,-102.18,724.24
12437,65225040,2023-02-06,146.22,870.4599999999999
12438,65225040,2023-02-06,106.0,976.4599999999999
12439,65225040,2023-02-09,188.3,1164.76
12440,65225040,2023-02-10,-55.08,1109.68
12441,65280102,2023-01-31,,2.17
12442,65280102,2023-02-06,131.6,133.76999999999998
12443,65280102,2023-02-06,-5.35,128.42
12444,65280102,2023-02-11,203.67,332.09
12445,65280102,2023-02-11,-134.09,197.99999999999997
12446,65280102,2023-02-14,701.1,899.1
12447,65280102,2023-02-14,126.17,1025.27
12448,65321237,2023-01-31,,425.42
12449,65321237,2023-02-03,616.4,1041.82
12450,65321237,2023-02-04,-35.68,1006.1400000000001
12451,65321237,2023-02-05,148.44,1154.58
12452,65321237,2023-02-08,107.42,1262.0
12453,65321237,2023-02-11,1293.9,2555.9
12454,65321237,2023-02-12,100.61,2656.51
12455,65380590,2023-01-31,,683.96
12456,65380590,2023-02-02,-31.96,652.0
12457,65380590,2023-02-05,70.44,722.44
12458,65380590,2023-02-07,73.26,795.7
12459,65380590,2023-02-12,-123.38,672.32
12460,65380590,2023-02-14,18.54,690.86
12461,65429379,2023-01-31,,232.83
12462,65429379,2023-02-01,78.22,311.05
12463,65429379,2023-02-01,54.5,365.55
12464,65429379,2023-02-07,-155.73,209.82000000000002
12465,65429379,2023-02-09,118.21,328.03000000000003
12466,65429379,2023-02-09,24.12,352.15000000000003
12467,65429379,2023-02-09,-133.43,218.72
12468,65429379,2023-02-10,60.14,278.86
12469,65429379,2023-02-13,133.53,412.39
12470,65534206,2023-01-31,,274.89
12471,65534206,2023-02-01,62.95,337.84
12472,65534206,2023-02-01,-173.01,164.82999999999998
12473,65534206,2023-02-04,35.8,200.63
12474,65534206,2023-02-09,-124.56,76.06999999999998
12475,65534206,2023-02-13,40.95,117.01999999999998
12476,65534206,2023-02-14,133.43,250.45
12477,65579734,2023-01-31,,928.08
12478,65579734,2023-02-07,97.26,1025.3400000000001
12479,65579734,2023-02-10,163.3,1188.64
12480,65579734,2023-02-10,134.33,1322.97
12481,65579734,2023-02-10,-123.19,1199.78
12482,65579734,2023-02-11,130.27,1330.0500000000002
12483,65579734,2023-02-12,-156.13,1173.92
12484,65579734,2023-02-13,1085.6,2259.52
12485,65579734,2023-02-13,-115.9,2143.62
12486,65583532,2023-01-31,,542.09
12487,65583532,2023-02-03,-80.54,461.55
12488,65583532,2023-02-04,57.41,518.96
12489,65583532,2023-02-05,209.45,728.4100000000001
12490,65583532,2023-02-09,107.84,836.25
12491,65583532,2023-02-09,-196.47,639.78
12492,65589565,2023-01-31,,321.99
12493,65589565,2023-02-07,-84.83,237.16000000000003
12494,65589565,2023-02-07,-93.93,143.23000000000002
12495,65589565,2023-02-12,-1761.1,-1617.87
12496,65596186,2023-01-31,,254.28
12497,65596186,2023-02-03,98.67,352.95
12498,65596186,2023-02-04,-111.74,241.21
12499,65596186,2023-02-06,-121.72,119.49000000000001
12500,65596186,2023-02-14,-37.22,82.27000000000001
12501,65603779,2023-01-31,,652.83
12502,65603779,2023-02-01,-121.46,531.37
12503,65603779,2023-02-02,1145.1,1676.4699999999998
12504,65603779,2023-02-02,-108.49,1567.9799999999998
12505,65603779,2023-02-02,-599.3,968.6799999999998
12506,65603779,2023-02-14,201.83,1170.5099999999998
12507,65606472,2023-01-31,,405.1
12508,65606472,2023-02-12,-65.91,339.19000000000005
12509,65606472,2023-02-14,-142.57,196.62000000000003
12510,65606472,2023-02-14,-302.9,-106.27999999999994
12511,65721172,2023-01-31,,221.49
12512,65721172,2023-02-04,-155.79,65.70000000000002
12513,65721172,2023-02-05,-66.67,-0.9699999999999847
12514,65721172,2023-02-05,-190.77,-191.74
12515,65721172,2023-02-07,-57.31,-249.04999999999998
12516,65721172,2023-02-09,-154.04,-403.09
12517,65721172,2023-02-13,-39.15,-442.23999999999995
12518,65724980,2023-01-31,,307.93
12519,65724980,2023-02-01,66.43,374.36
12520,65724980,2023-02-06,1138.4,1512.7600000000002
12521,65724980,2023-02-06,-133.2,1379.5600000000002
12522,65724980,2023-02-06,-155.01,1224.5500000000002
12523,65724980,2023-02-07,-134.59,1089.9600000000003
12524,65724980,2023-02-08,-157.28,932.6800000000003
12525,65724980,2023-02-12,-1.29,931.3900000000002
12526,65754176,2023-01-31,,716.55
12527,65754176,2023-02-01,174.19,890.74
12528,65754176,2023-02-03,-218.15,672.5899999999999
12529,65754176,2023-02-09,-1045.1,-372.51
12530,65754176,2023-02-10,-106.77,-479.28
12531,65754176,2023-02-12,180.46,-298.82
12532,65754176,2023-02-13,-105.95,-404.77
12533,65782923,2023-01-31,,193.43
12534,65782923,2023-02-05,118.02,311.45
12535,65782923,2023-02-06,-38.61,272.84000000000003
12536,65782923,2023-02-10,-148.09,124.75
12537,65782923,2023-02-11,70.39,195.14
12538,65782923,2023-02-14,-87.88,107.26
12539,65804470,2023-01-31,,454.38
12540,65804470,2023-02-02,-129.45,324.93
12541,65804470,2023-02-03,220.83,545.76
12542,65804470,2023-02-08,117.35,663.11
12543,65804470,2023-02-11,167.02,830.13
12544,65804470,2023-02-11,-90.36,739.77
12545,65804470,2023-02-13,62.13,801.9
12546,65804470,2023-02-14,61.34,863.24
12547,65815967,2023-01-31,,0.43
12548,65815967,2023-02-03,84.7,85.13000000000001
12549,65815967,2023-02-07,43.28,128.41000000000003
12550,65815967,2023-02-07,-149.99,-21.579999999999984
12551,65815967,2023-02-09,110.14,88.56000000000002
12552,65815967,2023-02-09,63.99,152.55
12553,65926576,2023-01-31,,73.48
12554,65926576,2023-02-02,97.47,170.95
12555,65926576,2023-02-10,82.23,253.18
12556,65926576,2023-02-12,158.57,411.75
12557,65926576,2023-02-13,110.4,522.15
12558,65926576,2023-02-14,-143.6,378.55
12559,65988118,2023-01-31,,647.81
12560,65988118,2023-02-02,56.84,704.65
12561,65988118,2023-02-08,-14.01,690.64
12562,65988118,2023-02-10,55.13,745.77
12563,65988118,2023-02-10,-117.56,628.2099999999999
12564,65988118,2023-02-11,108.59,736.8
12565,65988118,2023-02-12,157.46,894.26
12566,66008535,2023-01-31,,398.99
12567,66008535,2023-02-01,63.11,462.1
12568,66008535,2023-02-08,105.76,567.86
12569,66022888,2023-01-31,,757.14
12570,66022888,2023-02-01,57.37,814.51
12571,66022888,2023-02-02,-24.05,790.46
12572,66022888,2023-02-03,98.38,888.8399999999999
12573,66022888,2023-02-03,-50.38,838.4599999999999
12574,66022888,2023-02-03,-91.37,747.0899999999999
12575,66022888,2023-02-07,126.32,873.41
12576,66022888,2023-02-08,-159.05,714.3599999999999
12577,66022888,2023-02-09,63.95,778.31
12578,66022888,2023-02-14,81.21,859.52
12579,66044567,2023-01-31,,596.13
12580,66044567,2023-02-02,183.83,779.96
12581,66044567,2023-02-03,11.36,791.32
12582,66044567,2023-02-05,159.59,950.9100000000001
12583,66044567,2023-02-12,95.14,1046.05
12584,66152145,2023-01-31,,83.45
12585,66152145,2023-02-02,150.88,234.32999999999998
12586,66152145,2023-02-03,55.63,289.96
12587,66152145,2023-02-03,-616.4,-326.44
12588,66152145,2023-02-05,-83.4,-409.84000000000003
12589,66152145,2023-02-07,-1760.8,-2170.64
12590,66152145,2023-02-08,59.97,-2110.67
12591,66152145,2023-02-09,-73.42,-2184.09
12592,66152145,2023-02-14,685.5,-1498.5900000000001
12593,66152145,2023-02-14,107.51,-1391.0800000000002
12594,66168472,2023-01-31,,29.89
12595,66168472,2023-02-03,221.11,251.0
12596,66168472,2023-02-03,-79.25,171.75
12597,66168472,2023-02-03,-196.95,-25.19999999999999
12598,66168472,2023-02-05,98.07,72.87
12599,66168472,2023-02-09,96.2,169.07
12600,66168472,2023-02-09,20.18,189.25
12601,66168472,2023-02-12,-88.2,101.05000000000001
12602,66175264,2023-01-31,,765.91
12603,66175264,2023-02-06,123.31,889.22
12604,66175264,2023-02-09,74.87,964.0899999999999
12605,66175264,2023-02-10,1134.6,2098.6899999999996
12606,66175264,2023-02-12,67.31,2166.0
12607,66175264,2023-02-13,-161.21,2004.7899999999997
12608,66175264,2023-02-14,117.68,2122.47
12609,66187843,2023-01-31,,535.34
12610,66187843,2023-02-01,-112.17,423.17
12611,66187843,2023-02-03,163.12,586.29
12612,66239954,2023-01-31,,181.14
12613,66239954,2023-02-02,93.88,275.02
12614,66239954,2023-02-03,267.7,542.72
12615,66239954,2023-02-05,83.4,626.12
12616,66239954,2023-02-07,-140.1,486.02
12617,66239954,2023-02-12,-48.67,437.34999999999997
12618,66239954,2023-02-12,-57.42,379.92999999999995
12619,66239954,2023-02-14,130.84,510.77
12620,66239954,2023-02-14,80.39,591.16
12621,66239954,2023-02-14,-1478.2,-887.0400000000001
12622,66257438,2023-01-31,,818.57
12623,66257438,2023-02-01,78.4,896.97
12624,66257438,2023-02-04,84.59,981.5600000000001
12625,66257438,2023-02-05,-28.46,953.1
12626,66257438,2023-02-07,-6.03,947.07
12627,66257438,2023-02-09,71.12,1018.19
12628,66257438,2023-02-12,1799.2,2817.3900000000003
12629,66257438,2023-02-12,-108.0,2709.3900000000003
12630,66283493,2023-01-31,,612.88
12631,66283493,2023-02-06,49.21,662.09
12632,66283493,2023-02-07,1370.6,2032.69
12633,66332583,2023-01-31,,241.29
12634,66332583,2023-02-05,-184.86,56.42999999999998
12635,66332583,2023-02-06,-83.89,-27.460000000000022
12636,66332583,2023-02-07,151.7,124.23999999999997
12637,66332583,2023-02-09,-121.13,3.109999999999971
12638,66332583,2023-02-12,-128.81,-125.70000000000003
12639,66332583,2023-02-12,-198.39,-324.09000000000003
12640,66341438,2023-01-31,,685.06
12641,66341438,2023-02-05,-1625.6,-940.54
12642,66341438,2023-02-06,113.63,-826.91
12643,66341438,2023-02-13,-81.39,-908.3
12644,66341438,2023-02-13,-1013.4,-1921.6999999999998
12645,66390683,2023-01-31,,52.77
12646,66390683,2023-02-01,-104.47,-51.699999999999996
12647,66390683,2023-02-03,-103.29,-154.99
12648,66390683,2023-02-05,83.99,-71.0
12649,66390683,2023-02-05,-165.42,-236.42
12650,66390683,2023-02-09,90.79,-145.63
12651,66390683,2023-02-11,-77.62,-223.25
12652,66390683,2023-02-13,-157.55,-380.8
12653,66390683,2023-02-14,65.5,-315.3
12654,66390683,2023-02-14,-133.19,-448.49
12655,66390683,2023-02-14,-146.71,-595.2
12656,66416254,2023-01-31,,166.4
12657,66416254,2023-02-03,131.54,297.94
12658,66416254,2023-02-03,-38.14,259.8
12659,66416254,2023-02-03,-63.29,196.51
12660,66416254,2023-02-03,-159.42,37.09
12661,66416254,2023-02-04,-93.96,-56.86999999999999
12662,66416254,2023-02-05,812.6,755.73
12663,66416254,2023-02-05,-159.34,596.39
12664,66416254,2023-02-06,1095.4,1691.79
12665,66416254,2023-02-10,174.77,1866.56
12666,66416254,2023-02-10,-68.78,1797.78
12667,66416254,2023-02-11,142.67,1940.45
12668,66416254,2023-02-12,-89.64,1850.81
12669,66416254,2023-02-13,837.4,2688.21
12670,66445304,2023-01-31,,153.78
12671,66445304,2023-02-01,174.0,327.78
12672,66445304,2023-02-05,184.78,512.56
12673,66445304,2023-02-05,-108.92,403.64
12674,66445304,2023-02-08,-94.29,309.35
12675,66449974,2023-01-31,,795.59
12676,66449974,2023-02-05,65.31,860.9000000000001
12677,66449974,2023-02-11,102.91,963.8100000000001
12678,66449974,2023-02-12,-80.44,883.37
12679,66449974,2023-02-12,-1265.1,-381.7299999999999
12680,66504443,2023-01-31,,618.97
12681,66504443,2023-02-02,-217.51,401.46000000000004
12682,66504443,2023-02-05,-45.47,355.99
12683,66504443,2023-02-12,-127.6,228.39000000000004
12684,66521788,2023-01-31,,201.43
12685,66521788,2023-02-01,-127.41,74.02000000000001
12686,66521788,2023-02-05,90.66,164.68
12687,66521788,2023-02-05,-73.78,90.9
12688,66521788,2023-02-13,-67.31,23.590000000000003
12689,66556141,2023-01-31,,688.37
12690,66556141,2023-02-05,-33.96,654.41
12691,66556141,2023-02-07,45.83,700.24
12692,66556141,2023-02-10,206.97,907.21
12693,66556141,2023-02-13,-96.51,810.7
12694,66586860,2023-01-31,,938.51
12695,66586860,2023-02-01,1072.7,2011.21
12696,66586860,2023-02-06,-143.42,1867.79
12697,66586860,2023-02-07,-106.1,1761.69
12698,66586860,2023-02-08,-145.66,1616.03
12699,66586860,2023-02-10,116.33,1732.3600000000001
12700,66586860,2023-02-11,-86.77,1645.5900000000001
12701,66586860,2023-02-11,-148.74,1496.8500000000001
12702,66586860,2023-02-12,-1764.4,-267.54999999999995
12703,66586860,2023-02-13,-56.41,-323.9599999999999
12704,66601462,2023-01-31,,361.46
12705,66601462,2023-02-11,62.18,423.64
12706,66601462,2023-02-13,-115.86,307.78
12707,66624477,2023-01-31,,521.98
12708,66624477,2023-02-10,-1271.5,-749.52
12709,66624477,2023-02-13,-70.58,-820.1
12710,66667727,2023-01-31,,431.31
12711,66667727,2023-02-01,145.77,577.08
12712,66667727,2023-02-04,146.82,723.9
12713,66667727,2023-02-04,-201.15,522.75
12714,66667727,2023-02-05,-104.58,418.17
12715,66667727,2023-02-06,-106.31,311.86
12716,66681692,2023-01-31,,712.12
12717,66681692,2023-02-03,644.3,1356.42
12718,66681692,2023-02-03,-102.01,1254.4099999999999
12719,66681692,2023-02-09,1246.4,2500.81
12720,66681692,2023-02-11,99.6,2600.41
12721,66681692,2023-02-14,-150.42,2449.99
12722,66700123,2023-01-31,,175.15
12723,66700123,2023-02-01,-106.46,68.69000000000001
12724,66700123,2023-02-02,-1180.2,-1111.51
12725,66700123,2023-02-08,-39.85,-1151.36
12726,66700123,2023-02-11,125.31,-1026.05
12727,66700123,2023-02-12,-62.68,-1088.73
12728,66704269,2023-01-31,,915.51
12729,66704269,2023-02-03,110.38,1025.8899999999999
12730,66704269,2023-02-04,124.72,1150.61
12731,66704269,2023-02-04,64.92,1215.53
12732,66704269,2023-02-05,159.34,1374.87
12733,66704269,2023-02-07,-10.31,1364.56
12734,66704269,2023-02-08,-157.04,1207.52
12735,66704269,2023-02-11,94.59,1302.1100000000001
12736,66704269,2023-02-12,-124.55,1177.56
12737,66704269,2023-02-14,658.2,1835.7600000000002
12738,66704269,2023-02-14,87.55,1923.3100000000002
12739,66706067,2023-01-31,,1.98
12740,66706067,2023-02-02,-233.36,-231.38000000000002
12741,66706067,2023-02-04,111.13,-120.25000000000003
12742,66706067,2023-02-07,-180.28,-300.53000000000003
12743,66706067,2023-02-08,-12.95,-313.48
12744,66706067,2023-02-08,-1006.9,-1320.38
12745,66706067,2023-02-10,1202.5,-117.88000000000011
12746,66706067,2023-02-10,96.87,-21.010000000000105
12747,66706067,2023-02-10,-140.57,-161.5800000000001
12748,66706067,2023-02-11,-52.74,-214.3200000000001
12749,66706067,2023-02-12,166.9,-47.4200000000001
12750,66729131,2023-01-31,,100.8
12751,66729131,2023-02-04,-24.31,76.49
12752,66729131,2023-02-04,-95.6,-19.11
12753,66729131,2023-02-04,-146.89,-166.0
12754,66729131,2023-02-05,87.07,-78.93
12755,66896515,2023-01-31,,842.82
12756,66896515,2023-02-04,535.8,1378.62
12757,66896515,2023-02-05,91.73,1470.35
12758,66896515,2023-02-05,-104.2,1366.15
12759,66896515,2023-02-05,-190.01,1176.14
12760,66896515,2023-02-09,101.53,1277.67
12761,66896515,2023-02-11,222.05,1499.72
12762,66896515,2023-02-11,-99.6,1400.1200000000001
12763,66914990,2023-01-31,,764.75
12764,66914990,2023-02-01,-98.33,666.42
12765,66914990,2023-02-05,137.98,804.4
12766,66914990,2023-02-09,-125.11,679.29
12767,66914990,2023-02-13,-229.21,450.08
12768,66914990,2023-02-14,65.19,515.27
12769,66914990,2023-02-14,-133.67,381.6
12770,66930564,2023-01-31,,398.03
12771,66930564,2023-02-02,-83.72,314.30999999999995
12772,66930564,2023-02-05,-174.96,139.34999999999997
12773,66930564,2023-02-06,115.81,255.15999999999997
12774,66930564,2023-02-11,-96.9,158.25999999999996
12775,66930564,2023-02-13,114.54,272.79999999999995
12776,66954664,2023-01-31,,620.1
12777,66954664,2023-02-04,49.52,669.62
12778,66954664,2023-02-04,-57.49,612.13
12779,66954664,2023-02-05,-202.11,410.02
12780,66954664,2023-02-08,-62.89,347.13
12781,66954664,2023-02-12,-153.75,193.38
12782,66954664,2023-02-13,-48.57,144.81
12783,66954664,2023-02-14,-781.5,-636.69
12784,67029298,2023-01-31,,255.53
12785,67029298,2023-02-01,-60.58,194.95
12786,67029298,2023-02-02,786.6,981.55
12787,67029298,2023-02-02,68.12,1049.67
12788,67029298,2023-02-02,28.3,1077.97
12789,67029298,2023-02-02,-90.07,987.9000000000001
12790,67029298,2023-02-07,21.61,1009.5100000000001
12791,67029298,2023-02-08,-107.83,901.6800000000001
12792,67029298,2023-02-14,-93.35,808.33
12793,67056187,2023-01-31,,392.51
12794,67056187,2023-02-02,-101.39,291.12
12795,67056187,2023-02-08,-92.86,198.26
12796,67056187,2023-02-09,-163.99,34.26999999999998
12797,67056187,2023-02-11,-1370.2,-1335.93
12798,67056187,2023-02-14,-47.83,-1383.76
12799,67056187,2023-02-14,-106.34,-1490.1000000000001
12800,67090449,2023-01-31,,724.35
12801,67090449,2023-02-04,-31.07,693.28
12802,67090449,2023-02-07,-84.46,608.82
12803,67090449,2023-02-07,-788.3,-179.4799999999999
12804,67090449,2023-02-09,-143.28,-322.7599999999999
12805,67090449,2023-02-10,103.55,-219.20999999999992
12806,67090449,2023-02-10,-59.66,-278.8699999999999
12807,67090449,2023-02-11,62.9,-215.9699999999999
12808,67090449,2023-02-14,72.94,-143.02999999999992
12809,67090449,2023-02-14,-1145.9,-1288.93
12810,67102224,2023-01-31,,852.71
12811,67102224,2023-02-01,103.68,956.3900000000001
12812,67102224,2023-02-03,-107.3,849.09
12813,67104073,2023-01-31,,476.04
12814,67104073,2023-02-03,46.54,522.58
12815,67104073,2023-02-07,-184.95,337.63
12816,67104073,2023-02-13,-69.73,267.90000000000003
12817,67147649,2023-01-31,,3.28
12818,67147649,2023-02-02,1499.9,1503.18
12819,67147649,2023-02-03,-121.77,1381.41
12820,67147649,2023-02-05,106.43,1487.8400000000001
12821,67147649,2023-02-08,27.23,1515.0700000000002
12822,67147649,2023-02-10,72.61,1587.68
12823,67147649,2023-02-14,98.34,1686.02
12824,67153119,2023-01-31,,454.81
12825,67153119,2023-02-01,117.6,572.41
12826,67153119,2023-02-01,-99.45,472.96
12827,67153119,2023-02-02,190.87,663.8299999999999
12828,67153119,2023-02-03,8.49,672.3199999999999
12829,67153119,2023-02-08,-53.25,619.0699999999999
12830,67153119,2023-02-12,91.62,710.69
12831,67153119,2023-02-14,-171.69,539.0
12832,67157564,2023-01-31,,562.42
12833,67157564,2023-02-01,1153.0,1715.42
12834,67157564,2023-02-02,74.82,1790.24
12835,67157564,2023-02-03,89.03,1879.27
12836,67157564,2023-02-04,-160.12,1719.15
12837,67157564,2023-02-08,-122.19,1596.96
12838,67157564,2023-02-10,-58.74,1538.22
12839,67157564,2023-02-10,-72.18,1466.04
12840,67157564,2023-02-12,71.93,1537.97
12841,67190209,2023-01-31,,567.61
12842,67190209,2023-02-01,74.4,642.01
12843,67270354,2023-01-31,,805.28
12844,67270354,2023-02-04,-130.37,674.91
12845,67270354,2023-02-05,-139.91,535.0
12846,67270354,2023-02-10,1124.9,1659.9
12847,67270354,2023-02-12,-68.07,1591.8300000000002
12848,67283010,2023-01-31,,872.4
12849,67283010,2023-02-02,72.58,944.98
12850,67283010,2023-02-04,126.98,1071.96
12851,67283010,2023-02-05,143.73,1215.69
12852,67283010,2023-02-08,-7.94,1207.75
12853,67283010,2023-02-11,-75.12,1132.6299999999999
12854,67392638,2023-01-31,,519.61
12855,67392638,2023-02-04,905.4,1425.01
12856,67392638,2023-02-05,184.06,1609.07
12857,67392638,2023-02-05,-95.35,1513.72
12858,67392638,2023-02-06,-93.75,1419.97
12859,67400117,2023-01-31,,769.45
12860,67400117,2023-02-02,-114.44,655.01
12861,67400117,2023-02-03,158.72,813.73
12862,67400117,2023-02-10,121.7,935.4300000000001
12863,67400117,2023-02-10,-130.32,805.1100000000001
12864,67400117,2023-02-14,-658.2,146.91000000000008
12865,67434874,2023-01-31,,399.94
12866,67434874,2023-02-02,108.49,508.43
12867,67434874,2023-02-03,94.57,603.0
12868,67434874,2023-02-04,72.83,675.8299999999999
12869,67434874,2023-02-05,80.66,756.49
12870,67434874,2023-02-07,-123.67,632.8199999999999
12871,67434874,2023-02-09,110.11,742.93
12872,67434874,2023-02-11,-88.2,654.73
12873,67434874,2023-02-12,-85.9,568.8299999999999
12874,67464890,2023-01-31,,81.27
12875,67464890,2023-02-13,-565.6,-484.33000000000004
12876,67464890,2023-02-14,-114.72,-599.0500000000001
12877,67466632,2023-01-31,,350.06
12878,67466632,2023-02-01,126.75,476.81
12879,67466632,2023-02-05,-1317.7,-840.8900000000001
12880,67466632,2023-02-06,179.1,-661.7900000000001
12881,67466632,2023-02-06,48.43,-613.3600000000001
12882,67466632,2023-02-09,144.14,-469.22000000000014
12883,67466632,2023-02-11,83.01,-386.2100000000001
12884,67466632,2023-02-11,-196.49,-582.7
12885,67466632,2023-02-13,-66.5,-649.2
12886,67466632,2023-02-14,-147.38,-796.5800000000002
12887,67489489,2023-01-31,,219.39
12888,67489489,2023-02-01,-118.62,100.76999999999998
12889,67489489,2023-02-04,88.31,189.07999999999998
12890,67489489,2023-02-04,68.1,257.17999999999995
12891,67489489,2023-02-06,112.02,369.2
12892,67489489,2023-02-06,91.86,461.05999999999995
12893,67489489,2023-02-09,-7.44,453.61999999999995
12894,67489489,2023-02-09,-264.6,189.01999999999992
12895,67489489,2023-02-14,85.38,274.3999999999999
12896,67490657,2023-01-31,,588.58
12897,67490657,2023-02-04,-158.56,430.02000000000004
12898,67490657,2023-02-05,-18.89,411.13000000000005
12899,67490657,2023-02-06,-146.96,264.17
12900,67490657,2023-02-08,59.4,323.57
12901,67490657,2023-02-10,123.76,447.33000000000004
12902,67490657,2023-02-11,-954.4,-507.06999999999994
12903,67490657,2023-02-12,-850.1,-1357.17
12904,67490657,2023-02-14,99.88,-1257.29
12905,67502738,2023-01-31,,185.72
12906,67502738,2023-02-08,170.5,356.22
12907,67502738,2023-02-10,-104.93,251.29
12908,67502738,2023-02-12,-84.83,166.45999999999998
12909,67532228,2023-01-31,,805.91
12910,67532228,2023-02-03,936.3,1742.21
12911,67532228,2023-02-04,-163.15,1579.06
12912,67532228,2023-02-05,117.8,1696.86
12913,67532228,2023-02-05,-139.34,1557.52
12914,67532228,2023-02-07,153.27,1710.79
12915,67532228,2023-02-10,-92.13,1618.6599999999999
12916,67541253,2023-01-31,,985.49
12917,67541253,2023-02-02,-555.5,429.99
12918,67541253,2023-02-05,81.2,511.19
12919,67541253,2023-02-09,-38.71,472.48
12920,67541253,2023-02-10,139.35,611.83
12921,67561762,2023-01-31,,469.23
12922,67561762,2023-02-01,170.35,639.58
12923,67561762,2023-02-04,-192.0,447.58000000000004
12924,67561762,2023-02-07,-52.55,395.03000000000003
12925,67561762,2023-02-09,-140.61,254.42000000000002
12926,67561762,2023-02-11,-1136.3,-881.8799999999999
12927,67561762,2023-02-14,114.68,-767.1999999999998
12928,67571676,2023-01-31,,491.88
12929,67571676,2023-02-09,151.22,643.1
12930,67571676,2023-02-09,-7.96,635.14
12931,67571676,2023-02-10,-11.9,623.24
12932,67571676,2023-02-14,-85.15,538.09
12933,67635951,2023-01-31,,692.02
12934,67635951,2023-02-01,167.46,859.48
12935,67635951,2023-02-01,77.61,937.09
12936,67635951,2023-02-04,133.61,1070.7
12937,67635951,2023-02-04,-109.45,961.25
12938,67635951,2023-02-04,-174.55,786.7
12939,67635951,2023-02-08,174.24,960.94
12940,67635951,2023-02-08,-89.09,871.85
12941,67635951,2023-02-08,-258.6,613.25
12942,67674594,2023-01-31,,126.16
12943,67674594,2023-02-01,61.16,187.32
12944,67674594,2023-02-07,-169.03,18.289999999999992
12945,67674594,2023-02-08,153.92,172.20999999999998
12946,67674594,2023-02-08,-135.45,36.75999999999999
12947,67674594,2023-02-09,-56.53,-19.77000000000001
12948,67674594,2023-02-11,151.65,131.88
12949,67674594,2023-02-12,-76.15,55.72999999999999
12950,67679622,2023-01-31,,631.03
12951,67679622,2023-02-01,142.37,773.4
12952,67679622,2023-02-08,-54.11,719.29
12953,67679622,2023-02-08,-93.74,625.55
12954,67679622,2023-02-09,813.0,1438.55
12955,67679622,2023-02-10,-111.68,1326.87
12956,67679622,2023-02-10,-190.89,1135.98
12957,67679622,2023-02-12,-163.83,972.15
12958,67716893,2023-01-31,,250.99
12959,67716893,2023-02-02,93.16,344.15
12960,67716893,2023-02-05,69.16,413.31
12961,67716893,2023-02-07,-126.45,286.86
12962,67716893,2023-02-07,-1500.0,-1213.1399999999999
12963,67716893,2023-02-08,-10.18,-1223.32
12964,67716893,2023-02-08,-73.68,-1297.0
12965,67716893,2023-02-09,166.7,-1130.3
12966,67805276,2023-01-31,,431.12
12967,67805276,2023-02-08,88.85,519.97
12968,67805276,2023-02-09,79.05,599.02
12969,67805276,2023-02-09,-182.8,416.21999999999997
12970,67805276,2023-02-10,103.06,519.28
12971,67805276,2023-02-11,104.82,624.0999999999999
12972,67805276,2023-02-14,-10.57,613.53
12973,67837998,2023-01-31,,246.4
12974,67837998,2023-02-02,154.06,400.46000000000004
12975,67837998,2023-02-04,-87.56,312.9
12976,67837998,2023-02-05,63.7,376.6
12977,67837998,2023-02-10,682.2,1058.8000000000002
12978,67862200,2023-01-31,,944.49
12979,67862200,2023-02-04,-121.95,822.54
12980,67862200,2023-02-06,-7.07,815.47
12981,67862200,2023-02-09,1131.6,1947.07
12982,67862200,2023-02-11,1655.3,3602.37
12983,67862200,2023-02-12,-860.8,2741.5699999999997
12984,67902154,2023-01-31,,669.79
12985,67902154,2023-02-01,65.61,735.4
12986,67902154,2023-02-01,-86.21,649.1899999999999
12987,67902154,2023-02-01,-546.3,102.88999999999999
12988,67902154,2023-02-03,-3.24,99.64999999999999
12989,67902154,2023-02-03,-58.81,40.83999999999998
12990,67902154,2023-02-04,126.83,167.67
12991,67902154,2023-02-06,188.27,355.93999999999994
12992,67902154,2023-02-06,-85.9,270.03999999999996
12993,67902154,2023-02-08,118.58,388.61999999999995
12994,67902154,2023-02-12,158.11,546.73
12995,67902154,2023-02-14,-91.53,455.19999999999993
12996,67902154,2023-02-14,-1100.7,-645.5000000000001
12997,67909830,2023-01-31,,589.68
12998,67909830,2023-02-03,168.82,758.5
12999,67909830,2023-02-03,-118.95,639.55
13000,67909830,2023-02-06,-157.94,481.60999999999996
13001,67909830,2023-02-07,86.52,568.13
13002,67909830,2023-02-11,170.72,738.8499999999999
13003,67911201,2023-01-31,,762.17
13004,67911201,2023-02-01,65.26,827.43
13005,67911201,2023-02-04,-120.19,707.24
13006,67911201,2023-02-09,-1558.7,-851.46
13007,67911201,2023-02-10,170.08,-681.38
13008,67911201,2023-02-11,-52.48,-733.86
13009,67911201,2023-02-11,-107.06,-840.9200000000001
13010,67911677,2023-01-31,,725.9
13011,67911677,2023-02-04,149.2,875.0999999999999
13012,67911677,2023-02-09,-73.05,802.05
13013,67938929,2023-01-31,,868.04
13014,67938929,2023-02-01,-125.38,742.66
13015,67938929,2023-02-03,110.43,853.0899999999999
13016,67938929,2023-02-03,-61.92,791.17
13017,67938929,2023-02-06,122.9,914.0699999999999
13018,67938929,2023-02-09,158.5,1072.57
13019,67938929,2023-02-09,-135.47,937.1
13020,67938929,2023-02-10,90.78,1027.88
13021,67938929,2023-02-10,58.74,1086.62
13022,67938929,2023-02-10,-20.05,1066.57
13023,67938929,2023-02-11,-73.62,992.95
13024,67938929,2023-02-13,121.3,1114.25
13025,67961706,2023-01-31,,569.5
13026,67961706,2023-02-05,95.84,665.34
13027,67961706,2023-02-09,182.8,848.14
13028,67961706,2023-02-11,832.5,1680.6399999999999
13029,67961706,2023-02-12,-98.2,1582.44
13030,67961706,2023-02-14,104.45,1686.8899999999999
13031,67987326,2023-01-31,,161.67
13032,67987326,2023-02-01,-151.18,10.48999999999998
13033,67987326,2023-02-06,175.36,185.85
13034,67987326,2023-02-07,-138.63,47.22
13035,67987326,2023-02-10,83.95,131.17000000000002
13036,67987326,2023-02-12,224.14,355.31
13037,68051701,2023-01-31,,911.6
13038,68051701,2023-02-03,-197.64,713.96
13039,68051701,2023-02-03,-774.8,-60.83999999999992
13040,68051701,2023-02-04,-34.22,-95.05999999999992
13041,68051701,2023-02-11,89.5,-5.559999999999917
13042,68051701,2023-02-12,128.28,122.72000000000008
13043,68051701,2023-02-13,-184.92,-62.1999999999999
13044,68104946,2023-01-31,,925.71
13045,68104946,2023-02-08,109.29,1035.0
13046,68153614,2023-01-31,,927.95
13047,68153614,2023-02-02,118.22,1046.17
13048,68153614,2023-02-10,-170.08,876.09
13049,68153614,2023-02-11,-659.5,216.59000000000003
13050,68153614,2023-02-13,-99.78,116.81000000000003
13051,68189902,2023-01-31,,448.56
13052,68189902,2023-02-02,-61.7,386.86
13053,68189902,2023-02-05,125.05,511.90999999999997
13054,68189902,2023-02-05,-153.59,358.32
13055,68189902,2023-02-06,145.42,503.74
13056,68189902,2023-02-07,101.79,605.53
13057,68198696,2023-01-31,,979.46
13058,68198696,2023-02-05,27.36,1006.82
13059,68198696,2023-02-07,159.97,1166.79
13060,68198696,2023-02-08,-96.45,1070.34
13061,68198696,2023-02-09,56.02,1126.3600000000001
13062,68198696,2023-02-09,-37.14,1089.22
13063,68198696,2023-02-09,-60.16,1029.06
13064,68198696,2023-02-11,-16.59,1012.47
13065,68198696,2023-02-12,1149.0,2161.4700000000003
13066,68239576,2023-01-31,,64.42
13067,68239576,2023-02-01,121.83,186.25
13068,68239576,2023-02-01,94.97,281.22
13069,68239576,2023-02-01,21.82,303.04
13070,68239576,2023-02-05,100.33,403.37
13071,68239576,2023-02-09,85.04,488.41
13072,68239576,2023-02-09,-129.19,359.22
13073,68262083,2023-01-31,,899.79
13074,68262083,2023-02-04,-141.71,758.0799999999999
13075,68262083,2023-02-11,-57.11,700.9699999999999
13076,68262083,2023-02-14,120.31,821.28
13077,68275028,2023-01-31,,918.44
13078,68275028,2023-02-01,-120.92,797.5200000000001
13079,68275028,2023-02-03,106.67,904.19
13080,68275028,2023-02-04,-35.52,868.6700000000001
13081,68275028,2023-02-07,1002.5,1871.17
13082,68275028,2023-02-07,192.3,2063.4700000000003
13083,68275028,2023-02-09,-107.22,1956.25
13084,68294036,2023-01-31,,184.64
13085,68294036,2023-02-02,119.55,304.19
13086,68294036,2023-02-06,67.41,371.59999999999997
13087,68294036,2023-02-06,-50.84,320.76
13088,68294036,2023-02-08,-157.52,163.23999999999995
13089,68294036,2023-02-08,-162.49,0.7499999999999432
13090,68294036,2023-02-09,411.3,412.04999999999995
13091,68294036,2023-02-10,165.63,577.68
13092,68294645,2023-01-31,,306.18
13093,68294645,2023-02-01,33.51,339.69
13094,68294645,2023-02-02,83.72,423.40999999999997
13095,68294645,2023-02-06,126.54,549.95
13096,68294645,2023-02-12,-72.46,477.49
13097,68311266,2023-01-31,,87.08
13098,68311266,2023-02-01,-239.72,-152.64
13099,68311266,2023-02-03,130.74,-21.900000000000006
13100,68311266,2023-02-05,139.91,118.00999999999999
13101,68311266,2023-02-06,1253.1,1371.11
13102,68311266,2023-02-10,114.74,1485.85
13103,68311266,2023-02-12,-96.87,1388.9799999999998
13104,68311266,2023-02-14,108.48,1497.4599999999998
13105,68311266,2023-02-14,27.68,1525.1399999999999
13106,68315462,2023-01-31,,769.16
13107,68315462,2023-02-01,152.29,921.4499999999999
13108,68315462,2023-02-02,118.55,1040.0
13109,68315462,2023-02-03,198.29,1238.29
13110,68315462,2023-02-05,-10.32,1227.97
13111,68315462,2023-02-05,-19.27,1208.7
13112,68315462,2023-02-09,1410.1,2618.8
13113,68315462,2023-02-10,104.86,2723.66
13114,68315462,2023-02-10,63.58,2787.24
13115,68315462,2023-02-10,-74.29,2712.95
13116,68315462,2023-02-13,-40.65,2672.2999999999997
13117,68346907,2023-01-31,,752.88
13118,68346907,2023-02-01,-844.6,-91.72000000000003
13119,68346907,2023-02-05,74.21,-17.510000000000034
13120,68346907,2023-02-06,-100.09,-117.60000000000004
13121,68346907,2023-02-07,-129.86,-247.46000000000004
13122,68346907,2023-02-08,43.89,-203.57000000000005
13123,68346907,2023-02-09,-78.9,-282.47
13124,68346907,2023-02-12,-841.7,-1124.17
13125,68346907,2023-02-13,92.64,-1031.53
13126,68393439,2023-01-31,,783.05
13127,68393439,2023-02-01,137.75,920.8
13128,68393439,2023-02-02,-174.74,746.06
13129,68393439,2023-02-05,104.42,850.4799999999999
13130,68393439,2023-02-09,115.06,965.54
13131,68393439,2023-02-10,-130.57,834.97
13132,68393439,2023-02-12,40.07,875.04
13133,68393439,2023-02-12,-67.66,807.38
13134,68393439,2023-02-13,-72.65,734.73
13135,68393439,2023-02-13,-125.61,609.12
13136,68393439,2023-02-13,-152.83,456.28999999999996
13137,68423238,2023-01-31,,972.94
13138,68423238,2023-02-05,80.22,1053.16
13139,68423238,2023-02-11,-107.4,945.76
13140,68423238,2023-02-12,128.4,1074.16
13141,68423238,2023-02-12,84.4,1158.56
13142,68423238,2023-02-13,175.32,1333.88
13143,68483071,2023-01-31,,25.88
13144,68483071,2023-02-04,-2122.7,-2096.8199999999997
13145,68483071,2023-02-05,-1580.8,-3677.62
13146,68483071,2023-02-07,166.87,-3510.7499999999995
13147,68484031,2023-01-31,,853.99
13148,68484031,2023-02-02,52.86,906.85
13149,68484031,2023-02-05,18.89,925.74
13150,68484031,2023-02-05,-1463.6,-537.8599999999999
13151,68484031,2023-02-11,1672.7,1134.8400000000001
13152,68484031,2023-02-11,-26.87,1107.9700000000003
13153,68552857,2023-01-31,,309.92
13154,68552857,2023-02-02,156.04,465.96000000000004
13155,68552857,2023-02-02,-106.6,359.36
13156,68552857,2023-02-08,-68.6,290.76
13157,68552994,2023-01-31,,516.25
13158,68552994,2023-02-01,-62.95,453.3
13159,68552994,2023-02-08,-1608.4,-1155.1000000000001
13160,68552994,2023-02-09,-88.81,-1243.91
13161,68552994,2023-02-14,781.5,-462.4100000000001
13162,68558850,2023-01-31,,281.5
13163,68558850,2023-02-01,80.81,362.31
13164,68558850,2023-02-04,1395.3,1757.61
13165,68558850,2023-02-06,-182.96,1574.6499999999999
13166,68558850,2023-02-07,-111.95,1462.6999999999998
13167,68558850,2023-02-10,-70.74,1391.9599999999998
13168,68558850,2023-02-12,-69.85,1322.11
13169,68579203,2023-01-31,,149.39
13170,68680764,2023-01-31,,200.27
13171,68680764,2023-02-03,886.6,1086.8700000000001
13172,68680764,2023-02-09,-81.22,1005.65
13173,68683403,2023-01-31,,674.5
13174,68683403,2023-02-05,63.32,737.82
13175,68683403,2023-02-13,535.9,1273.72
13176,68689742,2023-01-31,,45.41
13177,68689742,2023-02-07,121.67,167.07999999999998
13178,68689742,2023-02-07,56.42,223.5
13179,68689742,2023-02-14,-123.36,100.14
13180,68708795,2023-01-31,,399.11
13181,68708795,2023-02-03,-102.85,296.26
13182,68708795,2023-02-04,-140.43,155.83
13183,68708795,2023-02-04,-255.0,-99.16999999999999
13184,68708795,2023-02-05,-109.76,-208.93
13185,68708795,2023-02-07,-115.4,-324.33
13186,68708795,2023-02-08,-134.23,-458.56
13187,68708795,2023-02-09,-49.06,-507.62
13188,68708795,2023-02-10,-138.8,-646.4200000000001
13189,68708795,2023-02-14,-1297.2,-1943.6200000000001
13190,68721707,2023-01-31,,900.45
13191,68721707,2023-02-03,113.78,1014.23
13192,68721707,2023-02-09,69.99,1084.22
13193,68721707,2023-02-10,-113.56,970.6600000000001
13194,68775529,2023-01-31,,531.87
13195,68775529,2023-02-03,1266.7,1798.5700000000002
13196,68775529,2023-02-07,-113.79,1684.78
13197,68775529,2023-02-08,-48.01,1636.77
13198,68775529,2023-02-09,512.3,2149.0699999999997
13199,68775529,2023-02-09,124.1,2273.17
13200,68775529,2023-02-10,129.33,2402.5
13201,68775529,2023-02-11,60.41,2462.91
13202,68775529,2023-02-12,178.37,2641.2799999999997
13203,68786878,2023-01-31,,512.06
13204,68786878,2023-02-03,44.25,556.31
13205,68786878,2023-02-12,79.12,635.43
13206,68786878,2023-02-12,66.27,701.6999999999999
13207,68786878,2023-02-14,-58.68,643.02
13208,68793483,2023-01-31,,581.36
13209,68793483,2023-02-02,-983.3,-401.93999999999994
13210,68793483,2023-02-03,185.02,-216.91999999999993
13211,68793483,2023-02-03,119.95,-96.96999999999993
13212,68793483,2023-02-08,68.31,-28.659999999999926
13213,68793483,2023-02-08,-110.48,-139.13999999999993
13214,68793483,2023-02-09,140.49,1.3500000000000796
13215,68793483,2023-02-09,-123.28,-121.92999999999992
13216,68793483,2023-02-10,116.54,-5.389999999999915
13217,68793483,2023-02-11,-626.6,-631.9899999999999
13218,68793483,2023-02-13,99.13,-532.8599999999999
13219,68793483,2023-02-14,130.44,-402.4199999999999
13220,68793483,2023-02-14,-59.81,-462.2299999999999
13221,68793483,2023-02-14,-131.83,-594.06
13222,68798691,2023-01-31,,819.33
13223,68798691,2023-02-01,-112.52,706.8100000000001
13224,68798691,2023-02-04,-7.74,699.07
13225,68798691,2023-02-05,-124.83,574.24
13226,68798691,2023-02-07,123.45,697.69
13227,68798691,2023-02-07,53.14,750.83
13228,68798691,2023-02-11,-33.64,717.19
13229,68798691,2023-02-11,-36.07,681.12
13230,68798691,2023-02-12,-147.45,533.6700000000001
13231,68798691,2023-02-14,71.41,605.08
13232,68798691,2023-02-14,47.84,652.9200000000001
13233,68798691,2023-02-14,-56.66,596.2600000000001
13234,68800062,2023-01-31,,749.65
13235,68800062,2023-02-04,165.76,915.41
13236,68800062,2023-02-04,-668.8,246.61
13237,68800062,2023-02-05,149.41,396.02
13238,68800062,2023-02-05,-276.4,119.62
13239,68800062,2023-02-06,-73.11,46.510000000000005
13240,68800062,2023-02-08,164.35,210.86
13241,68800062,2023-02-08,-116.37,94.48999999999998
13242,68800062,2023-02-09,109.08,203.57
13243,68800062,2023-02-09,100.36,303.92999999999995
13244,68800062,2023-02-13,123.49,427.41999999999996
13245,68836810,2023-01-31,,171.96
13246,68836810,2023-02-02,-128.3,43.66
13247,68836810,2023-02-04,89.11,132.76999999999998
13248,68891568,2023-01-31,,844.06
13249,68891568,2023-02-02,-58.4,785.66
13250,68891568,2023-02-03,121.82,907.4799999999999
13251,68891568,2023-02-09,-12.23,895.2499999999999
13252,68891568,2023-02-13,38.13,933.3799999999999
13253,68891568,2023-02-13,-30.41,902.9699999999999
13254,68891568,2023-02-13,-77.23,825.7399999999999
13255,68928221,2023-01-31,,502.06
13256,68928221,2023-02-02,236.79,738.85
13257,68928221,2023-02-02,-82.11,656.74
13258,68928221,2023-02-04,-104.53,552.21
13259,68928221,2023-02-06,171.3,723.51
13260,68928221,2023-02-08,106.98,830.49
13261,68928221,2023-02-09,46.08,876.5699999999999
13262,68928221,2023-02-11,-70.39,806.18
13263,68928221,2023-02-12,99.99,906.17
13264,68928221,2023-02-14,150.77,1056.94
13265,68928221,2023-02-14,63.0,1119.94
13266,68962066,2023-01-31,,304.46
13267,68962066,2023-02-02,699.5,1003.96
13268,68962066,2023-02-03,-61.91,942.0500000000001
13269,68962066,2023-02-06,197.61,1139.66
13270,68962066,2023-02-06,-441.4,698.2600000000001
13271,68962066,2023-02-07,141.05,839.3100000000002
13272,68962066,2023-02-08,220.34,1059.65
13273,68962066,2023-02-09,-103.84,955.8100000000002
13274,68962066,2023-02-09,-125.24,830.5700000000002
13275,68962066,2023-02-12,-36.02,794.5500000000001
13276,68962066,2023-02-12,-45.23,749.3200000000002
13277,68962066,2023-02-14,-75.98,673.3400000000001
13278,68973836,2023-01-31,,634.67
13279,68973836,2023-02-01,116.57,751.24
13280,68973836,2023-02-03,955.4,1706.6399999999999
13281,68973836,2023-02-04,-157.26,1549.3799999999999
13282,68973836,2023-02-05,115.12,1664.5
13283,68973836,2023-02-05,82.33,1746.83
13284,68973836,2023-02-10,-62.01,1684.82
13285,68973836,2023-02-11,1273.1,2957.92
13286,68973836,2023-02-13,-72.81,2885.1099999999997
13287,69008969,2023-01-31,,716.37
13288,69008969,2023-02-02,-128.03,588.34
13289,69008969,2023-02-03,-157.15,431.19
13290,69008969,2023-02-07,-88.5,342.69
13291,69008969,2023-02-09,58.69,401.38
13292,69008969,2023-02-10,-143.62,257.76
13293,69008969,2023-02-11,-60.41,197.35
13294,69008969,2023-02-14,67.7,265.05
13295,69090518,2023-01-31,,473.87
13296,69090518,2023-02-04,-124.74,349.13
13297,69090518,2023-02-05,-59.47,289.66
13298,69090518,2023-02-07,127.45,417.11
13299,69090518,2023-02-09,99.11,516.22
13300,69090518,2023-02-10,20.05,536.27
13301,69090518,2023-02-13,-157.27,379.0
13302,69118170,2023-01-31,,109.35
13303,69118170,2023-02-01,151.41,260.76
13304,69118170,2023-02-02,-56.3,204.45999999999998
13305,69118170,2023-02-06,-1161.4,-956.94
13306,69118170,2023-02-07,86.51,-870.4300000000001
13307,69118170,2023-02-08,110.44,-759.99
13308,69118170,2023-02-10,-180.0,-939.99
13309,69118170,2023-02-11,-130.27,-1070.26
13310,69118170,2023-02-14,439.8,-630.46
13311,69153577,2023-01-31,,402.52
13312,69153577,2023-02-05,-112.45,290.07
13313,69153577,2023-02-07,136.09,426.15999999999997
13314,69302678,2023-01-31,,568.08
13315,69302678,2023-02-05,62.49,630.57
13316,69302678,2023-02-10,86.78,717.35
13317,69302678,2023-02-11,213.76,931.11
13318,69302678,2023-02-12,132.03,1063.14
13319,69302678,2023-02-13,62.72,1125.8600000000001
13320,69306093,2023-01-31,,189.46
13321,69306093,2023-02-05,161.46,350.92
13322,69306093,2023-02-12,-20.96,329.96000000000004
13323,69307050,2023-01-31,,623.84
13324,69307050,2023-02-02,-62.13,561.71
13325,69307050,2023-02-02,-86.31,475.40000000000003
13326,69307050,2023-02-09,60.37,535.77
13327,69307050,2023-02-09,49.28,585.0500000000001
13328,69307050,2023-02-11,73.66,658.71
13329,69307050,2023-02-12,103.74,762.45
13330,69307050,2023-02-14,122.88,885.33
13331,69315008,2023-01-31,,923.08
13332,69315008,2023-02-01,1052.6,1975.6799999999998
13333,69315008,2023-02-01,-72.79,1902.8899999999999
13334,69315008,2023-02-02,180.4,2083.29
13335,69315008,2023-02-05,101.45,2184.74
13336,69315008,2023-02-07,-85.76,2098.98
13337,69315008,2023-02-09,-190.82,1908.1599999999999
13338,69315008,2023-02-12,139.75,2047.9099999999999
13339,69344396,2023-01-31,,304.19
13340,69344396,2023-02-02,1190.9,1495.0900000000001
13341,69344396,2023-02-03,97.42,1592.5100000000002
13342,69344396,2023-02-05,-138.9,1453.6100000000001
13343,69344396,2023-02-06,840.3,2293.91
13344,69344396,2023-02-10,87.07,2380.98
13345,69344396,2023-02-11,160.29,2541.27
13346,69344396,2023-02-11,78.29,2619.56
13347,69344396,2023-02-12,210.36,2829.92
13348,69344396,2023-02-12,118.77,2948.69
13349,69344396,2023-02-12,-44.88,2903.81
13350,69344396,2023-02-14,98.11,3001.92
13351,69362270,2023-01-31,,410.6
13352,69362270,2023-02-02,-179.0,231.60000000000002
13353,69362270,2023-02-05,-17.25,214.35000000000002
13354,69362270,2023-02-10,26.55,240.90000000000003
13355,69362270,2023-02-11,133.78,374.68000000000006
13356,69362270,2023-02-14,-126.46,248.22000000000003
13357,69446767,2023-01-31,,672.47
13358,69446767,2023-02-02,83.44,755.9100000000001
13359,69446767,2023-02-06,22.45,778.36
13360,69446767,2023-02-07,101.82,880.1800000000001
13361,69446767,2023-02-09,107.86,988.04
13362,69446767,2023-02-10,-137.34,850.7
13363,69446767,2023-02-11,-113.8,736.9
13364,69446767,2023-02-14,-141.48,595.4200000000001
13365,69447534,2023-01-31,,68.02
13366,69447534,2023-02-01,-105.36,-37.34
13367,69447534,2023-02-03,-121.82,-159.16
13368,69447534,2023-02-11,-68.33,-227.49
13369,69447534,2023-02-12,101.4,-126.08999999999999
13370,69447534,2023-02-13,-38.04,-164.13
13371,69468071,2023-01-31,,652.9
13372,69468071,2023-02-04,-81.16,571.74
13373,69468071,2023-02-05,111.92,683.66
13374,69468071,2023-02-06,1791.9,2475.56
13375,69468071,2023-02-06,137.34,2612.9
13376,69468071,2023-02-06,-67.45,2545.45
13377,69468071,2023-02-07,69.39,2614.84
13378,69468071,2023-02-08,166.6,2781.44
13379,69468071,2023-02-09,-36.71,2744.73
13380,69468071,2023-02-12,-16.68,2728.0499999999997
13381,69468071,2023-02-13,98.15,2826.2
13382,69492532,2023-01-31,,581.23
13383,69492532,2023-02-04,-119.25,461.98
13384,69492532,2023-02-11,-84.22,377.76
13385,69492532,2023-02-12,-200.04,177.72000000000003
13386,69533742,2023-01-31,,812.2
13387,69533742,2023-02-01,1397.4,2209.6000000000004
13388,69533742,2023-02-01,-12.21,2197.3900000000003
13389,69533742,2023-02-01,-96.51,2100.88
13390,69533742,2023-02-03,-175.55,1925.3300000000002
13391,69533742,2023-02-04,-82.56,1842.7700000000002
13392,69533742,2023-02-05,112.73,1955.5000000000002
13393,69533742,2023-02-06,129.51,2085.01
13394,69533742,2023-02-07,-98.42,1986.5900000000001
13395,69533742,2023-02-11,-65.15,1921.44
13396,69533742,2023-02-11,-75.14,1846.3000000000002
13397,69540137,2023-01-31,,351.36
13398,69540137,2023-02-02,109.28,460.64
13399,69540137,2023-02-06,473.7,934.34
13400,69540137,2023-02-06,51.71,986.0500000000001
13401,69540137,2023-02-07,173.55,1159.6000000000001
13402,69540137,2023-02-07,141.99,1301.5900000000001
13403,69540137,2023-02-11,32.04,1333.63
13404,69540137,2023-02-14,1314.7,2648.33
13405,69556322,2023-01-31,,785.03
13406,69556322,2023-02-01,102.91,887.9399999999999
13407,69556322,2023-02-02,24.87,912.81
13408,69556322,2023-02-03,112.15,1024.96
13409,69556322,2023-02-03,66.67,1091.6299999999999
13410,69556322,2023-02-06,68.0,1159.6299999999999
13411,69556322,2023-02-12,-125.48,1034.15
13412,69556322,2023-02-13,-62.36,971.79
13413,69556322,2023-02-14,1478.2,2449.99
13414,69556322,2023-02-14,1145.9,3595.8900000000003
13415,69561077,2023-01-31,,318.31
13416,69561077,2023-02-01,125.38,443.69
13417,69561077,2023-02-03,23.5,467.19
13418,69561077,2023-02-04,37.8,504.99
13419,69561077,2023-02-05,1917.1,2422.09
13420,69561077,2023-02-08,-167.35,2254.74
13421,69561077,2023-02-09,-56.02,2198.72
13422,69561077,2023-02-10,75.83,2274.5499999999997
13423,69561077,2023-02-11,132.56,2407.11
13424,69561077,2023-02-11,-104.82,2302.29
13425,69561077,2023-02-12,143.91,2446.2
13426,69588947,2023-01-31,,732.72
13427,69588947,2023-02-08,-66.6,666.12
13428,69588947,2023-02-09,-97.55,568.57
13429,69588947,2023-02-09,-114.45,454.12
13430,69588947,2023-02-10,-8.85,445.27000000000004
13431,69617552,2023-01-31,,853.9
13432,69617552,2023-02-03,-89.23,764.67
13433,69617552,2023-02-06,-96.79,667.88
13434,69617552,2023-02-08,-61.4,606.48
13435,69617552,2023-02-09,108.57,715.05
13436,69617552,2023-02-14,-188.3,526.75
13437,69647833,2023-01-31,,765.74
13438,69647833,2023-02-01,84.44,850.1800000000001
13439,69647833,2023-02-03,54.41,904.59
13440,69647833,2023-02-06,-160.08,744.51
13441,69647833,2023-02-07,170.65,915.16
13442,69647833,2023-02-07,-136.97,778.19
13443,69647833,2023-02-13,115.44,893.63
13444,69647833,2023-02-13,-107.16,786.47
13445,69648759,2023-01-31,,693.39
13446,69648759,2023-02-01,80.92,774.31
13447,69648759,2023-02-10,-155.67,618.64
13448,69648759,2023-02-13,-1503.2,-884.5600000000001
13449,69648759,2023-02-14,163.34,-721.22
13450,69648759,2023-02-14,-126.03,-847.25
13451,69664627,2023-01-31,,897.76
13452,69664627,2023-02-01,-130.78,766.98
13453,69664627,2023-02-07,218.78,985.76
13454,69664627,2023-02-10,28.25,1014.01
13455,69664627,2023-02-12,1482.9,2496.91
13456,69664627,2023-02-13,-163.99,2332.92
13457,69665438,2023-01-31,,417.78
13458,69665438,2023-02-01,-99.56,318.21999999999997
13459,69665438,2023-02-01,-158.57,159.64999999999998
13460,69665438,2023-02-05,-75.94,83.70999999999998
13461,69683385,2023-01-31,,519.63
13462,69683385,2023-02-04,54.37,574.0
13463,69683385,2023-02-07,-102.9,471.1
13464,69730266,2023-01-31,,732.61
13465,69730266,2023-02-04,-95.37,637.24
13466,69730266,2023-02-07,-105.66,531.58
13467,69730266,2023-02-09,102.69,634.27
13468,69730266,2023-02-12,-79.75,554.52
13469,69796371,2023-01-31,,649.23
13470,69796371,2023-02-02,-94.57,554.6600000000001
13471,69796371,2023-02-03,60.17,614.83
13472,69796371,2023-02-04,1412.5,2027.33
13473,69796371,2023-02-05,109.76,2137.09
13474,69796371,2023-02-06,182.28,2319.37
13475,69796371,2023-02-11,166.3,2485.67
13476,69796371,2023-02-14,2002.7,4488.37
13477,69806946,2023-01-31,,971.49
13478,69806946,2023-02-07,87.82,1059.31
13479,69806946,2023-02-08,-183.05,876.26
13480,69939682,2023-01-31,,854.18
13481,69939682,2023-02-01,94.91,949.0899999999999
13482,69939682,2023-02-01,-120.13,828.9599999999999
13483,69939682,2023-02-08,-5.73,823.2299999999999
13484,69939682,2023-02-09,-143.77,679.4599999999999
13485,69939682,2023-02-11,-214.9,464.55999999999995
13486,70010970,2023-01-31,,114.23
13487,70010970,2023-02-06,-128.7,-14.469999999999985
13488,70010970,2023-02-08,-69.02,-83.48999999999998
13489,70010970,2023-02-11,-181.68,-265.16999999999996
13490,70013367,2023-01-31,,38.86
13491,70013367,2023-02-04,-70.76,-31.900000000000006
13492,70013367,2023-02-06,660.3,628.4
13493,70013367,2023-02-06,138.83,767.23
13494,70013367,2023-02-09,140.35,907.5799999999999
13495,70013367,2023-02-13,-96.06,811.52
13496,70034563,2023-01-31,,723.18
13497,70034563,2023-02-01,149.8,872.98
13498,70034563,2023-02-02,-122.42,750.56
13499,70034563,2023-02-04,96.09,846.65
13500,70034563,2023-02-05,-137.98,708.67
13501,70034563,2023-02-13,-182.14,526.53
13502,70049609,2023-01-31,,226.63
13503,70049609,2023-02-07,89.73,316.36
13504,70049609,2023-02-07,75.13,391.49
13505,70049609,2023-02-10,-84.17,307.32
13506,70049609,2023-02-10,-109.89,197.43
13507,70049609,2023-02-13,101.66,299.09
13508,70049609,2023-02-14,103.89,402.98
13509,70123664,2023-01-31,,483.12
13510,70123664,2023-02-01,-122.51,360.61
13511,70123664,2023-02-02,-127.28,233.32999999999998
13512,70123664,2023-02-03,-114.58,118.75
13513,70123664,2023-02-04,24.31,143.06
13514,70123664,2023-02-08,-209.01,-65.94999999999999
13515,70129567,2023-01-31,,886.92
13516,70129567,2023-02-01,52.32,939.24
13517,70129567,2023-02-03,-98.67,840.5699999999999
13518,70129567,2023-02-04,-133.05,707.52
13519,70129567,2023-02-06,100.59,808.1099999999999
13520,70129567,2023-02-08,-149.26,658.8499999999999
13521,70129567,2023-02-09,175.39,834.24
13522,70129567,2023-02-10,65.29,899.53
13523,70129567,2023-02-10,-47.22,852.31
13524,70129567,2023-02-11,214.9,1067.21
13525,70129567,2023-02-11,-125.65,941.56
13526,70129567,2023-02-12,35.17,976.73
13527,70163139,2023-01-31,,674.14
13528,70163139,2023-02-01,85.94,760.0799999999999
13529,70163139,2023-02-05,116.16,876.24
13530,70163139,2023-02-06,-31.91,844.3299999999999
13531,70163139,2023-02-07,121.65,965.98
13532,70163139,2023-02-11,158.58,1124.56
13533,70163139,2023-02-11,100.86,1225.42
13534,70163139,2023-02-11,55.33,1280.75
13535,70163139,2023-02-12,170.4,1451.15
13536,70163139,2023-02-12,64.23,1515.38
13537,70163139,2023-02-14,48.39,1563.77
13538,70185446,2023-01-31,,863.26
13539,70185446,2023-02-08,191.64,1054.9
13540,70185446,2023-02-09,97.29,1152.19
13541,70185446,2023-02-11,96.92,1249.11
13542,70214700,2023-01-31,,152.79
13543,70214700,2023-02-01,-1255.3,-1102.51
13544,70214700,2023-02-02,-84.59,-1187.1
13545,70214700,2023-02-06,-1498.3,-2685.3999999999996
13546,70214700,2023-02-07,-89.15,-2774.5499999999997
13547,70214700,2023-02-12,127.0,-2647.5499999999997
13548,70214700,2023-02-14,33.09,-2614.46
13549,70214700,2023-02-14,-102.53,-2716.99
13550,70217229,2023-01-31,,705.69
13551,70217229,2023-02-02,190.9,896.59
13552,70217229,2023-02-02,167.22,1063.81
13553,70217229,2023-02-03,-127.58,936.23
13554,70217229,2023-02-06,59.52,995.7500000000001
13555,70217229,2023-02-12,129.61,1125.3600000000001
13556,70217229,2023-02-12,-491.6,633.76
13557,70217229,2023-02-14,-46.61,587.1500000000001
13558,70221848,2023-01-31,,550.83
13559,70221848,2023-02-01,69.91,620.74
13560,70221848,2023-02-03,175.55,796.2900000000001
13561,70221848,2023-02-05,23.13,819.4200000000001
13562,70221848,2023-02-08,149.26,968.6800000000001
13563,70231750,2023-01-31,,749.6
13564,70231750,2023-02-02,187.19,936.79
13565,70231750,2023-02-03,-2128.4,-1191.6100000000001
13566,70231750,2023-02-04,-148.06,-1339.67
13567,70231750,2023-02-04,-1618.2,-2957.87
13568,70231750,2023-02-09,112.38,-2845.4900000000002
13569,70231750,2023-02-10,-192.08,-3037.57
13570,70231750,2023-02-11,100.04,-2937.53
13571,70331285,2023-01-31,,537.34
13572,70331285,2023-02-08,-74.39,462.95000000000005
13573,70331285,2023-02-09,121.13,584.08
13574,70331285,2023-02-10,56.59,640.6700000000001
13575,70331285,2023-02-14,-105.11,535.5600000000001
13576,70351135,2023-01-31,,169.6
13577,70351135,2023-02-01,3.89,173.48999999999998
13578,70351135,2023-02-05,128.72,302.21
13579,70351135,2023-02-13,-167.52,134.68999999999997
13580,70375931,2023-01-31,,980.21
13581,70375931,2023-02-05,92.89,1073.1000000000001
13582,70375931,2023-02-07,-152.96,920.1400000000001
13583,70375931,2023-02-11,87.16,1007.3000000000001
13584,70375931,2023-02-13,159.46,1166.76
13585,70384410,2023-01-31,,718.99
13586,70384410,2023-02-04,122.2,841.19
13587,70384410,2023-02-04,-129.64,711.55
13588,70384410,2023-02-09,969.7,1681.25
13589,70384410,2023-02-11,-55.38,1625.87
13590,70384410,2023-02-13,153.4,1779.27
13591,70385129,2023-01-31,,252.45
13592,70385129,2023-02-01,121.46,373.90999999999997
13593,70385129,2023-02-08,25.37,399.28
13594,70385129,2023-02-10,134.99,534.27
13595,70409852,2023-01-31,,662.8
13596,70409852,2023-02-04,-81.35,581.4499999999999
13597,70409852,2023-02-06,137.14,718.5899999999999
13598,70409852,2023-02-09,-67.33,651.26
13599,70409852,2023-02-10,25.41,676.67
13600,70409852,2023-02-11,102.16,778.8299999999999
13601,70469258,2023-01-31,,868.53
13602,70469258,2023-02-04,-71.39,797.14
13603,70469258,2023-02-05,2112.8,2909.94
13604,70469258,2023-02-08,80.16,2990.1
13605,70469258,2023-02-09,-171.71,2818.39
13606,70469258,2023-02-10,-1575.6,1242.7900000000002
13607,70469258,2023-02-14,-47.11,1195.6800000000003
13608,70505401,2023-01-31,,138.85
13609,70505401,2023-02-04,113.98,252.82999999999998
13610,70505401,2023-02-04,-113.98,138.85
13611,70505401,2023-02-11,123.81,262.65999999999997
13612,70505401,2023-02-11,-58.36,204.3
13613,70505401,2023-02-14,-884.5,-680.2
13614,70554021,2023-01-31,,44.26
13615,70554021,2023-02-05,129.49,173.75
13616,70554021,2023-02-06,-116.65,57.099999999999994
13617,70554021,2023-02-10,-1188.3,-1131.2
13618,70554021,2023-02-11,126.09,-1005.11
13619,70554021,2023-02-11,78.25,-926.86
13620,70554021,2023-02-12,63.69,-863.1700000000001
13621,70567557,2023-01-31,,984.3
13622,70567557,2023-02-07,41.64,1025.94
13623,70567557,2023-02-08,185.22,1211.1599999999999
13624,70567557,2023-02-08,-87.73,1123.43
13625,70567557,2023-02-13,129.32,1252.75
13626,70567557,2023-02-14,113.78,1366.53
13627,70571486,2023-01-31,,573.26
13628,70571486,2023-02-01,-52.17,521.09
13629,70571486,2023-02-07,-639.3,-118.20999999999992
13630,70571486,2023-02-10,-39.45,-157.6599999999999
13631,70571486,2023-02-11,115.25,-42.409999999999926
13632,70571486,2023-02-12,47.25,4.8400000000000745
13633,70624878,2023-01-31,,328.5
13634,70624878,2023-02-01,-158.51,169.99
13635,70624878,2023-02-03,825.8,995.79
13636,70624878,2023-02-05,190.77,1186.56
13637,70624878,2023-02-08,190.88,1377.44
13638,70624878,2023-02-08,-94.34,1283.1
13639,70624878,2023-02-08,-1051.3,231.79999999999995
13640,70643766,2023-01-31,,143.86
13641,70643766,2023-02-03,-192.08,-48.22
13642,70643766,2023-02-07,-140.14,-188.35999999999999
13643,70652524,2023-01-31,,342.86
13644,70652524,2023-02-05,81.18,424.04
13645,70652524,2023-02-05,76.23,500.27000000000004
13646,70652524,2023-02-07,61.37,561.64
13647,70652524,2023-02-11,89.98,651.62
13648,70652524,2023-02-12,104.46,756.08
13649,70665892,2023-01-31,,856.22
13650,70665892,2023-02-01,-165.66,690.5600000000001
13651,70665892,2023-02-04,45.03,735.59
13652,70665892,2023-02-08,113.92,849.51
13653,70665892,2023-02-09,1365.7,2215.21
13654,70665892,2023-02-11,-43.12,2172.09
13655,70665892,2023-02-12,245.7,2417.79
13656,70719064,2023-01-31,,752.97
13657,70719064,2023-02-02,1805.5,2558.4700000000003
13658,70719064,2023-02-02,-198.45,2360.02
13659,70719064,2023-02-04,-163.96,2196.06
13660,70719064,2023-02-06,965.2,3161.26
13661,70719064,2023-02-08,145.4,3306.6600000000003
13662,70719064,2023-02-11,40.22,3346.88
13663,70749706,2023-01-31,,963.82
13664,70749706,2023-02-01,-119.88,843.94
13665,70749706,2023-02-04,-122.23,721.71
13666,70749706,2023-02-07,-137.51,584.2
13667,70749706,2023-02-09,-150.23,433.97
13668,70749706,2023-02-10,58.75,492.72
13669,70749706,2023-02-12,-91.93,400.7900000000001
13670,70905083,2023-01-31,,623.65
13671,70905083,2023-02-02,131.53,755.18
13672,70905083,2023-02-02,119.89,875.0699999999999
13673,70905083,2023-02-03,133.41,1008.48
13674,70905083,2023-02-07,103.35,1111.83
13675,70920653,2023-01-31,,577.7
13676,70920653,2023-02-02,-88.8,488.90000000000003
13677,70920653,2023-02-04,-97.81,391.09000000000003
13678,70920653,2023-02-10,123.77,514.86
13679,70925461,2023-01-31,,260.33
13680,70925461,2023-02-01,-66.84,193.48999999999998
13681,70925461,2023-02-03,97.5,290.99
13682,70925461,2023-02-06,134.68,425.66999999999996
13683,70925461,2023-02-06,46.16,471.83
13684,70925461,2023-02-06,-126.83,345.0
13685,70925461,2023-02-07,-154.41,190.58999999999997
13686,70925461,2023-02-08,121.98,312.57
13687,70925461,2023-02-08,-103.89,208.67999999999998
13688,70925461,2023-02-09,201.62,410.29999999999995
13689,70925461,2023-02-09,-287.8,122.5
13690,70925461,2023-02-12,-100.25,22.25
13691,70925461,2023-02-12,-907.1,-884.85
13692,70954264,2023-01-31,,331.51
13693,70954264,2023-02-01,-142.91,188.6
13694,70954264,2023-02-02,-81.2,107.39999999999999
13695,70954264,2023-02-08,-35.81,71.58999999999999
13696,70954264,2023-02-10,113.81,185.39999999999998
13697,70954264,2023-02-10,-64.46,120.94
13698,70954264,2023-02-10,-90.32,30.620000000000005
13699,70954264,2023-02-12,-76.6,-45.97999999999999
13700,70954264,2023-02-12,-82.91,-128.89
13701,70954264,2023-02-13,-101.48,-230.37
13702,70989002,2023-01-31,,220.06
13703,70989002,2023-02-03,-134.37,85.69
13704,70989002,2023-02-04,134.48,220.17
13705,70989002,2023-02-04,-111.19,108.97999999999999
13706,70989002,2023-02-05,298.3,407.28
13707,70989002,2023-02-05,102.18,509.46000000000004
13708,70989002,2023-02-06,116.65,626.11
13709,70989002,2023-02-12,-87.73,538.38
13710,70989002,2023-02-13,156.04,694.4200000000001
13711,71014167,2023-01-31,,654.16
13712,71014167,2023-02-01,58.05,712.2099999999999
13713,71014167,2023-02-02,72.72,784.93
13714,71014167,2023-02-04,-118.37,666.56
13715,71014167,2023-02-06,-46.33,620.23
13716,71014167,2023-02-07,122.53,742.76
13717,71014167,2023-02-12,-84.75,658.01
13718,71014167,2023-02-14,80.98,738.99
13719,71045135,2023-01-31,,98.76
13720,71045135,2023-02-11,-43.47,55.290000000000006
13721,71045135,2023-02-11,-989.3,-934.01
13722,71045135,2023-02-12,54.92,-879.09
13723,71045135,2023-02-14,-133.71,-1012.8
13724,71051904,2023-01-31,,48.92
13725,71051904,2023-02-02,-93.84,-44.92
13726,71051904,2023-02-06,102.1,57.17999999999999
13727,71051904,2023-02-08,117.36,174.54
13728,71051904,2023-02-13,-2.26,172.28
13729,71082437,2023-01-31,,717.98
13730,71082437,2023-02-04,111.19,829.1700000000001
13731,71082437,2023-02-06,-51.53,777.64
13732,71082437,2023-02-11,111.11,888.75
13733,71082437,2023-02-11,-122.42,766.33
13734,71082437,2023-02-12,96.6,862.9300000000001
13735,71082437,2023-02-13,-76.11,786.82
13736,71135606,2023-01-31,,728.32
13737,71135606,2023-02-02,-99.44,628.8800000000001
13738,71135606,2023-02-02,-104.5,524.3800000000001
13739,71135606,2023-02-04,-47.16,477.22
13740,71135606,2023-02-08,-65.06,412.1600000000001
13741,71135606,2023-02-09,159.05,571.21
13742,71135606,2023-02-09,66.83,638.0400000000001
13743,71135606,2023-02-12,-26.59,611.45
13744,71135606,2023-02-12,-116.83,494.62000000000006
13745,71135606,2023-02-13,73.19,567.8100000000001
13746,71137421,2023-01-31,,65.44
13747,71137421,2023-02-01,61.08,126.52
13748,71137421,2023-02-02,109.29,235.81
13749,71137421,2023-02-02,-27.44,208.37
13750,71137421,2023-02-07,53.78,262.15
13751,71137421,2023-02-07,-79.99,182.16000000000003
13752,71137421,2023-02-07,-949.2,-767.04
13753,71137421,2023-02-08,190.12,-576.92
13754,71137421,2023-02-14,-123.69,-700.6099999999999
13755,71161073,2023-01-31,,861.98
13756,71161073,2023-02-01,-99.52,762.46
13757,71161073,2023-02-02,-94.2,668.26
13758,71161073,2023-02-09,191.29,859.55
13759,71183710,2023-01-31,,989.68
13760,71183710,2023-02-02,-77.54,912.14
13761,71183710,2023-02-03,5.31,917.4499999999999
13762,71183710,2023-02-03,-65.8,851.65
13763,71183710,2023-02-04,-143.95,707.6999999999999
13764,71183710,2023-02-06,-68.0,639.6999999999999
13765,71183710,2023-02-07,-86.52,553.18
13766,71183710,2023-02-08,68.68,621.86
13767,71183710,2023-02-13,-77.91,543.9499999999999
13768,71213535,2023-01-31,,686.81
13769,71213535,2023-02-07,83.34,770.15
13770,71213535,2023-02-08,218.9,989.05
13771,71213535,2023-02-08,136.73,1125.78
13772,71247681,2023-01-31,,955.43
13773,71247681,2023-02-03,-114.47,840.9599999999999
13774,71247681,2023-02-11,-130.08,710.8799999999999
13775,71247681,2023-02-14,-93.52,617.3599999999999
13776,71264941,2023-01-31,,195.49
13777,71264941,2023-02-01,170.89,366.38
13778,71264941,2023-02-01,160.38,526.76
13779,71264941,2023-02-01,92.64,619.4
13780,71264941,2023-02-06,-33.32,586.08
13781,71264941,2023-02-10,19.72,605.8
13782,71264941,2023-02-11,196.49,802.29
13783,71264941,2023-02-11,101.84,904.13
13784,71264941,2023-02-11,-6.42,897.71
13785,71264941,2023-02-11,-222.05,675.66
13786,71266283,2023-01-31,,496.77
13787,71266283,2023-02-04,1218.0,1714.77
13788,71266283,2023-02-05,134.86,1849.63
13789,71266283,2023-02-07,-151.33,1698.3
13790,71266283,2023-02-09,105.21,1803.51
13791,71266283,2023-02-09,-61.15,1742.36
13792,71266283,2023-02-13,138.97,1881.33
13793,71266283,2023-02-13,18.04,1899.37
13794,71266283,2023-02-13,-223.88,1675.49
13795,71280775,2023-01-31,,427.44
13796,71280775,2023-02-03,65.8,493.24
13797,71280775,2023-02-03,-124.88,368.36
13798,71280775,2023-02-04,148.06,516.4200000000001
13799,71280775,2023-02-05,-114.23,402.19
13800,71280775,2023-02-06,127.87,530.0600000000001
13801,71280775,2023-02-06,91.85,621.91
13802,71280775,2023-02-06,-1176.9,-554.9900000000001
13803,71280775,2023-02-09,112.69,-442.3000000000001
13804,71293250,2023-01-31,,686.0
13805,71293250,2023-02-04,-5.86,680.14
13806,71293250,2023-02-06,120.15,800.29
13807,71293250,2023-02-08,90.09,890.38
13808,71293250,2023-02-11,-99.36,791.02
13809,71332337,2023-01-31,,661.23
13810,71332337,2023-02-07,-1434.3,-773.0699999999999
13811,71332337,2023-02-08,113.65,-659.42
13812,71332337,2023-02-08,-195.95,-855.3699999999999
13813,71332337,2023-02-10,88.33,-767.04
13814,71332337,2023-02-12,120.12,-646.92
13815,71332337,2023-02-14,-95.87,-742.79
13816,71381278,2023-01-31,,592.79
13817,71381278,2023-02-03,-66.67,526.12
13818,71381278,2023-02-09,82.1,608.2199999999999
13819,71381278,2023-02-11,1243.0,1851.2199999999998
13820,71381278,2023-02-11,-190.18,1661.0399999999997
13821,71381278,2023-02-12,-245.7,1415.3399999999997
13822,71381278,2023-02-14,125.94,1541.2799999999997
13823,71383376,2023-01-31,,448.26
13824,71383376,2023-02-01,-170.96,277.29999999999995
13825,71383376,2023-02-03,1619.6,1896.8999999999999
13826,71383376,2023-02-04,-884.9,1011.9999999999999
13827,71383376,2023-02-07,92.7,1104.6999999999998
13828,71383376,2023-02-09,-105.71,998.9899999999999
13829,71383376,2023-02-10,94.14,1093.1299999999999
13830,71383376,2023-02-11,39.58,1132.7099999999998
13831,71394875,2023-01-31,,778.77
13832,71394875,2023-02-01,-112.34,666.43
13833,71394875,2023-02-03,165.51,831.9399999999999
13834,71394875,2023-02-04,40.15,872.0899999999999
13835,71394875,2023-02-05,68.75,940.8399999999999
13836,71394875,2023-02-06,-144.68,796.16
13837,71394875,2023-02-13,158.03,954.1899999999999
13838,71394875,2023-02-14,-67.36,886.8299999999999
13839,71444662,2023-01-31,,276.78
13840,71444662,2023-02-01,-101.08,175.7
13841,71444662,2023-02-02,-116.0,59.699999999999974
13842,71444662,2023-02-04,-1131.3,-1071.6
13843,71444662,2023-02-07,87.19,-984.4099999999999
13844,71444662,2023-02-12,-67.65,-1052.06
13845,71444662,2023-02-13,181.51,-870.55
13846,71444662,2023-02-14,-124.76,-995.31
13847,71469803,2023-01-31,,14.79
13848,71469803,2023-02-05,151.15,165.94
13849,71469803,2023-02-05,-118.02,47.92
13850,71469803,2023-02-11,-191.93,-144.01
13851,71469803,2023-02-14,141.49,-2.519999999999982
13852,71469803,2023-02-14,-64.89,-67.40999999999998
13853,71536854,2023-01-31,,42.99
13854,71536854,2023-02-06,-93.96,-50.96999999999999
13855,71536854,2023-02-10,-181.0,-231.97
13856,71536854,2023-02-11,142.47,-89.5
13857,71536854,2023-02-11,-112.1,-201.6
13858,71562080,2023-01-31,,352.05
13859,71562080,2023-02-04,63.81,415.86
13860,71562080,2023-02-09,101.51,517.37
13861,71562080,2023-02-14,-135.72,381.65000000000003
13862,71594658,2023-01-31,,392.66
13863,71594658,2023-02-07,67.95,460.61
13864,71594658,2023-02-10,-93.37,367.24
13865,71594658,2023-02-11,36.36,403.6
13866,71594658,2023-02-11,-102.91,300.69000000000005
13867,71594658,2023-02-12,108.19,408.88
13868,71594658,2023-02-12,81.87,490.75
13869,71594658,2023-02-14,-7.26,483.49
13870,71643841,2023-01-31,,232.5
13871,71643841,2023-02-03,161.37,393.87
13872,71643841,2023-02-06,-113.63,280.24
13873,71643841,2023-02-12,71.39,351.63
13874,71643841,2023-02-13,125.16,476.79
13875,71643841,2023-02-14,-1308.6,-831.81
13876,71675127,2023-01-31,,353.48
13877,71675127,2023-02-02,143.95,497.43
13878,71675127,2023-02-07,-171.53,325.9
13879,71675127,2023-02-11,82.38,408.28
13880,71718483,2023-01-31,,747.34
13881,71718483,2023-02-01,1089.6,1836.94
13882,71718483,2023-02-02,1193.3,3030.24
13883,71718483,2023-02-02,94.57,3124.81
13884,71718483,2023-02-02,-100.61,3024.2
13885,71718483,2023-02-02,-112.35,2911.85
13886,71718483,2023-02-09,42.25,2954.1
13887,71718483,2023-02-12,90.33,3044.43
13888,71718483,2023-02-13,167.52,3211.95
13889,71791483,2023-01-31,,873.44
13890,71791483,2023-02-03,99.93,973.3700000000001
13891,71791483,2023-02-04,-34.64,938.73
13892,71791483,2023-02-12,-86.27,852.46
13893,71792376,2023-01-31,,4.39
13894,71792376,2023-02-02,-50.71,-46.32
13895,71792376,2023-02-03,-76.87,-123.19
13896,71792376,2023-02-07,74.77,-48.42
13897,71792376,2023-02-09,-68.62,-117.04
13898,71792376,2023-02-09,-160.1,-277.14
13899,71792376,2023-02-11,52.48,-224.66000000000003
13900,71792376,2023-02-11,-84.08,-308.74
13901,71792376,2023-02-14,90.48,-218.26
13902,71825742,2023-01-31,,665.75
13903,71825742,2023-02-02,198.28,864.03
13904,71825742,2023-02-08,-968.8,-104.76999999999998
13905,71852263,2023-01-31,,676.77
13906,71852263,2023-02-10,42.14,718.91
13907,71852263,2023-02-14,163.23,882.14
13908,71868471,2023-01-31,,474.32
13909,71868471,2023-02-05,-1315.1,-840.78
13910,71868471,2023-02-07,189.62,-651.16
13911,71868471,2023-02-08,196.25,-454.90999999999997
13912,71868471,2023-02-11,-121.25,-576.16
13913,71868471,2023-02-12,7.59,-568.5699999999999
13914,71913103,2023-01-31,,5.42
13915,71913103,2023-02-02,117.49,122.91
13916,71913103,2023-02-06,121.13,244.04
13917,71913103,2023-02-07,127.37,371.40999999999997
13918,71913103,2023-02-08,40.97,412.38
13919,71934515,2023-01-31,,340.99
13920,71934515,2023-02-05,59.47,400.46000000000004
13921,71934515,2023-02-06,-1011.5,-611.04
13922,71934515,2023-02-08,150.55,-460.48999999999995
13923,71934515,2023-02-08,-358.9,-819.3899999999999
13924,71934515,2023-02-09,-82.1,-901.4899999999999
13925,71939863,2023-01-31,,116.31
13926,71939863,2023-02-01,136.22,252.53
13927,71939863,2023-02-05,110.09,362.62
13928,71939863,2023-02-06,995.2,1357.8200000000002
13929,71939863,2023-02-11,102.84,1460.66
13930,72008772,2023-01-31,,725.22
13931,72008772,2023-02-01,-110.9,614.32
13932,72008772,2023-02-03,1791.6,2405.92
13933,72008772,2023-02-04,-112.22,2293.7000000000003
13934,72008772,2023-02-06,95.71,2389.41
13935,72008772,2023-02-06,60.85,2450.26
13936,72008772,2023-02-09,83.64,2533.9
13937,72008772,2023-02-09,-175.39,2358.51
13938,72008772,2023-02-13,81.86,2440.37
13939,72008772,2023-02-14,-113.47,2326.9
13940,72050477,2023-01-31,,95.87
13941,72050477,2023-02-03,-106.6,-10.72999999999999
13942,72050477,2023-02-08,156.86,146.13000000000002
13943,72055977,2023-01-31,,172.73
13944,72055977,2023-02-09,624.2,796.9300000000001
13945,72055977,2023-02-09,108.23,905.1600000000001
13946,72055977,2023-02-10,-178.01,727.1500000000001
13947,72055977,2023-02-11,78.66,805.8100000000001
13948,72087700,2023-01-31,,359.55
13949,72087700,2023-02-06,160.25,519.8
13950,72087700,2023-02-07,229.29,749.09
13951,72087700,2023-02-09,25.58,774.67
13952,72087700,2023-02-12,-109.9,664.77
13953,72087700,2023-02-13,125.92,790.69
13954,72120467,2023-01-31,,340.15
13955,72120467,2023-02-04,-75.25,264.9
13956,72120467,2023-02-11,-125.55,139.34999999999997
13957,72164482,2023-01-31,,535.39
13958,72164482,2023-02-02,-83.79,451.59999999999997
13959,72164482,2023-02-09,-951.0,-499.40000000000003
13960,72164482,2023-02-10,-89.11,-588.51
13961,72164482,2023-02-12,643.6,55.09000000000003
13962,72176895,2023-01-31,,109.78
13963,72176895,2023-02-03,64.91,174.69
13964,72176895,2023-02-09,160.54,335.23
13965,72176895,2023-02-09,-38.14,297.09
13966,72176895,2023-02-13,150.38,447.46999999999997
13967,72176895,2023-02-13,-837.4,-389.93
13968,72208029,2023-01-31,,11.37
13969,72208029,2023-02-01,0.5,11.87
13970,72208029,2023-02-02,-181.62,-169.75
13971,72208029,2023-02-05,-139.1,-308.85
13972,72208029,2023-02-06,66.16,-242.69
13973,72208029,2023-02-06,-1024.2,-1266.89
13974,72208029,2023-02-09,-140.11,-1407.0
13975,72208029,2023-02-09,-173.88,-1580.88
13976,72208029,2023-02-10,-80.36,-1661.24
13977,72208029,2023-02-13,-102.22,-1763.46
13978,72208029,2023-02-14,-141.62,-1905.0800000000002
13979,72230395,2023-01-31,,773.55
13980,72230395,2023-02-03,155.02,928.5699999999999
13981,72230395,2023-02-03,-130.74,797.8299999999999
13982,72230395,2023-02-09,-53.95,743.88
13983,72230395,2023-02-11,-86.69,657.1899999999999
13984,72230395,2023-02-13,-518.3,138.89
13985,72230395,2023-02-14,-597.7,-458.81000000000006
13986,72268811,2023-01-31,,694.68
13987,72268811,2023-02-02,-62.04,632.64
13988,72268811,2023-02-02,-151.37,481.27
13989,72268811,2023-02-03,133.85,615.1199999999999
13990,72268811,2023-02-08,70.08,685.1999999999999
13991,72268811,2023-02-09,-134.21,550.99
13992,72268811,2023-02-11,132.94,683.93
13993,72268811,2023-02-12,84.13,768.06
13994,72289791,2023-01-31,,502.96
13995,72289791,2023-02-02,130.94,633.9
13996,72289791,2023-02-07,185.39,819.29
13997,72289791,2023-02-07,11.99,831.28
13998,72289791,2023-02-10,-1046.8,-215.51999999999998
13999,72289791,2023-02-11,-63.8,-279.32
14000,72292735,2023-01-31,,723.43
14001,72292735,2023-02-01,-50.95,672.4799999999999
14002,72292735,2023-02-01,-153.65,518.8299999999999
14003,72292735,2023-02-04,-122.2,396.62999999999994
14004,72292735,2023-02-09,128.31,524.9399999999999
14005,72292735,2023-02-09,-54.57,470.36999999999995
14006,72292735,2023-02-10,-88.62,381.74999999999994
14007,72292735,2023-02-12,19.98,401.72999999999996
14008,72292735,2023-02-14,54.0,455.72999999999996
14009,72309641,2023-01-31,,386.61
14010,72309641,2023-02-05,179.34,565.95
14011,72309641,2023-02-06,-96.4,469.55
14012,72309641,2023-02-07,-0.83,468.72
14013,72309641,2023-02-11,-2.2,466.52000000000004
14014,72309641,2023-02-13,-138.24,328.28
14015,72309641,2023-02-14,-1323.7,-995.4200000000001
14016,72323206,2023-01-31,,372.97
14017,72323206,2023-02-06,71.4,444.37
14018,72323206,2023-02-09,-135.68,308.69000000000005
14019,72323206,2023-02-11,-126.09,182.60000000000002
14020,72323206,2023-02-13,132.93,315.53000000000003
14021,72354216,2023-01-31,,852.23
14022,72354216,2023-02-02,118.23,970.46
14023,72354216,2023-02-05,-81.6,888.86
14024,72354216,2023-02-07,-145.86,743.0
14025,72354216,2023-02-10,-62.94,680.06
14026,72354216,2023-02-11,-165.48,514.58
14027,72354216,2023-02-12,742.0,1256.58
14028,72354216,2023-02-13,1127.3,2383.88
14029,72354216,2023-02-13,-147.05,2236.83
14030,72354216,2023-02-14,-2010.0,226.83000000000015
14031,72446758,2023-01-31,,893.64
14032,72446758,2023-02-08,67.6,961.24
14033,72446758,2023-02-08,-153.92,807.3199999999999
14034,72446758,2023-02-08,-196.25,611.0699999999999
14035,72446758,2023-02-12,-58.82,552.25
14036,72446758,2023-02-14,-141.49,410.76
14037,72450129,2023-01-31,,905.61
14038,72450129,2023-02-01,-208.23,697.38
14039,72450129,2023-02-02,90.38,787.76
14040,72450129,2023-02-03,130.7,918.46
14041,72450129,2023-02-03,98.53,1016.99
14042,72450129,2023-02-10,156.28,1173.27
14043,72450129,2023-02-14,112.23,1285.5
14044,72466733,2023-01-31,,580.24
14045,72466733,2023-02-03,474.7,1054.94
14046,72466733,2023-02-08,-61.29,993.65
14047,72466733,2023-02-09,138.48,1132.13
14048,72466733,2023-02-10,-78.83,1053.3
14049,72526383,2023-01-31,,885.37
14050,72526383,2023-02-07,853.6,1738.97
14051,72526383,2023-02-08,93.74,1832.71
14052,72526383,2023-02-08,-13.55,1819.16
14053,72526383,2023-02-08,-166.6,1652.56
14054,72526383,2023-02-12,895.2,2547.76
14055,72526383,2023-02-13,-93.82,2453.94
14056,72558185,2023-01-31,,793.9
14057,72558185,2023-02-08,77.8,871.6999999999999
14058,72600465,2023-01-31,,595.44
14059,72600465,2023-02-03,108.6,704.0400000000001
14060,72600465,2023-02-09,-197.63,506.4100000000001
14061,72623919,2023-01-31,,610.63
14062,72623919,2023-02-03,119.56,730.19
14063,72623919,2023-02-07,644.8,1374.99
14064,72623919,2023-02-07,-65.6,1309.39
14065,72623919,2023-02-08,-72.15,1237.24
14066,72623919,2023-02-12,-803.9,433.34000000000003
14067,72623919,2023-02-13,98.45,531.7900000000001
14068,72627756,2023-01-31,,473.02
14069,72627756,2023-02-02,63.42,536.4399999999999
14070,72627756,2023-02-04,44.62,581.06
14071,72627756,2023-02-05,94.48,675.54
14072,72627756,2023-02-05,-98.07,577.47
14073,72627756,2023-02-12,49.53,627.0
14074,72627756,2023-02-12,-54.92,572.08
14075,72716288,2023-01-31,,167.69
14076,72716288,2023-02-05,-118.55,49.14
14077,72716288,2023-02-07,1282.4,1331.5400000000002
14078,72716288,2023-02-09,-36.48,1295.0600000000002
14079,72771982,2023-01-31,,501.76
14080,72771982,2023-02-02,-95.09,406.66999999999996
14081,72771982,2023-02-05,-74.98,331.69
14082,72771982,2023-02-06,-94.32,237.37
14083,72771982,2023-02-12,81.63,319.0
14084,72771982,2023-02-13,-86.2,232.79999999999998
14085,72784766,2023-01-31,,181.69
14086,72784766,2023-02-01,161.31,343.0
14087,72784766,2023-02-01,-142.14,200.86
14088,72784766,2023-02-09,1288.6,1489.46
14089,72784766,2023-02-11,482.1,1971.56
14090,72784766,2023-02-11,131.61,2103.17
14091,72784766,2023-02-14,170.29,2273.46
14092,72799297,2023-01-31,,614.69
14093,72799297,2023-02-04,-45.45,569.24
14094,72809561,2023-01-31,,270.68
14095,72809561,2023-02-02,156.52,427.20000000000005
14096,72809561,2023-02-02,-62.51,364.69
14097,72809561,2023-02-03,111.35,476.04
14098,72809561,2023-02-09,-69.0,407.04
14099,72809561,2023-02-10,-151.75,255.29000000000002
14100,72809943,2023-01-31,,870.72
14101,72809943,2023-02-02,71.36,942.08
14102,72809943,2023-02-02,-91.97,850.11
14103,72809943,2023-02-03,-111.24,738.87
14104,72809943,2023-02-06,-57.47,681.4000000000001
14105,72809943,2023-02-06,-96.19,585.21
14106,72809943,2023-02-07,-113.01,472.20000000000005
14107,72809943,2023-02-07,-125.73,346.47
14108,72809943,2023-02-08,-93.19,253.28000000000003
14109,72809943,2023-02-09,-118.62,134.66000000000003
14110,72809943,2023-02-12,99.3,233.96000000000004
14111,72809943,2023-02-14,1297.2,1531.16
14112,72809943,2023-02-14,116.09,1647.25
14113,72812647,2023-01-31,,351.84
14114,72812647,2023-02-01,-134.43,217.40999999999997
14115,72812647,2023-02-02,-73.15,144.25999999999996
14116,72812647,2023-02-06,20.39,164.64999999999998
14117,72812647,2023-02-07,74.77,239.41999999999996
14118,72812647,2023-02-08,209.9,449.31999999999994
14119,72812647,2023-02-11,-159.08,290.23999999999995
14120,72856610,2023-01-31,,576.08
14121,72856610,2023-02-01,103.99,680.07
14122,72856610,2023-02-02,107.47,787.5400000000001
14123,72856610,2023-02-05,8.72,796.26
14124,72856610,2023-02-05,-76.11,720.1500000000001
14125,72856610,2023-02-06,140.03,860.1800000000001
14126,72856610,2023-02-08,114.69,974.87
14127,72856610,2023-02-13,-74.01,900.86
14128,72894034,2023-01-31,,74.8
14129,72894034,2023-02-01,164.31,239.11
14130,72894034,2023-02-04,79.24,318.35
14131,72894034,2023-02-12,-57.16,261.19
14132,72925782,2023-01-31,,351.64
14133,72925782,2023-02-02,121.58,473.21999999999997
14134,72925782,2023-02-04,761.9,1235.12
14135,72925782,2023-02-05,-12.23,1222.89
14136,72925782,2023-02-09,-99.11,1123.78
14137,72925782,2023-02-11,-149.84,973.94
14138,72934756,2023-01-31,,829.55
14139,72934756,2023-02-01,856.5,1686.05
14140,72934756,2023-02-01,12.83,1698.8799999999999
14141,72934756,2023-02-01,-127.57,1571.31
14142,72934756,2023-02-02,-94.69,1476.62
14143,72934756,2023-02-03,28.47,1505.09
14144,72934756,2023-02-04,-1080.2,424.8899999999999
14145,72934756,2023-02-07,66.78,491.66999999999985
14146,72934756,2023-02-14,-63.85,427.8199999999999
14147,72971287,2023-01-31,,890.23
14148,72971287,2023-02-01,67.52,957.75
14149,72971287,2023-02-01,-65.26,892.49
14150,72971287,2023-02-02,122.23,1014.72
14151,72971287,2023-02-10,-1038.8,-24.079999999999927
14152,72971287,2023-02-11,-87.08,-111.15999999999993
14153,72971287,2023-02-13,109.33,-1.8299999999999272
14154,72986897,2023-01-31,,603.23
14155,72986897,2023-02-04,-42.74,560.49
14156,72986897,2023-02-07,-182.69,377.8
14157,72986897,2023-02-08,72.05,449.85
14158,72986897,2023-02-09,69.41,519.26
14159,72986897,2023-02-12,1682.4,2201.66
14160,72986897,2023-02-14,86.1,2287.76
14161,72995062,2023-01-31,,506.73
14162,72995062,2023-02-01,321.2,827.9300000000001
14163,72995062,2023-02-03,121.77,949.7
14164,72995062,2023-02-03,-105.23,844.47
14165,72995062,2023-02-05,-175.88,668.59
14166,72995062,2023-02-08,173.81,842.4
14167,72995062,2023-02-09,-73.82,768.58
14168,72995062,2023-02-14,321.9,1090.48
14169,72996601,2023-01-31,,730.27
14170,72996601,2023-02-03,-50.42,679.85
14171,72996601,2023-02-03,-201.14,478.71
14172,72996601,2023-02-04,-84.53,394.17999999999995
14173,72996601,2023-02-07,78.2,472.38
14174,72996601,2023-02-08,157.52,629.9
14175,72996601,2023-02-10,93.87,723.77
14176,72996601,2023-02-10,-989.8,-266.03
14177,72996601,2023-02-11,-113.52,-379.54999999999995
14178,72996601,2023-02-13,-106.08,-485.63
14179,73009461,2023-01-31,,938.52
14180,73009461,2023-02-04,-89.19,849.3299999999999
14181,73009461,2023-02-09,125.67,975.0
14182,73009461,2023-02-10,97.88,1072.8799999999999
14183,73009461,2023-02-13,-26.0,1046.8799999999999
14184,73009461,2023-02-14,88.67,1135.55
14185,73015538,2023-01-31,,634.94
14186,73015538,2023-02-01,249.75,884.69
14187,73015538,2023-02-02,-526.8,357.8900000000001
14188,73015538,2023-02-03,-37.15,320.7400000000001
14189,73015538,2023-02-07,-1190.8,-870.0599999999998
14190,73015538,2023-02-08,903.3,33.24000000000012
14191,73015538,2023-02-09,107.47,140.71000000000012
14192,73015538,2023-02-10,85.7,226.41000000000014
14193,73015538,2023-02-11,557.0,783.4100000000001
14194,73039019,2023-01-31,,360.0
14195,73039019,2023-02-05,175.88,535.88
14196,73039019,2023-02-09,-176.56,359.32
14197,73039019,2023-02-11,-35.07,324.25
14198,73059951,2023-01-31,,955.01
14199,73059951,2023-02-02,128.13,1083.1399999999999
14200,73059951,2023-02-03,53.78,1136.92
14201,73059951,2023-02-04,198.37,1335.29
14202,73059951,2023-02-07,65.96,1401.25
14203,73059951,2023-02-12,206.28,1607.53
14204,73080553,2023-01-31,,880.06
14205,73080553,2023-02-04,-79.24,800.8199999999999
14206,73080553,2023-02-10,59.44,860.26
14207,73080553,2023-02-11,79.43,939.6899999999999
14208,73080553,2023-02-11,-120.19,819.5
14209,73124762,2023-01-31,,110.47
14210,73124762,2023-02-01,-49.48,60.99
14211,73124762,2023-02-01,-50.33,10.660000000000004
14212,73124762,2023-02-06,-24.38,-13.719999999999995
14213,73124762,2023-02-07,87.94,74.22
14214,73124762,2023-02-09,196.64,270.86
14215,73124762,2023-02-09,177.2,448.05999999999995
14216,73124762,2023-02-11,-51.94,396.12
14217,73124762,2023-02-12,78.65,474.77
14218,73208971,2023-01-31,,107.97
14219,73208971,2023-02-02,-185.26,-77.28999999999999
14220,73208971,2023-02-07,484.1,406.81000000000006
14221,73208971,2023-02-12,95.07,501.88000000000005
14222,73234341,2023-01-31,,811.71
14223,73234341,2023-02-04,101.3,913.01
14224,73234341,2023-02-11,107.95,1020.96
14225,73234341,2023-02-11,-2044.6,-1023.6399999999999
14226,73269307,2023-01-31,,485.86
14227,73269307,2023-02-04,98.27,584.13
14228,73269307,2023-02-04,42.73,626.86
14229,73275714,2023-01-31,,924.88
14230,73275714,2023-02-04,-173.75,751.13
14231,73275714,2023-02-06,-123.09,628.04
14232,73275714,2023-02-11,135.38,763.42
14233,73282074,2023-01-31,,220.48
14234,73282074,2023-02-01,-61.23,159.25
14235,73282074,2023-02-04,-97.9,61.349999999999994
14236,73282074,2023-02-07,-105.38,-44.03
14237,73282074,2023-02-07,-147.36,-191.39000000000001
14238,73282074,2023-02-09,-239.1,-430.49
14239,73282074,2023-02-11,-54.29,-484.78000000000003
14240,73282074,2023-02-13,-71.18,-555.96
14241,73321391,2023-01-31,,100.12
14242,73321391,2023-02-03,-174.25,-74.13
14243,73321391,2023-02-04,-18.25,-92.38
14244,73321391,2023-02-11,-80.85,-173.23
14245,73321391,2023-02-12,-61.95,-235.18
14246,73321391,2023-02-13,-80.74,-315.91999999999996
14247,73321391,2023-02-14,78.83,-237.08999999999997
14248,73328955,2023-01-31,,404.7
14249,73328955,2023-02-06,-30.45,374.25
14250,73328955,2023-02-07,-1819.0,-1444.75
14251,73328955,2023-02-09,149.44,-1295.31
14252,73328955,2023-02-10,-50.5,-1345.81
14253,73328955,2023-02-13,77.1,-1268.71
14254,73410227,2023-01-31,,820.36
14255,73410227,2023-02-01,-219.71,600.65
14256,73410227,2023-02-06,52.84,653.49
14257,73410227,2023-02-09,38.14,691.63
14258,73410227,2023-02-12,-107.09,584.54
14259,73439131,2023-01-31,,863.01
14260,73439131,2023-02-02,-54.93,808.08
14261,73439131,2023-02-02,-71.36,736.72
14262,73439131,2023-02-02,-88.1,648.62
14263,73439131,2023-02-03,-149.58,499.03999999999996
14264,73439131,2023-02-04,107.38,606.42
14265,73439131,2023-02-04,-123.49,482.93
14266,73439131,2023-02-06,-1069.0,-586.0699999999999
14267,73439131,2023-02-07,69.6,-516.4699999999999
14268,73439131,2023-02-09,-98.98,-615.4499999999999
14269,73439131,2023-02-14,105.25,-510.19999999999993
14270,73439131,2023-02-14,-53.79,-563.9899999999999
14271,73510067,2023-01-31,,895.82
14272,73510067,2023-02-04,135.72,1031.54
14273,73510067,2023-02-07,-135.77,895.77
14274,73510067,2023-02-14,22.59,918.36
14275,73512834,2023-01-31,,424.59
14276,73512834,2023-02-01,103.58,528.17
14277,73512834,2023-02-02,110.43,638.6
14278,73512834,2023-02-04,-578.7,59.89999999999998
14279,73512834,2023-02-05,-6.73,53.16999999999997
14280,73512834,2023-02-06,113.54,166.70999999999998
14281,73512834,2023-02-09,54.35,221.05999999999997
14282,73512834,2023-02-09,-176.84,44.21999999999997
14283,73512834,2023-02-10,123.35,167.56999999999996
14284,73512834,2023-02-11,-31.41,136.15999999999997
14285,73512834,2023-02-11,-110.11,26.04999999999997
14286,73512834,2023-02-12,121.0,147.04999999999995
14287,73512834,2023-02-14,163.28,310.33
14288,73534143,2023-01-31,,804.34
14289,73534143,2023-02-12,-85.27,719.07
14290,73538236,2023-01-31,,231.93
14291,73538236,2023-02-01,60.58,292.51
14292,73538236,2023-02-13,-99.01,193.5
14293,73604500,2023-01-31,,689.4
14294,73604500,2023-02-02,-186.07,503.33
14295,73604500,2023-02-06,193.27,696.6
14296,73604500,2023-02-12,140.65,837.25
14297,73642628,2023-01-31,,300.06
14298,73642628,2023-02-06,1042.0,1342.06
14299,73642628,2023-02-06,-128.02,1214.04
14300,73642628,2023-02-07,109.32,1323.36
14301,73642628,2023-02-08,128.53,1451.8899999999999
14302,73642628,2023-02-09,105.05,1556.9399999999998
14303,73642628,2023-02-14,109.13,1666.07
14304,73652359,2023-01-31,,80.58
14305,73652359,2023-02-08,68.73,149.31
14306,73652359,2023-02-12,135.05,284.36
14307,73652359,2023-02-14,12.8,297.16
14308,73668192,2023-01-31,,371.47
14309,73668192,2023-02-02,1495.8,1867.27
14310,73668192,2023-02-04,-153.96,1713.31
14311,73668192,2023-02-05,149.4,1862.71
14312,73668192,2023-02-05,37.76,1900.47
14313,73668192,2023-02-07,-93.03,1807.44
14314,73668192,2023-02-10,111.12,1918.56
14315,73668192,2023-02-10,-11.9,1906.66
14316,73668192,2023-02-13,-62.93,1843.73
14317,73700087,2023-01-31,,274.17
14318,73700087,2023-02-04,116.66,390.83000000000004
14319,73700087,2023-02-04,-44.37,346.46000000000004
14320,73700087,2023-02-06,-106.53,239.93
14321,73700087,2023-02-08,70.5,310.43
14322,73700087,2023-02-10,70.11,380.54
14323,73700087,2023-02-12,-84.72,295.82
14324,73744504,2023-01-31,,270.6
14325,73744504,2023-02-05,-54.49,216.11
14326,73744504,2023-02-07,-52.52,163.59000000000003
14327,73744504,2023-02-08,51.75,215.34000000000003
14328,73744504,2023-02-09,-70.71,144.63000000000002
14329,73744504,2023-02-10,-69.64,74.99000000000002
14330,73744504,2023-02-10,-127.34,-52.34999999999998
14331,73744504,2023-02-11,89.18,36.83000000000003
14332,73744504,2023-02-11,-69.64,-32.809999999999974
14333,73744504,2023-02-12,-128.61,-161.42
14334,73744504,2023-02-13,165.67,4.25
14335,73744504,2023-02-13,-137.58,-133.33
14336,73762750,2023-01-31,,221.12
14337,73762750,2023-02-01,-66.19,154.93
14338,73762750,2023-02-03,1505.1,1660.03
14339,73762750,2023-02-05,-129.71,1530.32
14340,73762750,2023-02-06,106.97,1637.29
14341,73762750,2023-02-08,156.53,1793.82
14342,73782061,2023-01-31,,891.9
14343,73782061,2023-02-02,-58.23,833.67
14344,73782061,2023-02-13,-69.25,764.42
14345,73782061,2023-02-13,-164.0,600.42
14346,73878828,2023-01-31,,845.19
14347,73878828,2023-02-01,-58.02,787.1700000000001
14348,73878828,2023-02-04,-973.3,-186.12999999999988
14349,73878828,2023-02-06,42.82,-143.3099999999999
14350,73878828,2023-02-09,117.9,-25.409999999999883
14351,73878828,2023-02-10,74.6,49.19000000000011
14352,73878828,2023-02-10,-7.29,41.90000000000011
14353,73878828,2023-02-13,86.65,128.55000000000013
14354,73878828,2023-02-13,-62.41,66.14000000000013
14355,73983591,2023-01-31,,292.39
14356,73983591,2023-02-01,117.31,409.7
14357,73983591,2023-02-05,72.56,482.26
14358,73983591,2023-02-06,-124.22,358.03999999999996
14359,73983591,2023-02-07,7.57,365.61
14360,73983591,2023-02-08,-1668.5,-1302.8899999999999
14361,73983591,2023-02-10,-83.3,-1386.1899999999998
14362,73983591,2023-02-11,-152.46,-1538.6499999999999
14363,73983591,2023-02-13,-83.87,-1622.52
14364,73983601,2023-01-31,,617.23
14365,73983601,2023-02-04,-186.59,430.64
14366,73983601,2023-02-06,-111.97,318.67
14367,73983601,2023-02-08,62.88,381.55
14368,73983601,2023-02-10,-136.73,244.82000000000002
14369,73983601,2023-02-11,81.42,326.24
14370,73983601,2023-02-12,-37.22,289.02000000000004
14371,73983601,2023-02-13,-140.52,148.5
14372,73983601,2023-02-14,82.4,230.9
14373,74012560,2023-01-31,,414.56
14374,74012560,2023-02-08,-51.04,363.52
14375,74012560,2023-02-10,2476.1,2839.62
14376,74012560,2023-02-10,75.51,2915.13
14377,74012560,2023-02-10,-70.94,2844.19
14378,74012560,2023-02-10,-71.14,2773.0499999999997
14379,74012560,2023-02-10,-150.3,2622.75
14380,74012560,2023-02-14,-96.98,2525.77
14381,74154906,2023-01-31,,743.84
14382,74154906,2023-02-09,32.68,776.52
14383,74163559,2023-01-31,,45.76
14384,74163559,2023-02-02,100.89,146.65
14385,74163559,2023-02-02,-105.59,41.05999999999999
14386,74163559,2023-02-07,84.66,125.71999999999998
14387,74163559,2023-02-09,-91.85,33.86999999999999
14388,74163559,2023-02-10,-108.57,-74.7
14389,74163559,2023-02-11,-80.75,-155.45
14390,74218001,2023-01-31,,133.02
14391,74218001,2023-02-05,68.53,201.55
14392,74218001,2023-02-09,898.2,1099.75
14393,74218001,2023-02-09,-7.4,1092.35
14394,74252410,2023-01-31,,278.47
14395,74252410,2023-02-01,37.94,316.41
14396,74252410,2023-02-01,-105.25,211.16000000000003
14397,74252410,2023-02-01,-117.31,93.85000000000002
14398,74252410,2023-02-03,126.21,220.06
14399,74252410,2023-02-03,-145.42,74.64000000000004
14400,74252410,2023-02-08,-32.44,42.200000000000045
14401,74252410,2023-02-10,1531.0,1573.2
14402,74252410,2023-02-11,-1207.7,365.5
14403,74252410,2023-02-13,99.01,464.51
14404,74252410,2023-02-14,625.3,1089.81
14405,74255305,2023-01-31,,3.7
14406,74255305,2023-02-02,162.41,166.10999999999999
14407,74255305,2023-02-03,106.51,272.62
14408,74255305,2023-02-06,93.96,366.58
14409,74255305,2023-02-07,85.44,452.02
14410,74255305,2023-02-11,-167.02,285.0
14411,74255305,2023-02-11,-1672.7,-1387.7
14412,74281404,2023-01-31,,678.89
14413,74281404,2023-02-01,-456.2,222.69
14414,74281404,2023-02-04,139.28,361.97
14415,74281404,2023-02-08,89.88,451.85
14416,74281404,2023-02-11,-145.81,306.03999999999996
14417,74304084,2023-01-31,,883.35
14418,74304084,2023-02-01,131.58,1014.9300000000001
14419,74304084,2023-02-08,570.9,1585.83
14420,74304084,2023-02-10,89.61,1675.44
14421,74304084,2023-02-14,-122.61,1552.83
14422,74365725,2023-01-31,,518.04
14423,74365725,2023-02-03,-97.42,420.61999999999995
14424,74365725,2023-02-06,24.84,445.46
14425,74365725,2023-02-10,81.71,527.17
14426,74365725,2023-02-13,163.71,690.88
14427,74367877,2023-01-31,,818.92
14428,74367877,2023-02-01,45.64,864.56
14429,74367877,2023-02-02,-104.03,760.53
14430,74367877,2023-02-03,472.5,1233.03
14431,74367877,2023-02-08,-70.08,1162.95
14432,74367877,2023-02-10,-118.64,1044.31
14433,74367877,2023-02-13,48.97,1093.28
14434,74387481,2023-01-31,,883.93
14435,74387481,2023-02-02,-117.73,766.1999999999999
14436,74387481,2023-02-04,106.46,872.66
14437,74387481,2023-02-07,88.5,961.16
14438,74387481,2023-02-07,-87.94,873.2199999999999
14439,74387481,2023-02-07,-644.8,228.41999999999996
14440,74387481,2023-02-08,162.49,390.90999999999997
14441,74387481,2023-02-09,-163.2,227.70999999999998
14442,74387481,2023-02-10,-91.88,135.82999999999998
14443,74387481,2023-02-13,-61.95,73.87999999999998
14444,74441123,2023-01-31,,833.24
14445,74441123,2023-02-01,-143.97,689.27
14446,74441123,2023-02-02,61.45,750.72
14447,74441123,2023-02-08,-124.5,626.22
14448,74441123,2023-02-09,-128.5,497.72
14449,74441123,2023-02-10,-139.35,358.37
14450,74441123,2023-02-13,-1154.7,-796.33
14451,74539170,2023-01-31,,417.58
14452,74539170,2023-02-04,143.01,560.5899999999999
14453,74539170,2023-02-04,-74.02,486.57
14454,74539170,2023-02-07,-142.95,343.62
14455,74539170,2023-02-10,-126.49,217.13
14456,74539170,2023-02-11,84.22,301.35
14457,74539170,2023-02-11,-1.71,299.64
14458,74539170,2023-02-12,-20.81,278.83
14459,74544582,2023-01-31,,407.96
14460,74544582,2023-02-01,-58.96,349.0
14461,74544582,2023-02-06,107.8,456.79999999999995
14462,74544582,2023-02-07,89.17,545.97
14463,74544582,2023-02-08,-1010.6,-464.63
14464,74544582,2023-02-10,-122.82,-587.45
14465,74544582,2023-02-11,-16.09,-603.54
14466,74544582,2023-02-11,-28.8,-632.34
14467,74544582,2023-02-13,-46.08,-678.42
14468,74544582,2023-02-13,-196.46,-874.88
14469,74604471,2023-01-31,,661.57
14470,74604471,2023-02-03,-21.47,640.1
14471,74604471,2023-02-11,1199.0,1839.1
14472,74604471,2023-02-11,1096.1,2935.2
14473,74662976,2023-01-31,,782.3
14474,74662976,2023-02-01,1634.7,2417.0
14475,74662976,2023-02-06,213.44,2630.44
14476,74662976,2023-02-09,-105.05,2525.39
14477,74662976,2023-02-11,-111.96,2413.43
14478,74662976,2023-02-14,-69.61,2343.82
14479,74703933,2023-01-31,,321.42
14480,74703933,2023-02-01,239.72,561.14
14481,74703933,2023-02-02,-68.12,493.02
14482,74703933,2023-02-04,58.74,551.76
14483,74703933,2023-02-04,-157.05,394.71000000000004
14484,74703933,2023-02-07,949.2,1343.91
14485,74703933,2023-02-11,-152.17,1191.74
14486,74703933,2023-02-13,81.27,1273.01
14487,74709026,2023-01-31,,465.39
14488,74709026,2023-02-04,-119.96,345.43
14489,74709026,2023-02-05,-53.54,291.89
14490,74709026,2023-02-09,58.09,349.98
14491,74709026,2023-02-11,-152.47,197.51
14492,74709026,2023-02-14,162.35,359.86
14493,74768567,2023-01-31,,557.15
14494,74768567,2023-02-04,39.82,596.97
14495,74768567,2023-02-08,-58.95,538.02
14496,74768567,2023-02-10,-103.06,434.96
14497,74768567,2023-02-11,-119.83,315.13
14498,74770758,2023-01-31,,643.52
14499,74770758,2023-02-01,143.86,787.38
14500,74770758,2023-02-02,645.8,1433.1799999999998
14501,74770758,2023-02-02,-507.1,926.0799999999999
14502,74770758,2023-02-05,-23.74,902.3399999999999
14503,74770758,2023-02-07,155.73,1058.07
14504,74770758,2023-02-07,27.88,1085.9499999999998
14505,74770758,2023-02-07,-115.83,970.1199999999999
14506,74770758,2023-02-10,119.83,1089.9499999999998
14507,74770758,2023-02-11,-62.47,1027.48
14508,74770758,2023-02-13,180.81,1208.29
14509,74770758,2023-02-13,39.74,1248.03
14510,74770758,2023-02-14,90.79,1338.82
14511,74770758,2023-02-14,-97.35,1241.4699999999998
14512,74770758,2023-02-14,-541.0,700.4699999999999
14513,74822001,2023-01-31,,673.61
14514,74822001,2023-02-03,113.25,786.86
14515,74822001,2023-02-04,84.91,871.77
14516,74822001,2023-02-06,157.11,1028.88
14517,74822001,2023-02-08,-42.88,986.0
14518,75000628,2023-01-31,,117.33
14519,75000628,2023-02-03,-102.49,14.840000000000003
14520,75000628,2023-02-06,-967.8,-952.9599999999999
14521,75000628,2023-02-07,111.95,-841.0099999999999
14522,75000628,2023-02-07,23.9,-817.1099999999999
14523,75000628,2023-02-09,119.86,-697.2499999999999
14524,75000628,2023-02-11,160.56,-536.6899999999999
14525,75000628,2023-02-11,-102.03,-638.7199999999999
14526,75000628,2023-02-12,24.74,-613.9799999999999
14527,75000628,2023-02-14,-122.88,-736.8599999999999
14528,75004471,2023-01-31,,435.54
14529,75004471,2023-02-06,-90.19,345.35
14530,75004471,2023-02-07,-71.12,274.23
14531,75004471,2023-02-09,161.19,435.42
14532,75004471,2023-02-10,-54.73,380.69
14533,75027308,2023-01-31,,307.44
14534,75027308,2023-02-05,70.81,378.25
14535,75027308,2023-02-13,-21.73,356.52
14536,75027308,2023-02-14,-42.03,314.49
14537,75068844,2023-01-31,,852.47
14538,75068844,2023-02-07,32.26,884.73
14539,75068844,2023-02-09,-174.92,709.8100000000001
14540,75068844,2023-02-10,-205.21,504.6
14541,75068844,2023-02-13,56.42,561.02
14542,75094093,2023-01-31,,478.09
14543,75094093,2023-02-08,-66.58,411.51
14544,75094093,2023-02-10,-86.39,325.12
14545,75094093,2023-02-14,-120.62,204.49999999999997
14546,75134291,2023-01-31,,903.25
14547,75134291,2023-02-07,905.3,1808.55
14548,75134291,2023-02-08,-137.66,1670.8899999999999
14549,75134291,2023-02-10,145.13,1816.02
14550,75134291,2023-02-11,1677.5,3493.52
14551,75134291,2023-02-11,63.08,3556.6
14552,75134291,2023-02-12,-1261.6,2295.0
14553,75134291,2023-02-13,138.85,2433.85
14554,75164598,2023-01-31,,569.4
14555,75164598,2023-02-01,84.96,654.36
14556,75164598,2023-02-03,1529.4,2183.76
14557,75164598,2023-02-13,83.87,2267.63
14558,75164598,2023-02-14,-130.44,2137.19
14559,75172199,2023-01-31,,955.0
14560,75172199,2023-02-01,800.0,1755.0
14561,75172199,2023-02-05,-110.09,1644.91
14562,75172199,2023-02-10,-108.6,1536.31
14563,75172199,2023-02-14,-41.12,1495.19
14564,75205767,2023-01-31,,113.75
14565,75205767,2023-02-01,12.5,126.25
14566,75205767,2023-02-03,-59.01,67.24000000000001
14567,75205767,2023-02-08,-26.82,40.42
14568,75205767,2023-02-09,117.38,157.8
14569,75205767,2023-02-10,964.8,1122.6
14570,75205767,2023-02-11,52.74,1175.34
14571,75205767,2023-02-12,-195.95,979.3899999999999
14572,75216128,2023-01-31,,671.26
14573,75216128,2023-02-05,848.7,1519.96
14574,75216128,2023-02-05,-51.76,1468.2
14575,75216128,2023-02-06,-50.86,1417.3400000000001
14576,75216128,2023-02-10,-113.81,1303.53
14577,75216128,2023-02-11,136.0,1439.53
14578,75216128,2023-02-13,145.9,1585.43
14579,75216128,2023-02-13,37.31,1622.74
14580,75216128,2023-02-14,-110.13,1512.6100000000001
14581,75223089,2023-01-31,,557.48
14582,75223089,2023-02-02,-97.37,460.11
14583,75223089,2023-02-06,140.76,600.87
14584,75223089,2023-02-08,0.47,601.34
14585,75223089,2023-02-10,71.41,672.75
14586,75258542,2023-01-31,,772.67
14587,75258542,2023-02-06,59.16,831.8299999999999
14588,75331062,2023-01-31,,117.81
14589,75331062,2023-02-01,124.73,242.54000000000002
14590,75331062,2023-02-02,192.68,435.22
14591,75331062,2023-02-02,153.2,588.4200000000001
14592,75331062,2023-02-09,-103.8,484.62
14593,75331062,2023-02-10,76.32,560.94
14594,75331062,2023-02-12,182.63,743.5699999999999
14595,75331062,2023-02-12,168.57,912.14
14596,75355842,2023-01-31,,621.95
14597,75355842,2023-02-02,-107.62,514.33
14598,75355842,2023-02-08,-167.23,347.1
14599,75355842,2023-02-13,36.43,383.53000000000003
14600,75355842,2023-02-13,-65.62,317.9100000000001
14601,75394177,2023-01-31,,191.04
14602,75394177,2023-02-01,212.26,403.29999999999995
14603,75394177,2023-02-01,-189.07,214.23
14604,75394177,2023-02-05,84.35,298.58
14605,75394177,2023-02-07,-96.08,202.5
14606,75394177,2023-02-09,-67.76,134.73999999999998
14607,75394177,2023-02-13,-12.26,122.47999999999998
14608,75428657,2023-01-31,,455.8
14609,75428657,2023-02-01,96.14,551.94
14610,75428657,2023-02-04,72.24,624.1800000000001
14611,75428657,2023-02-06,-89.47,534.71
14612,75428657,2023-02-06,-107.32,427.39
14613,75428657,2023-02-07,-166.06,261.33000000000004
14614,75428657,2023-02-12,-133.04,128.29000000000002
14615,75468090,2023-01-31,,984.92
14616,75468090,2023-02-02,-94.47,890.4499999999999
14617,75468090,2023-02-03,-110.96,779.49
14618,75468090,2023-02-05,143.3,922.79
14619,75468090,2023-02-06,-28.36,894.43
14620,75468090,2023-02-09,82.14,976.5699999999999
14621,75468090,2023-02-13,2264.3,3240.87
14622,75468090,2023-02-14,86.73,3327.6
14623,75468090,2023-02-14,-156.02,3171.58
14624,75551521,2023-01-31,,538.64
14625,75551521,2023-02-01,-170.89,367.75
14626,75551521,2023-02-10,-175.95,191.8
14627,75551521,2023-02-11,-40.81,150.99
14628,75553043,2023-01-31,,669.59
14629,75553043,2023-02-01,-124.86,544.73
14630,75553043,2023-02-02,-66.42,478.31000000000006
14631,75553043,2023-02-07,-46.14,432.17
14632,75553043,2023-02-08,45.54,477.71000000000004
14633,75553043,2023-02-12,150.22,627.9300000000001
14634,75553043,2023-02-12,87.33,715.26
14635,75553043,2023-02-13,172.54,887.8
14636,75553043,2023-02-13,-126.86,760.94
14637,75553043,2023-02-13,-156.04,604.9000000000001
14638,75569387,2023-01-31,,249.27
14639,75569387,2023-02-01,1775.6,2024.87
14640,75569387,2023-02-03,-177.23,1847.6399999999999
14641,75569387,2023-02-05,76.31,1923.9499999999998
14642,75569387,2023-02-08,-137.97,1785.98
14643,75569387,2023-02-08,-155.15,1630.83
14644,75569387,2023-02-09,173.2,1804.03
14645,75569387,2023-02-10,-177.19,1626.84
14646,75569387,2023-02-12,95.61,1722.4499999999998
14647,75573750,2023-01-31,,159.92
14648,75573750,2023-02-01,-57.37,102.54999999999998
14649,75573750,2023-02-01,-614.1,-511.55000000000007
14650,75573750,2023-02-11,95.68,-415.87000000000006
14651,75687743,2023-01-31,,668.39
14652,75687743,2023-02-02,-77.04,591.35
14653,75687743,2023-02-02,-121.53,469.82
14654,75687743,2023-02-06,68.98,538.8
14655,75687743,2023-02-08,710.3,1249.1
14656,75687743,2023-02-13,-101.21,1147.8899999999999
14657,75687743,2023-02-13,-124.44,1023.4499999999999
14658,75692380,2023-01-31,,477.28
14659,75692380,2023-02-07,13.71,490.98999999999995
14660,75692380,2023-02-12,76.48,567.47
14661,75696521,2023-01-31,,660.34
14662,75696521,2023-02-02,151.37,811.71
14663,75696521,2023-02-04,-113.97,697.74
14664,75696521,2023-02-09,124.33,822.07
14665,75696521,2023-02-12,-443.1,378.97
14666,75696521,2023-02-13,105.96,484.93
14667,75747094,2023-01-31,,289.48
14668,75747094,2023-02-01,-108.17,181.31
14669,75747094,2023-02-02,-111.34,69.97000000000001
14670,75747094,2023-02-03,-88.14,-18.169999999999987
14671,75747094,2023-02-03,-170.7,-188.86999999999998
14672,75747094,2023-02-06,-179.08,-367.95
14673,75747094,2023-02-07,-69.34,-437.28999999999996
14674,75747094,2023-02-09,125.74,-311.55
14675,75747094,2023-02-09,-24.49,-336.04
14676,75747094,2023-02-12,198.39,-137.65
14677,75747094,2023-02-12,119.08,-18.570000000000007
14678,75747094,2023-02-12,-1314.3,-1332.87
14679,75747094,2023-02-14,51.36,-1281.51
14680,75762044,2023-01-31,,980.08
14681,75762044,2023-02-03,-117.47,862.61
14682,75762044,2023-02-05,617.7,1480.31
14683,75762044,2023-02-05,80.83,1561.14
14684,75762044,2023-02-07,-79.53,1481.6100000000001
14685,75762044,2023-02-07,-1107.6,374.0100000000002
14686,75762044,2023-02-08,-238.9,135.1100000000002
14687,75762044,2023-02-09,84.51,219.62000000000023
14688,75762044,2023-02-12,-64.23,155.3900000000002
14689,75762044,2023-02-12,-94.0,61.390000000000214
14690,75762044,2023-02-14,-87.33,-25.939999999999785
14691,75782714,2023-01-31,,105.34
14692,75782714,2023-02-02,182.71,288.05
14693,75782714,2023-02-04,93.96,382.01
14694,75782714,2023-02-07,97.29,479.3
14695,75782714,2023-02-08,-58.82,420.48
14696,75782714,2023-02-11,53.59,474.07
14697,75839704,2023-01-31,,202.34
14698,75839704,2023-02-06,59.6,261.94
14699,75839704,2023-02-11,-157.05,104.88999999999999
14700,75839704,2023-02-12,44.96,149.85
14701,75893682,2023-01-31,,573.74
14702,75893682,2023-02-03,104.78,678.52
14703,75893682,2023-02-04,102.31,780.83
14704,75893682,2023-02-08,-105.88,674.95
14705,75893682,2023-02-09,148.56,823.51
14706,75925793,2023-01-31,,425.69
14707,75925793,2023-02-01,107.97,533.66
14708,75925793,2023-02-03,-50.4,483.26
14709,75925793,2023-02-04,-87.65,395.61
14710,75925793,2023-02-11,77.62,473.23
14711,75925793,2023-02-11,-143.15,330.08
14712,75946768,2023-01-31,,103.05
14713,75946768,2023-02-02,158.32,261.37
14714,75946768,2023-02-03,-121.58,139.79000000000002
14715,75946768,2023-02-04,-85.27,54.52000000000001
14716,75946768,2023-02-11,157.4,211.92000000000002
14717,75954317,2023-01-31,,583.28
14718,75954317,2023-02-02,92.9,676.18
14719,75954317,2023-02-05,41.21,717.39
14720,75954317,2023-02-11,129.66,847.05
14721,75954317,2023-02-13,760.4,1607.4499999999998
14722,75954317,2023-02-13,122.87,1730.32
14723,75954317,2023-02-14,85.66,1815.98
14724,75969874,2023-01-31,,454.25
14725,75969874,2023-02-05,325.0,779.25
14726,75969874,2023-02-05,165.42,944.67
14727,75969874,2023-02-08,-42.92,901.75
14728,75969874,2023-02-09,48.05,949.8
14729,76078639,2023-01-31,,318.17
14730,76078639,2023-02-01,9.8,327.97
14731,76078639,2023-02-06,154.69,482.66
14732,76078639,2023-02-08,109.06,591.72
14733,76078639,2023-02-09,-25.58,566.14
14734,76096120,2023-01-31,,996.6
14735,76096120,2023-02-01,-115.85,880.75
14736,76096120,2023-02-02,142.28,1023.03
14737,76096120,2023-02-02,101.22,1124.25
14738,76096120,2023-02-03,85.29,1209.54
14739,76096120,2023-02-05,-142.12,1067.42
14740,76096120,2023-02-06,99.42,1166.84
14741,76096120,2023-02-13,-90.4,1076.44
14742,76099143,2023-01-31,,525.4
14743,76099143,2023-02-02,-118.6,406.79999999999995
14744,76099143,2023-02-05,61.09,467.89
14745,76099143,2023-02-13,-53.33,414.56
14746,76122310,2023-01-31,,985.6
14747,76122310,2023-02-10,-616.1,369.5
14748,76122310,2023-02-11,32.2,401.7
14749,76122310,2023-02-13,148.74,550.44
14750,76146870,2023-01-31,,414.24
14751,76146870,2023-02-03,1278.2,1692.44
14752,76146870,2023-02-06,-165.65,1526.79
14753,76146870,2023-02-07,168.17,1694.96
14754,76146870,2023-02-07,141.27,1836.23
14755,76146870,2023-02-08,-86.36,1749.8700000000001
14756,76146870,2023-02-11,101.6,1851.47
14757,76146870,2023-02-14,88.1,1939.57
14758,76146870,2023-02-14,-104.18,1835.39
14759,76146870,2023-02-14,-1053.5,781.8900000000001
14760,76169332,2023-01-31,,615.46
14761,76169332,2023-02-02,83.79,699.25
14762,76169332,2023-02-02,-1695.5,-996.25
14763,76169332,2023-02-03,-28.0,-1024.25
14764,76169332,2023-02-07,84.19,-940.06
14765,76206810,2023-01-31,,887.63
14766,76206810,2023-02-01,-128.78,758.85
14767,76206810,2023-02-05,-104.42,654.43
14768,76206810,2023-02-12,108.81,763.24
14769,76206810,2023-02-12,104.78,868.02
14770,76206810,2023-02-14,37.74,905.76
14771,76245103,2023-01-31,,814.75
14772,76245103,2023-02-07,171.4,986.15
14773,76245103,2023-02-08,-72.19,913.96
14774,76245103,2023-02-10,-108.64,805.32
14775,76245103,2023-02-11,-126.42,678.9
14776,76245103,2023-02-11,-194.38,484.52
14777,76245103,2023-02-14,64.58,549.1
14778,76256026,2023-01-31,,36.71
14779,76256026,2023-02-01,114.21,150.92
14780,76256026,2023-02-02,-122.54,28.379999999999995
14781,76256026,2023-02-03,-65.14,-36.760000000000005
14782,76256026,2023-02-05,76.57,39.80999999999999
14783,76256026,2023-02-06,-91.5,-51.69000000000001
14784,76256026,2023-02-06,-583.7,-635.3900000000001
14785,76256026,2023-02-07,-62.85,-698.2400000000001
14786,76256026,2023-02-08,154.47,-543.7700000000001
14787,76256026,2023-02-09,125.05,-418.7200000000001
14788,76256026,2023-02-12,1251.2,832.48
14789,76256026,2023-02-12,1145.7,1978.18
14790,76256026,2023-02-12,-107.03,1871.15
14791,76257915,2023-01-31,,795.66
14792,76257915,2023-02-04,87.08,882.74
14793,76257915,2023-02-05,108.03,990.77
14794,76257915,2023-02-07,-1236.7,-245.93000000000006
14795,76257915,2023-02-14,51.78,-194.15000000000006
14796,76273831,2023-01-31,,866.62
14797,76273831,2023-02-02,49.14,915.76
14798,76273831,2023-02-03,-113.59,802.17
14799,76273831,2023-02-07,109.58,911.75
14800,76273831,2023-02-08,99.77,1011.52
14801,76273831,2023-02-12,-110.79,900.73
14802,76273831,2023-02-13,-124.45,776.28
14803,76273831,2023-02-14,129.25,905.53
14804,76318330,2023-01-31,,710.56
14805,76318330,2023-02-01,-960.8,-250.24
14806,76318330,2023-02-03,-1.03,-251.27
14807,76318330,2023-02-04,41.13,-210.14000000000001
14808,76318330,2023-02-04,-49.52,-259.66
14809,76318330,2023-02-04,-165.42,-425.08
14810,76318330,2023-02-06,405.7,-19.379999999999995
14811,76318330,2023-02-06,128.02,108.64000000000001
14812,76318330,2023-02-14,156.27,264.91
14813,76336076,2023-01-31,,288.71
14814,76336076,2023-02-07,109.43,398.14
14815,76336076,2023-02-13,-96.98,301.15999999999997
14816,76336076,2023-02-14,-1376.0,-1074.8400000000001
14817,76342664,2023-01-31,,371.62
14818,76342664,2023-02-03,42.34,413.96000000000004
14819,76342664,2023-02-04,124.23,538.19
14820,76342664,2023-02-05,-44.51,493.68
14821,76342664,2023-02-12,100.06,593.74
14822,76343783,2023-01-31,,42.36
14823,76343783,2023-02-02,133.38,175.74
14824,76343783,2023-02-08,1253.6,1429.34
14825,76343783,2023-02-10,113.56,1542.8999999999999
14826,76343783,2023-02-13,1505.7,3048.6
14827,76355557,2023-01-31,,285.61
14828,76355557,2023-02-03,110.56,396.17
14829,76355557,2023-02-10,65.54,461.71000000000004
14830,76355557,2023-02-10,-206.97,254.74
14831,76355557,2023-02-11,184.5,439.24
14832,76355557,2023-02-13,-73.19,366.05
14833,76454427,2023-01-31,,267.03
14834,76454427,2023-02-09,32.83,299.85999999999996
14835,76454427,2023-02-10,64.12,363.97999999999996
14836,76454427,2023-02-12,-170.4,193.57999999999998
14837,76470405,2023-01-31,,606.3
14838,76470405,2023-02-01,120.13,726.43
14839,76470405,2023-02-02,62.52,788.9499999999999
14840,76470405,2023-02-02,-65.2,723.75
14841,76470405,2023-02-05,175.68,899.43
14842,76470405,2023-02-05,104.2,1003.63
14843,76470405,2023-02-05,-41.21,962.42
14844,76470405,2023-02-07,56.28,1018.6999999999999
14845,76470405,2023-02-07,-98.61,920.0899999999999
14846,76470405,2023-02-10,-116.06,804.03
14847,76474111,2023-01-31,,563.43
14848,76474111,2023-02-01,88.99,652.42
14849,76474111,2023-02-05,-69.19,583.2299999999999
14850,76474111,2023-02-07,173.35,756.5799999999999
14851,76474111,2023-02-07,-17.39,739.1899999999999
14852,76474111,2023-02-09,-158.25,580.9399999999999
14853,76474111,2023-02-11,-73.94,506.99999999999994
14854,76474111,2023-02-12,109.6,616.5999999999999
14855,76474111,2023-02-12,85.9,702.5
14856,76474111,2023-02-14,626.8,1329.3
14857,76482858,2023-01-31,,568.63
14858,76482858,2023-02-04,-1084.8,-516.17
14859,76482858,2023-02-05,124.61,-391.55999999999995
14860,76482858,2023-02-06,202.83,-188.72999999999996
14861,76482858,2023-02-07,1236.7,1047.97
14862,76482858,2023-02-08,-782.7,265.27
14863,76524911,2023-01-31,,190.9
14864,76524911,2023-02-01,-41.55,149.35000000000002
14865,76524911,2023-02-05,-65.57,83.78000000000002
14866,76524911,2023-02-07,176.26,260.04
14867,76524911,2023-02-13,69.71,329.75
14868,76537084,2023-01-31,,884.7
14869,76537084,2023-02-03,77.14,961.84
14870,76537084,2023-02-03,-86.49,875.35
14871,76537084,2023-02-05,-117.8,757.5500000000001
14872,76537084,2023-02-06,83.76,841.3100000000001
14873,76537084,2023-02-11,84.29,925.6
14874,76537084,2023-02-12,-76.36,849.24
14875,76537084,2023-02-13,76.58,925.82
14876,76546657,2023-01-31,,434.77
14877,76546657,2023-02-03,-99.85,334.91999999999996
14878,76546657,2023-02-05,-122.25,212.67
14879,76546657,2023-02-06,-88.52,124.14999999999999
14880,76546657,2023-02-07,-14.81,109.33999999999999
14881,76546657,2023-02-07,-85.6,23.739999999999995
14882,76546657,2023-02-08,-1123.1,-1099.36
14883,76546657,2023-02-09,1363.6,264.24
14884,76546657,2023-02-10,209.84,474.08000000000004
14885,76629706,2023-01-31,,962.66
14886,76629706,2023-02-04,126.02,1088.68
14887,76629706,2023-02-04,52.76,1141.44
14888,76629706,2023-02-07,105.66,1247.1
14889,76629706,2023-02-09,-158.66,1088.44
14890,76629706,2023-02-10,74.41,1162.85
14891,76662799,2023-01-31,,296.68
14892,76662799,2023-02-01,-84.07,212.61
14893,76662799,2023-02-04,-76.66,135.95000000000002
14894,76662799,2023-02-06,-77.47,58.48000000000002
14895,76662799,2023-02-08,60.7,119.18000000000002
14896,76662799,2023-02-08,-67.17,52.01000000000002
14897,76662799,2023-02-09,70.71,122.72000000000001
14898,76662799,2023-02-10,-1394.1,-1271.3799999999999
14899,76662799,2023-02-14,95.2,-1176.1799999999998
14900,76698056,2023-01-31,,827.36
14901,76698056,2023-02-02,206.91,1034.27
14902,76698056,2023-02-02,111.34,1145.6100000000001
14903,76698056,2023-02-02,98.37,1243.98
14904,76698056,2023-02-03,9.03,1253.01
14905,76698056,2023-02-07,84.97,1337.98
14906,76698056,2023-02-07,-124.31,1213.67
14907,76698056,2023-02-08,221.0,1434.67
14908,76720959,2023-01-31,,436.06
14909,76720959,2023-02-04,100.63,536.69
14910,76720959,2023-02-05,93.03,629.72
14911,76720959,2023-02-07,93.88,723.6
14912,76720959,2023-02-10,-166.54,557.06
14913,76720959,2023-02-13,133.35,690.41
14914,76787359,2023-01-31,,386.73
14915,76787359,2023-02-03,116.55,503.28000000000003
14916,76787359,2023-02-03,-110.59,392.69
14917,76787359,2023-02-04,1398.7,1791.39
14918,76787359,2023-02-06,-61.92,1729.47
14919,76787359,2023-02-07,-151.4,1578.0700000000002
14920,76787359,2023-02-07,-808.1,769.97
14921,76787359,2023-02-08,154.93,924.9000000000001
14922,76799768,2023-01-31,,981.08
14923,76799768,2023-02-01,-77.81,903.27
14924,76799768,2023-02-03,50.4,953.6700000000001
14925,76799768,2023-02-03,-100.81,852.86
14926,76799768,2023-02-03,-644.3,208.56000000000006
14927,76799768,2023-02-04,73.93,282.49000000000007
14928,76799768,2023-02-04,53.8,336.2900000000001
14929,76799768,2023-02-04,49.53,385.82000000000005
14930,76799768,2023-02-06,-71.52,314.30000000000007
14931,76799768,2023-02-09,81.65,395.95000000000005
14932,76799768,2023-02-14,55.79,451.74000000000007
14933,76847816,2023-01-31,,197.8
14934,76847816,2023-02-01,-16.06,181.74
14935,76847816,2023-02-01,-129.39,52.35000000000002
14936,76847816,2023-02-02,-699.5,-647.15
14937,76847816,2023-02-03,1259.6,612.4499999999999
14938,76847816,2023-02-07,-1282.4,-669.9500000000002
14939,76847816,2023-02-09,160.1,-509.85000000000014
14940,76847816,2023-02-10,115.98,-393.8700000000002
14941,76847816,2023-02-12,1268.1,874.2299999999998
14942,76847816,2023-02-12,-92.93,781.2999999999997
14943,76847816,2023-02-13,-67.88,713.4199999999998
14944,76857747,2023-01-31,,952.88
14945,76857747,2023-02-04,-63.46,889.42
14946,76857747,2023-02-04,-122.06,767.36
14947,76857747,2023-02-05,-70.81,696.55
14948,76857747,2023-02-06,112.33,808.88
14949,76857747,2023-02-07,97.82,906.6999999999999
14950,76857747,2023-02-08,117.22,1023.92
14951,76857747,2023-02-09,107.22,1131.1399999999999
14952,76857747,2023-02-10,205.21,1336.35
14953,76857747,2023-02-11,75.48,1411.83
14954,76857747,2023-02-12,122.61,1534.44
14955,76869201,2023-01-31,,515.62
14956,76869201,2023-02-01,-98.26,417.36
14957,76869201,2023-02-04,-149.33,268.03
14958,76869201,2023-02-05,-84.35,183.67999999999998
14959,76869201,2023-02-09,1485.0,1668.68
14960,76869201,2023-02-12,-128.28,1540.4
14961,76869201,2023-02-14,-20.41,1519.99
14962,76869375,2023-01-31,,894.84
14963,76869375,2023-02-01,92.35,987.19
14964,76869375,2023-02-01,41.18,1028.3700000000001
14965,76869375,2023-02-02,-103.03,925.34
14966,76869375,2023-02-03,141.16,1066.5
14967,76869375,2023-02-04,96.31,1162.81
14968,76869375,2023-02-05,-54.79,1108.02
14969,76869375,2023-02-06,-82.75,1025.27
14970,76869375,2023-02-13,148.17,1173.44
14971,76953050,2023-01-31,,453.1
14972,76953050,2023-02-04,-89.97,363.13
14973,76953050,2023-02-05,129.47,492.6
14974,76953050,2023-02-09,39.39,531.99
14975,76953050,2023-02-10,102.06,634.0500000000001
14976,76953050,2023-02-14,120.54,754.59
14977,77010964,2023-01-31,,899.11
14978,77010964,2023-02-05,91.81,990.9200000000001
14979,77010964,2023-02-07,57.25,1048.17
14980,77010964,2023-02-10,-116.67,931.5
14981,77010964,2023-02-11,85.0,1016.5
14982,77010964,2023-02-11,-70.24,946.26
14983,77017650,2023-01-31,,699.24
14984,77017650,2023-02-01,-103.04,596.2
14985,77017650,2023-02-03,121.15,717.35
14986,77017650,2023-02-04,-92.05,625.3
14987,77017650,2023-02-07,121.9,747.2
14988,77017650,2023-02-07,38.41,785.61
14989,77017650,2023-02-08,96.4,882.01
14990,77017650,2023-02-08,-104.18,777.83
14991,77017650,2023-02-12,-57.5,720.33
14992,77017650,2023-02-12,-95.8,624.53
14993,77017650,2023-02-13,98.44,722.97
14994,77017650,2023-02-13,-56.42,666.55
14995,77017650,2023-02-14,113.46,780.01
14996,77017650,2023-02-14,-49.55,730.46
14997,77017650,2023-02-14,-116.74,613.72
14998,77026279,2023-01-31,,126.05
14999,77026279,2023-02-05,-39.2,86.85
15000,77026279,2023-02-06,101.4,188.25
15001,77026279,2023-02-08,36.78,225.03
15002,77026279,2023-02-09,-105.04,119.99
15003,77026279,2023-02-12,1640.8,1760.79
15004,77026279,2023-02-13,101.58,1862.37
15005,77026279,2023-02-13,-136.98,1725.3899999999999
15006,77207452,2023-01-31,,696.83
15007,77207452,2023-02-04,104.45,801.2800000000001
15008,77207452,2023-02-04,65.13,866.4100000000001
15009,77207452,2023-02-04,35.68,902.09
15010,77207452,2023-02-09,-77.75,824.34
15011,77207452,2023-02-10,-104.39,719.95
15012,77207452,2023-02-10,-1975.6,-1255.6499999999999
15013,77207452,2023-02-11,150.26,-1105.3899999999999
15014,77207452,2023-02-11,-482.1,-1587.4899999999998
15015,77207452,2023-02-11,-531.4,-2118.89
15016,77241606,2023-01-31,,761.38
15017,77241606,2023-02-02,-106.05,655.33
15018,77241606,2023-02-07,174.77,830.1
15019,77241606,2023-02-07,-97.26,732.84
15020,77241606,2023-02-08,-84.11,648.73
15021,77241606,2023-02-09,-5.59,643.14
15022,77241606,2023-02-12,141.01,784.15
15023,77241606,2023-02-12,77.9,862.05
15024,77243259,2023-01-31,,614.86
15025,77243259,2023-02-01,86.97,701.83
15026,77243259,2023-02-01,-106.89,594.94
15027,77243259,2023-02-02,86.62,681.5600000000001
15028,77243259,2023-02-08,97.07,778.63
15029,77243259,2023-02-08,-164.7,613.9300000000001
15030,77243259,2023-02-10,90.2,704.13
15031,77243259,2023-02-12,123.95,828.08
15032,77289104,2023-01-31,,737.08
15033,77289104,2023-02-03,145.14,882.22
15034,77289104,2023-02-06,134.08,1016.3000000000001
15035,77289104,2023-02-07,67.04,1083.3400000000001
15036,77289104,2023-02-10,-148.04,935.3000000000001
15037,77289104,2023-02-13,93.21,1028.51
15038,77342574,2023-01-31,,907.34
15039,77342574,2023-02-01,-115.41,791.9300000000001
15040,77342574,2023-02-02,24.05,815.98
15041,77342574,2023-02-02,-132.64,683.34
15042,77342574,2023-02-02,-1666.0,-982.66
15043,77342574,2023-02-02,-1774.7,-2757.36
15044,77342574,2023-02-04,-127.8,-2885.16
15045,77342574,2023-02-10,-187.69,-3072.85
15046,77342574,2023-02-13,211.13,-2861.72
15047,77342574,2023-02-14,114.72,-2747.0
15048,77342574,2023-02-14,-40.73,-2787.73
15049,77342574,2023-02-14,-130.66,-2918.39
15050,77377150,2023-01-31,,673.03
15051,77377150,2023-02-01,-8.07,664.9599999999999
15052,77377150,2023-02-06,-144.03,520.93
15053,77377150,2023-02-08,-112.44,408.49
15054,77377150,2023-02-11,-139.56,268.92999999999995
15055,77377150,2023-02-12,-791.8,-522.87
15056,77379844,2023-01-31,,32.65
15057,77379844,2023-02-02,55.08,87.72999999999999
15058,77379844,2023-02-03,-139.16,-51.43000000000001
15059,77379844,2023-02-04,-137.7,-189.13
15060,77379844,2023-02-06,136.6,-52.53
15061,77379844,2023-02-13,-37.83,-90.36
15062,77387016,2023-01-31,,894.34
15063,77387016,2023-02-05,505.0,1399.3400000000001
15064,77387016,2023-02-14,707.3,2106.64
15065,77418940,2023-01-31,,263.71
15066,77418940,2023-02-03,159.42,423.13
15067,77418940,2023-02-04,127.76,550.89
15068,77418940,2023-02-05,-37.76,513.13
15069,77418940,2023-02-05,-83.83,429.29999999999995
15070,77418940,2023-02-10,92.09,521.39
15071,77418940,2023-02-11,1012.8,1534.19
15072,77418940,2023-02-11,-80.51,1453.6799999999998
15073,77418940,2023-02-11,-130.61,1323.07
15074,77418940,2023-02-11,-187.53,1135.54
15075,77447018,2023-01-31,,754.64
15076,77447018,2023-02-03,-56.34,698.3
15077,77447018,2023-02-08,-59.47,638.8299999999999
15078,77447018,2023-02-08,-163.05,475.78
15079,77447018,2023-02-10,159.2,634.98
15080,77447018,2023-02-10,-123.76,511.21999999999997
15081,77447018,2023-02-11,-50.07,461.15
15082,77447018,2023-02-11,-147.81,313.3399999999999
15083,77504884,2023-01-31,,221.03
15084,77504884,2023-02-01,695.3,916.3299999999999
15085,77504884,2023-02-07,122.99,1039.32
15086,77504884,2023-02-08,108.51,1147.83
15087,77504884,2023-02-08,92.11,1239.9399999999998
15088,77504884,2023-02-08,-43.89,1196.05
15089,77504884,2023-02-12,-51.05,1145.0
15090,77504884,2023-02-12,-118.61,1026.3899999999999
15091,77551209,2023-01-31,,7.33
15092,77551209,2023-02-04,1795.8,1803.1299999999999
15093,77551209,2023-02-05,-69.16,1733.9699999999998
15094,77551209,2023-02-09,666.4,2400.37
15095,77551209,2023-02-09,136.79,2537.16
15096,77551209,2023-02-11,-573.2,1963.9599999999998
15097,77551209,2023-02-13,-104.56,1859.3999999999999
15098,77554032,2023-01-31,,646.5
15099,77554032,2023-02-02,45.75,692.25
15100,77554032,2023-02-02,-124.34,567.91
15101,77554032,2023-02-04,58.86,626.77
15102,77554032,2023-02-07,-198.21,428.56
15103,77554032,2023-02-07,-1029.9,-601.3400000000001
15104,77554032,2023-02-10,-23.96,-625.3000000000002
15105,77554032,2023-02-10,-101.72,-727.0200000000002
15106,77587664,2023-01-31,,769.43
15107,77587664,2023-02-04,-72.49,696.9399999999999
15108,77587664,2023-02-05,-90.66,606.28
15109,77587664,2023-02-06,154.81,761.0899999999999
15110,77587664,2023-02-06,51.05,812.14
15111,77587664,2023-02-07,-33.35,778.79
15112,77587664,2023-02-09,-89.39,689.4
15113,77587664,2023-02-12,72.94,762.3399999999999
15114,77646359,2023-01-31,,434.93
15115,77646359,2023-02-11,43.47,478.4
15116,77668890,2023-01-31,,804.88
15117,77668890,2023-02-02,-103.44,701.44
15118,77668890,2023-02-03,590.1,1291.54
15119,77668890,2023-02-03,-101.3,1190.24
15120,77668890,2023-02-05,-149.93,1040.31
15121,77668890,2023-02-10,-120.91,919.4
15122,77668890,2023-02-11,-174.4,745.0
15123,77668890,2023-02-13,-98.34,646.66
15124,77668890,2023-02-14,132.75,779.41
15125,77668890,2023-02-14,18.83,798.2399999999999
15126,77668890,2023-02-14,-18.83,779.41
15127,77668890,2023-02-14,-33.09,746.3199999999999
15128,77688406,2023-01-31,,224.2
15129,77688406,2023-02-05,49.84,274.03999999999996
15130,77688406,2023-02-06,-16.5,257.53999999999996
15131,77688406,2023-02-07,1516.3,1773.84
15132,77688406,2023-02-08,-140.07,1633.77
15133,77688406,2023-02-10,95.08,1728.85
15134,77688406,2023-02-14,-101.1,1627.75
15135,77717508,2023-01-31,,493.27
15136,77717508,2023-02-01,-173.96,319.30999999999995
15137,77717508,2023-02-03,-73.31,245.99999999999997
15138,77717508,2023-02-04,119.83,365.83
15139,77717508,2023-02-12,125.62,491.45
15140,77717508,2023-02-12,110.26,601.71
15141,77717508,2023-02-12,99.41,701.12
15142,77722115,2023-01-31,,735.94
15143,77722115,2023-02-01,-160.76,575.1800000000001
15144,77722115,2023-02-02,-130.9,444.2800000000001
15145,77722115,2023-02-03,129.36,573.6400000000001
15146,77722115,2023-02-05,92.6,666.24
15147,77722115,2023-02-05,80.56,746.8000000000001
15148,77722115,2023-02-05,-138.32,608.48
15149,77722115,2023-02-06,134.96,743.44
15150,77722115,2023-02-07,-204.81,538.6300000000001
15151,77722115,2023-02-09,178.61,717.2400000000001
15152,77722115,2023-02-14,-142.86,574.3800000000001
15153,77737443,2023-01-31,,220.7
15154,77737443,2023-02-03,-115.87,104.82999999999998
15155,77737443,2023-02-04,-187.19,-82.36000000000001
15156,77737443,2023-02-06,103.08,20.719999999999985
15157,77737443,2023-02-07,44.02,64.73999999999998
15158,77737443,2023-02-11,73.94,138.67999999999998
15159,77737443,2023-02-12,93.78,232.45999999999998
15160,77737443,2023-02-12,11.78,244.23999999999998
15161,77792490,2023-01-31,,822.76
15162,77792490,2023-02-01,-150.38,672.38
15163,77792490,2023-02-03,122.22,794.6
15164,77792490,2023-02-04,-123.43,671.17
15165,77792490,2023-02-04,-133.46,537.71
15166,77792490,2023-02-06,124.17,661.88
15167,77792490,2023-02-11,-89.5,572.38
15168,77792490,2023-02-11,-92.62,479.76
15169,77792490,2023-02-12,132.28,612.04
15170,77792490,2023-02-13,111.75,723.79
15171,77797288,2023-01-31,,199.97
15172,77797288,2023-02-02,-68.63,131.34
15173,77797288,2023-02-05,1852.7,1984.04
15174,77797288,2023-02-12,1808.9,3792.94
15175,77797288,2023-02-12,-108.19,3684.75
15176,77802960,2023-01-31,,157.47
15177,77802960,2023-02-06,-156.97,0.5
15178,77802960,2023-02-07,-106.8,-106.3
15179,77802960,2023-02-14,140.97,34.67
15180,77838890,2023-01-31,,951.16
15181,77838890,2023-02-01,85.61,1036.77
15182,77838890,2023-02-10,812.8,1849.57
15183,77838890,2023-02-11,-11.3,1838.27
15184,77838890,2023-02-13,101.4,1939.6699999999998
15185,77838890,2023-02-14,56.24,1995.9099999999999
15186,77841390,2023-01-31,,673.82
15187,77841390,2023-02-04,-81.91,591.9100000000001
15188,77841390,2023-02-07,-98.66,493.25000000000006
15189,77841390,2023-02-08,1908.7,2401.9500000000003
15190,77841390,2023-02-12,-151.37,2250.58
15191,77841390,2023-02-13,-61.83,2188.75
15192,77841390,2023-02-14,-44.44,2144.31
15193,77847751,2023-01-31,,850.14
15194,77847751,2023-02-09,-74.39,775.75
15195,77847751,2023-02-10,-195.79,579.96
15196,77847751,2023-02-13,26.0,605.96
15197,77847751,2023-02-14,-302.7,303.26
15198,77867306,2023-01-31,,907.96
15199,77867306,2023-02-06,-168.93,739.03
15200,77867306,2023-02-09,-190.68,548.35
15201,77867306,2023-02-09,-787.2,-238.85000000000002
15202,77867306,2023-02-11,-851.2,-1090.0500000000002
15203,77867306,2023-02-12,76.15,-1013.9000000000001
15204,77867306,2023-02-14,-69.99,-1083.89
15205,77880852,2023-01-31,,550.69
15206,77880852,2023-02-02,179.67,730.36
15207,77880852,2023-02-03,-113.03,617.33
15208,77880852,2023-02-04,1649.2,2266.53
15209,77880852,2023-02-04,55.7,2322.23
15210,77880852,2023-02-06,-140.03,2182.2
15211,77880852,2023-02-07,81.45,2263.65
15212,77880852,2023-02-10,47.22,2310.87
15213,77880852,2023-02-10,-103.62,2207.25
15214,77880852,2023-02-12,68.38,2275.63
15215,77911836,2023-01-31,,87.75
15216,77911836,2023-02-02,-51.61,36.14
15217,77911836,2023-02-03,46.29,82.43
15218,77911836,2023-02-03,-622.9,-540.47
15219,77911836,2023-02-06,-114.33,-654.8
15220,77911836,2023-02-08,99.5,-555.3
15221,77913078,2023-01-31,,885.96
15222,77913078,2023-02-01,14.22,900.1800000000001
15223,77913078,2023-02-02,93.5,993.6800000000001
15224,77913078,2023-02-03,-193.29,800.3900000000001
15225,77913078,2023-02-10,43.52,843.9100000000001
15226,77913078,2023-02-12,154.82,998.73
15227,77917083,2023-01-31,,929.41
15228,77917083,2023-02-04,135.89,1065.3
15229,77917083,2023-02-05,-78.8,986.5
15230,77917083,2023-02-08,1119.6,2106.1
15231,77931114,2023-01-31,,480.52
15232,77931114,2023-02-01,57.95,538.47
15233,77931114,2023-02-05,64.41,602.88
15234,77931114,2023-02-06,-67.96,534.92
15235,77931114,2023-02-07,-99.87,435.04999999999995
15236,77931114,2023-02-09,-82.99,352.06
15237,77931114,2023-02-11,-181.51,170.55
15238,77931114,2023-02-12,-1041.9,-871.3500000000001
15239,77966293,2023-01-31,,904.28
15240,77966293,2023-02-03,-77.0,827.28
15241,77966293,2023-02-04,44.5,871.78
15242,77966293,2023-02-05,81.21,952.99
15243,77966293,2023-02-06,22.54,975.53
15244,77966293,2023-02-08,132.99,1108.52
15245,77966293,2023-02-08,96.66,1205.18
15246,77966293,2023-02-12,-134.41,1070.77
15247,77966293,2023-02-13,-81.41,989.36
15248,77966293,2023-02-14,100.41,1089.77
15249,77980498,2023-01-31,,893.87
15250,77980498,2023-02-01,-50.55,843.32
15251,77980498,2023-02-01,-81.36,761.96
15252,77980498,2023-02-01,-102.31,659.65
15253,77980498,2023-02-04,-46.96,612.69
15254,77980498,2023-02-10,819.0,1431.69
15255,77980498,2023-02-11,36.07,1467.76
15256,78004131,2023-01-31,,723.24
15257,78004131,2023-02-01,-34.17,689.07
15258,78004131,2023-02-04,-37.75,651.32
15259,78004131,2023-02-07,-12.69,638.63
15260,78004131,2023-02-08,-1245.5,-606.87
15261,78004131,2023-02-10,156.94,-449.93
15262,78047487,2023-01-31,,417.33
15263,78047487,2023-02-13,-61.15,356.18
15264,78065026,2023-01-31,,356.26
15265,78065026,2023-02-02,-80.01,276.25
15266,78065026,2023-02-05,-41.55,234.7
15267,78065026,2023-02-07,-75.46,159.24
15268,78065026,2023-02-09,38.34,197.57999999999998
15269,78065026,2023-02-13,-194.21,3.3700000000000045
15270,78072161,2023-01-31,,914.19
15271,78072161,2023-02-01,-76.69,837.5
15272,78072161,2023-02-03,70.99,908.49
15273,78072161,2023-02-05,-175.05,733.44
15274,78072161,2023-02-06,-118.48,614.96
15275,78072161,2023-02-07,111.08,726.0400000000001
15276,78072161,2023-02-11,-102.26,623.7800000000001
15277,78076137,2023-01-31,,290.47
15278,78076137,2023-02-01,128.93,419.40000000000003
15279,78076137,2023-02-02,-45.75,373.65000000000003
15280,78076137,2023-02-04,1231.2,1604.8500000000001
15281,78076137,2023-02-04,-130.12,1474.73
15282,78076137,2023-02-05,-357.9,1116.8300000000002
15283,78076137,2023-02-10,-171.22,945.6100000000001
15284,78076137,2023-02-12,78.91,1024.5200000000002
15285,78076137,2023-02-13,115.5,1140.0200000000002
15286,78076137,2023-02-13,-734.3,405.72000000000025
15287,78129803,2023-01-31,,233.76
15288,78129803,2023-02-03,38.61,272.37
15289,78129803,2023-02-03,-168.33,104.03999999999996
15290,78129803,2023-02-05,540.8,644.8399999999999
15291,78129803,2023-02-08,-154.46,490.3799999999999
15292,78129803,2023-02-11,35.03,525.4099999999999
15293,78129803,2023-02-12,146.81,672.2199999999999
15294,78129803,2023-02-12,-122.36,549.8599999999999
15295,78129803,2023-02-13,-41.75,508.1099999999999
15296,78129803,2023-02-13,-79.84,428.2699999999999
15297,78133064,2023-01-31,,103.96
15298,78133064,2023-02-02,103.44,207.39999999999998
15299,78133064,2023-02-02,-156.52,50.879999999999995
15300,78133064,2023-02-03,1935.5,1986.38
15301,78133064,2023-02-10,129.69,2116.07
15302,78133064,2023-02-12,177.52,2293.59
15303,78133064,2023-02-12,149.27,2442.86
15304,78133064,2023-02-12,-100.06,2342.8
15305,78167719,2023-01-31,,969.06
15306,78167719,2023-02-03,53.43,1022.4899999999999
15307,78167719,2023-02-03,-130.91,891.5799999999999
15308,78167719,2023-02-04,944.5,1836.08
15309,78167719,2023-02-04,71.57,1907.6499999999999
15310,78167719,2023-02-07,142.95,2050.6
15311,78167719,2023-02-07,-84.81,1965.79
15312,78167719,2023-02-09,-63.95,1901.84
15313,78167719,2023-02-14,-97.06,1804.78
15314,78167719,2023-02-14,-110.42,1694.36
15315,78167719,2023-02-14,-147.72,1546.6399999999999
15316,78175956,2023-01-31,,124.55
15317,78175956,2023-02-02,114.44,238.99
15318,78175956,2023-02-04,-74.84,164.14999999999998
15319,78175956,2023-02-06,106.31,270.46
15320,78175956,2023-02-09,-10.05,260.40999999999997
15321,78175956,2023-02-14,-61.34,199.07
15322,78184766,2023-01-31,,98.1
15323,78184766,2023-02-05,-109.41,-11.310000000000002
15324,78184766,2023-02-08,43.9,32.589999999999996
15325,78184766,2023-02-08,-68.63,-36.04
15326,78184766,2023-02-10,-75.51,-111.55000000000001
15327,78184766,2023-02-12,-76.71,-188.26
15328,78234498,2023-01-31,,697.88
15329,78234498,2023-02-01,69.18,767.06
15330,78234498,2023-02-04,1369.6,2136.66
15331,78234498,2023-02-13,112.88,2249.54
15332,78257880,2023-01-31,,933.22
15333,78257880,2023-02-03,753.5,1686.72
15334,78257880,2023-02-03,180.52,1867.24
15335,78257880,2023-02-03,97.96,1965.2
15336,78257880,2023-02-08,151.47,2116.67
15337,78257880,2023-02-09,548.3,2664.9700000000003
15338,78257880,2023-02-09,-587.9,2077.07
15339,78257880,2023-02-10,-31.28,2045.79
15340,78268704,2023-01-31,,888.99
15341,78268704,2023-02-05,997.4,1886.3899999999999
15342,78268704,2023-02-05,141.36,2027.75
15343,78268704,2023-02-06,431.9,2459.65
15344,78268704,2023-02-07,-26.33,2433.32
15345,78268704,2023-02-07,-86.16,2347.16
15346,78268704,2023-02-13,-24.32,2322.84
15347,78296743,2023-01-31,,406.97
15348,78296743,2023-02-01,-1888.2,-1481.23
15349,78296743,2023-02-02,-108.67,-1589.9
15350,78296743,2023-02-07,-94.27,-1684.17
15351,78296743,2023-02-08,96.34,-1587.83
15352,78296743,2023-02-08,-36.72,-1624.55
15353,78296743,2023-02-08,-154.6,-1779.15
15354,78296743,2023-02-09,-103.44,-1882.59
15355,78296743,2023-02-10,-66.19,-1948.78
15356,78296743,2023-02-10,-143.84,-2092.62
15357,78296743,2023-02-13,62.36,-2030.26
15358,78296743,2023-02-13,-334.9,-2365.16
15359,78303304,2023-01-31,,921.4
15360,78303304,2023-02-03,-108.32,813.0799999999999
15361,78303304,2023-02-06,-91.58,721.5
15362,78303304,2023-02-08,130.43,851.9300000000001
15363,78343618,2023-01-31,,30.43
15364,78343618,2023-02-01,80.43,110.86000000000001
15365,78343618,2023-02-01,9.32,120.18
15366,78343618,2023-02-02,72.9,193.08
15367,78343618,2023-02-02,-1193.3,-1000.2199999999999
15368,78343618,2023-02-03,-1632.0,-2632.22
15369,78343618,2023-02-08,107.47,-2524.75
15370,78343618,2023-02-13,164.76,-2359.99
15371,78362587,2023-01-31,,390.79
15372,78362587,2023-02-01,-1292.5,-901.71
15373,78362587,2023-02-02,142.45,-759.26
15374,78362587,2023-02-02,-1499.9,-2259.16
15375,78362587,2023-02-04,1266.4,-992.76
15376,78362587,2023-02-04,-66.32,-1059.08
15377,78362587,2023-02-04,-1510.5,-2569.58
15378,78362587,2023-02-07,-136.3,-2705.88
15379,78362587,2023-02-10,35.64,-2670.24
15380,78362587,2023-02-10,-25.41,-2695.65
15381,78362587,2023-02-12,-118.77,-2814.42
15382,78392456,2023-01-31,,592.04
15383,78392456,2023-02-02,123.8,715.8399999999999
15384,78392456,2023-02-04,-41.13,674.7099999999999
15385,78392456,2023-02-05,65.73,740.4399999999999
15386,78392456,2023-02-07,-71.99,668.4499999999999
15387,78392456,2023-02-09,158.77,827.22
15388,78392456,2023-02-10,-222.4,604.8199999999999
15389,78392456,2023-02-11,205.44,810.26
15390,78392456,2023-02-11,94.31,904.5699999999999
15391,78392456,2023-02-12,108.51,1013.0799999999999
15392,78392456,2023-02-13,-42.54,970.54
15393,78395863,2023-01-31,,458.24
15394,78395863,2023-02-01,168.34,626.58
15395,78395863,2023-02-02,379.5,1006.08
15396,78395863,2023-02-02,-101.46,904.62
15397,78395863,2023-02-03,-153.58,751.04
15398,78395863,2023-02-09,-49.68,701.36
15399,78395863,2023-02-10,85.31,786.6700000000001
15400,78395863,2023-02-11,-126.78,659.89
15401,78395863,2023-02-12,-1619.3,-959.41
15402,78395863,2023-02-13,177.52,-781.89
15403,78493642,2023-01-31,,748.98
15404,78493642,2023-02-02,53.59,802.57
15405,78493642,2023-02-02,-54.11,748.46
15406,78493642,2023-02-02,-103.47,644.99
15407,78493642,2023-02-07,185.02,830.01
15408,78493642,2023-02-07,113.23,943.24
15409,78493642,2023-02-07,65.6,1008.84
15410,78493642,2023-02-09,134.78,1143.6200000000001
15411,78493642,2023-02-10,167.69,1311.31
15412,78493642,2023-02-13,161.8,1473.1100000000001
15413,78501355,2023-01-31,,910.42
15414,78501355,2023-02-04,1610.8,2521.22
15415,78501355,2023-02-07,210.28,2731.5
15416,78501355,2023-02-10,1038.8,3770.3
15417,78541427,2023-01-31,,366.51
15418,78541427,2023-02-03,718.2,1084.71
15419,78541427,2023-02-06,-981.9,102.81000000000006
15420,78541427,2023-02-06,-1751.6,-1648.79
15421,78541427,2023-02-07,76.58,-1572.21
15422,78541427,2023-02-09,-32.87,-1605.08
15423,78541427,2023-02-13,116.3,-1488.78
15424,78541427,2023-02-14,-95.3,-1584.08
15425,78580221,2023-01-31,,271.94
15426,78580221,2023-02-01,105.16,377.1
15427,78580221,2023-02-06,-121.13,255.97
15428,78580221,2023-02-12,-96.6,159.37
15429,78580221,2023-02-12,-197.29,-37.91999999999999
15430,78580221,2023-02-14,119.48,81.56000000000002
15431,78584818,2023-01-31,,723.21
15432,78584818,2023-02-02,122.42,845.63
15433,78584818,2023-02-03,119.02,964.6500000000001
15434,78584818,2023-02-07,124.55,1089.2
15435,78584818,2023-02-09,-56.03,1033.17
15436,78667134,2023-01-31,,672.23
15437,78667134,2023-02-02,-93.09,579.14
15438,78667134,2023-02-03,-135.44,443.70000000000005
15439,78667134,2023-02-04,153.31,597.01
15440,78667134,2023-02-04,39.71,636.72
15441,78667134,2023-02-08,-97.07,539.6500000000001
15442,78667134,2023-02-13,77.77,617.4200000000001
15443,78667134,2023-02-13,-55.07,562.35
15444,78667134,2023-02-14,-68.56,493.79
15445,78673350,2023-01-31,,307.25
15446,78673350,2023-02-03,74.72,381.97
15447,78673350,2023-02-08,112.44,494.40999999999997
15448,78673350,2023-02-09,-137.17,357.24
15449,78673350,2023-02-14,18.62,375.86
15450,78716149,2023-01-31,,658.83
15451,78716149,2023-02-01,-49.84,608.99
15452,78716149,2023-02-02,-184.29,424.70000000000005
15453,78716149,2023-02-06,38.7,463.40000000000003
15454,78716149,2023-02-08,40.13,503.53000000000003
15455,78716149,2023-02-10,-106.03,397.50000000000006
15456,78716149,2023-02-14,85.81,483.31000000000006
15457,78767161,2023-01-31,,248.42
15458,78767161,2023-02-01,-115.41,133.01
15459,78767161,2023-02-02,22.54,155.54999999999998
15460,78767161,2023-02-02,-133.59,21.95999999999998
15461,78767161,2023-02-05,-185.3,-163.34000000000003
15462,78767161,2023-02-06,8.04,-155.30000000000004
15463,78767161,2023-02-06,-69.84,-225.14000000000004
15464,78767161,2023-02-08,110.07,-115.07000000000005
15465,78767161,2023-02-11,75.14,-39.93000000000005
15466,78767161,2023-02-14,-103.18,-143.11000000000007
15467,78773905,2023-01-31,,511.78
15468,78773905,2023-02-10,-189.51,322.27
15469,78773905,2023-02-11,-1104.5,-782.23
15470,78773905,2023-02-12,116.83,-665.4
15471,78773905,2023-02-12,-51.02,-716.4200000000001
15472,78773905,2023-02-13,-38.13,-754.5500000000001
15473,78807944,2023-01-31,,442.48
15474,78807944,2023-02-01,-90.9,351.58000000000004
15475,78807944,2023-02-04,-134.34,217.24
15476,78807944,2023-02-06,141.23,358.47
15477,78807944,2023-02-07,226.83,585.3
15478,78807944,2023-02-08,-9.19,576.11
15479,78807944,2023-02-10,152.17,728.28
15480,78807944,2023-02-12,-75.44,652.84
15481,78807944,2023-02-12,-169.34,483.5
15482,78807944,2023-02-13,92.53,576.03
15483,78807944,2023-02-13,-161.8,414.23
15484,78844183,2023-01-31,,194.7
15485,78844183,2023-02-02,-12.35,182.35
15486,78844183,2023-02-05,-181.42,0.9300000000000068
15487,78844183,2023-02-06,-132.29,-131.35999999999999
15488,78844183,2023-02-12,-50.34,-181.7
15489,78844183,2023-02-13,-101.09,-282.78999999999996
15490,78905675,2023-01-31,,11.18
15491,78905675,2023-02-01,-84.08,-72.9
15492,78905675,2023-02-04,-138.04,-210.93999999999997
15493,78905675,2023-02-05,-101.84,-312.78
15494,78905675,2023-02-08,129.7,-183.07999999999998
15495,78905675,2023-02-08,100.85,-82.22999999999999
15496,78905675,2023-02-08,53.66,-28.569999999999993
15497,78905675,2023-02-09,35.18,6.6100000000000065
15498,78905675,2023-02-10,11.07,17.680000000000007
15499,78905675,2023-02-13,-48.01,-30.32999999999999
15500,78905675,2023-02-13,-79.92,-110.25
15501,78913378,2023-01-31,,378.08
15502,78913378,2023-02-01,-84.25,293.83
15503,78913378,2023-02-03,-127.62,166.20999999999998
15504,78913378,2023-02-04,68.87,235.07999999999998
15505,78913378,2023-02-04,-143.88,91.19999999999999
15506,78913378,2023-02-05,-58.45,32.749999999999986
15507,78913378,2023-02-06,-711.2,-678.45
15508,78913378,2023-02-08,146.5,-531.95
15509,78913378,2023-02-12,-72.09,-604.0400000000001
15510,78913378,2023-02-12,-85.39,-689.4300000000001
15511,78927989,2023-01-31,,825.23
15512,78927989,2023-02-02,22.64,847.87
15513,78927989,2023-02-05,-60.35,787.52
15514,78927989,2023-02-05,-1174.8,-387.28
15515,78927989,2023-02-07,-105.18,-492.46
15516,78927989,2023-02-09,217.27,-275.18999999999994
15517,78927989,2023-02-09,153.45,-121.73999999999998
15518,78927989,2023-02-11,-148.81,-270.54999999999995
15519,78927989,2023-02-12,66.32,-204.23
15520,78927989,2023-02-13,66.55,-137.68
15521,78927989,2023-02-13,52.26,-85.41999999999999
15522,78927989,2023-02-14,-31.7,-117.11999999999999
15523,78927989,2023-02-14,-34.84,-151.95999999999998
15524,78945298,2023-01-31,,609.68
15525,78945298,2023-02-03,100.81,710.49
15526,78945298,2023-02-04,1320.2,2030.69
15527,78945298,2023-02-05,119.75,2150.44
15528,78945298,2023-02-05,115.53,2265.9700000000003
15529,78945298,2023-02-07,883.6,3149.57
15530,78945298,2023-02-07,-194.01,2955.56
15531,78945298,2023-02-08,58.82,3014.38
15532,78945298,2023-02-09,-115.06,2899.32
15533,78953379,2023-01-31,,45.3
15534,78953379,2023-02-02,-181.56,-136.26
15535,78953379,2023-02-05,53.54,-82.72
15536,78953379,2023-02-05,-325.0,-407.72
15537,78953379,2023-02-10,80.36,-327.36
15538,78953379,2023-02-12,85.93,-241.43
15539,78953379,2023-02-12,53.57,-187.86
15540,78953379,2023-02-14,-63.74,-251.60000000000002
15541,79015773,2023-01-31,,706.11
15542,79015773,2023-02-03,-74.72,631.39
15543,79015773,2023-02-10,111.05,742.44
15544,79015773,2023-02-11,74.36,816.8
15545,79015773,2023-02-12,-91.81,724.99
15546,79015773,2023-02-12,-95.84,629.15
15547,79015773,2023-02-13,39.15,668.3
15548,79015773,2023-02-14,118.75,787.05
15549,79033058,2023-01-31,,97.12
15550,79033058,2023-02-01,-167.53,-70.41
15551,79033058,2023-02-02,-117.49,-187.89999999999998
15552,79033058,2023-02-04,1454.9,1267.0
15553,79033058,2023-02-09,-1504.7,-237.70000000000005
15554,79033058,2023-02-12,68.89,-168.81000000000006
15555,79033058,2023-02-13,-47.82,-216.63000000000005
15556,79036903,2023-01-31,,491.23
15557,79036903,2023-02-01,16.06,507.29
15558,79036903,2023-02-03,-45.41,461.88
15559,79036903,2023-02-09,181.31,643.19
15560,79036903,2023-02-09,-119.51,523.6800000000001
15561,79036903,2023-02-10,-179.1,344.58000000000004
15562,79036903,2023-02-11,-64.21,280.37000000000006
15563,79036903,2023-02-11,-72.7,207.67000000000004
15564,79036903,2023-02-11,-137.26,70.41000000000005
15565,79036903,2023-02-13,-161.44,-91.02999999999994
15566,79036903,2023-02-14,-141.13,-232.15999999999994
15567,79069274,2023-01-31,,685.1
15568,79069274,2023-02-03,-104.0,581.1
15569,79069274,2023-02-09,-97.15,483.95000000000005
15570,79069274,2023-02-12,-103.74,380.21000000000004
15571,79069274,2023-02-13,-86.79,293.42
15572,79090076,2023-01-31,,119.25
15573,79090076,2023-02-01,130.83,250.08
15574,79090076,2023-02-02,1520.8,1770.8799999999999
15575,79090076,2023-02-02,-551.2,1219.6799999999998
15576,79090076,2023-02-03,187.7,1407.3799999999999
15577,79090076,2023-02-07,-54.35,1353.0299999999997
15578,79090076,2023-02-07,-126.32,1226.7099999999998
15579,79090076,2023-02-09,210.8,1437.5099999999998
15580,79090076,2023-02-09,-101.12,1336.3899999999999
15581,79090076,2023-02-13,-144.82,1191.57
15582,79090076,2023-02-14,174.26,1365.83
15583,79091642,2023-01-31,,961.45
15584,79091642,2023-02-02,663.6,1625.0500000000002
15585,79091642,2023-02-05,110.12,1735.17
15586,79091642,2023-02-07,133.96,1869.13
15587,79091642,2023-02-10,64.46,1933.5900000000001
15588,79091642,2023-02-10,-125.47,1808.1200000000001
15589,79118116,2023-01-31,,463.1
15590,79118116,2023-02-01,55.58,518.6800000000001
15591,79118116,2023-02-01,-105.55,413.13
15592,79118116,2023-02-02,-136.38,276.75
15593,79118116,2023-02-04,122.06,398.81000000000006
15594,79118116,2023-02-06,141.06,539.87
15595,79118116,2023-02-07,-101.44,438.43000000000006
15596,79118116,2023-02-10,97.03,535.46
15597,79147964,2023-01-31,,753.1
15598,79147964,2023-02-01,169.68,922.78
15599,79147964,2023-02-01,102.61,1025.39
15600,79147964,2023-02-01,-52.32,973.07
15601,79147964,2023-02-02,130.9,1103.97
15602,79147964,2023-02-02,-183.83,920.14
15603,79147964,2023-02-04,210.25,1130.39
15604,79147964,2023-02-05,-63.7,1066.69
15605,79163824,2023-01-31,,938.15
15606,79163824,2023-02-01,-899.8,38.35000000000002
15607,79163824,2023-02-04,-63.81,-25.45999999999998
15608,79163824,2023-02-06,125.82,100.36000000000001
15609,79163824,2023-02-06,81.68,182.04000000000002
15610,79163824,2023-02-12,111.68,293.72
15611,79163824,2023-02-14,147.24,440.96000000000004
15612,79169988,2023-01-31,,354.01
15613,79169988,2023-02-02,136.38,490.39
15614,79169988,2023-02-06,51.53,541.92
15615,79169988,2023-02-08,-31.3,510.62
15616,79169988,2023-02-08,-102.11,408.51
15617,79169988,2023-02-09,827.3,1235.81
15618,79169988,2023-02-10,212.1,1447.9099999999999
15619,79169988,2023-02-13,58.3,1506.21
15620,79169988,2023-02-13,-93.56,1412.6499999999999
15621,79181666,2023-01-31,,600.88
15622,79181666,2023-02-04,103.33,704.21
15623,79181666,2023-02-08,-138.31,565.9
15624,79181666,2023-02-09,123.84,689.74
15625,79181666,2023-02-10,66.98,756.72
15626,79181666,2023-02-11,77.77,834.49
15627,79181666,2023-02-12,108.96,943.4499999999999
15628,79181666,2023-02-14,129.59,1073.04
15629,79181666,2023-02-14,-129.29,943.75
15630,79213491,2023-01-31,,308.65
15631,79213491,2023-02-03,-49.16,259.49
15632,79213491,2023-02-05,-51.72,207.76999999999998
15633,79213491,2023-02-05,-216.4,-8.630000000000024
15634,79213491,2023-02-07,-11.99,-20.620000000000026
15635,79213491,2023-02-09,-37.9,-58.520000000000024
15636,79307217,2023-01-31,,307.87
15637,79307217,2023-02-02,93.31,401.18
15638,79307217,2023-02-08,26.82,428.0
15639,79307217,2023-02-09,101.37,529.37
15640,79307217,2023-02-10,79.08,608.45
15641,79307217,2023-02-13,60.19,668.64
15642,79309039,2023-01-31,,642.08
15643,79309039,2023-02-01,-96.14,545.94
15644,79309039,2023-02-03,164.94,710.8800000000001
15645,79309039,2023-02-04,124.74,835.62
15646,79309039,2023-02-06,78.77,914.3900000000001
15647,79309039,2023-02-06,-977.0,-62.6099999999999
15648,79309039,2023-02-11,-90.71,-153.31999999999988
15649,79309039,2023-02-11,-94.31,-247.62999999999988
15650,79325967,2023-01-31,,647.65
15651,79325967,2023-02-04,157.32,804.97
15652,79329254,2023-01-31,,984.43
15653,79329254,2023-02-08,-83.02,901.41
15654,79329254,2023-02-10,90.32,991.7299999999999
15655,79329254,2023-02-12,1143.7,2135.43
15656,79329254,2023-02-12,164.03,2299.46
15657,79329254,2023-02-12,-95.14,2204.32
15658,79355498,2023-01-31,,132.74
15659,79355498,2023-02-01,812.6,945.34
15660,79355498,2023-02-03,-119.56,825.78
15661,79355498,2023-02-05,-74.28,751.5
15662,79355498,2023-02-06,162.2,913.7
15663,79380893,2023-01-31,,163.15
15664,79380893,2023-02-01,-63.11,100.04
15665,79380893,2023-02-02,174.74,274.78000000000003
15666,79380893,2023-02-03,119.68,394.46000000000004
15667,79380893,2023-02-03,-146.88,247.58000000000004
15668,79380893,2023-02-09,196.47,444.05000000000007
15669,79380893,2023-02-12,28.61,472.66
15670,79380893,2023-02-12,-122.48,350.18000000000006
15671,79380893,2023-02-12,-160.14,190.04000000000005
15672,79415620,2023-01-31,,729.51
15673,79415620,2023-02-07,104.64,834.15
15674,79415620,2023-02-08,-113.38,720.77
15675,79415620,2023-02-10,-117.79,602.98
15676,79415620,2023-02-11,6.42,609.4
15677,79415620,2023-02-14,95.3,704.7
15678,79415620,2023-02-14,-64.1,640.6
15679,79435523,2023-01-31,,920.0
15680,79435523,2023-02-03,-17.57,902.43
15681,79435523,2023-02-04,100.66,1003.09
15682,79435523,2023-02-08,-140.73,862.36
15683,79435523,2023-02-12,91.9,954.26
15684,79435523,2023-02-13,-1397.6,-443.3399999999999
15685,79499412,2023-01-31,,159.51
15686,79499412,2023-02-01,960.8,1120.31
15687,79499412,2023-02-01,527.1,1647.4099999999999
15688,79499412,2023-02-14,43.42,1690.83
15689,79566165,2023-01-31,,64.47
15690,79566165,2023-02-01,-86.03,-21.560000000000002
15691,79566165,2023-02-04,-98.42,-119.98
15692,79566165,2023-02-05,94.95,-25.03
15693,79566165,2023-02-05,94.45,69.42
15694,79566165,2023-02-08,132.45,201.87
15695,79566165,2023-02-09,18.36,220.23000000000002
15696,79566165,2023-02-11,70.24,290.47
15697,79566165,2023-02-12,-140.52,149.95
15698,79566165,2023-02-14,-86.86,63.08999999999999
15699,79566627,2023-01-31,,377.62
15700,79566627,2023-02-02,-876.4,-498.78
15701,79566627,2023-02-03,-108.13,-606.91
15702,79566627,2023-02-04,122.23,-484.67999999999995
15703,79566627,2023-02-04,-105.93,-590.61
15704,79566627,2023-02-05,-17.69,-608.3
15705,79566627,2023-02-07,167.72,-440.58
15706,79566627,2023-02-08,-170.5,-611.0799999999999
15707,79566627,2023-02-09,-109.28,-720.36
15708,79566627,2023-02-12,-115.11,-835.47
15709,79566627,2023-02-13,-81.86,-917.3299999999999
15710,79566627,2023-02-14,72.35,-844.98
15711,79570236,2023-01-31,,91.66
15712,79570236,2023-02-05,-158.27,-66.61000000000001
15713,79570236,2023-02-07,-101.36,-167.97000000000003
15714,79570236,2023-02-08,1168.1,1000.1299999999999
15715,79570236,2023-02-11,-1000.2,-0.07000000000016371
15716,79599747,2023-01-31,,393.28
15717,79599747,2023-02-02,-57.66,335.62
15718,79599747,2023-02-03,92.94,428.55999999999995
15719,79599747,2023-02-04,109.45,538.01
15720,79599747,2023-02-06,125.59,663.6
15721,79632523,2023-01-31,,867.95
15722,79632523,2023-02-04,149.33,1017.2800000000001
15723,79632523,2023-02-04,146.68,1163.96
15724,79632523,2023-02-04,95.05,1259.01
15725,79632523,2023-02-05,-129.27,1129.74
15726,79632523,2023-02-08,93.73,1223.47
15727,79632523,2023-02-12,-910.1,313.37
15728,79656112,2023-01-31,,848.18
15729,79656112,2023-02-04,-157.32,690.8599999999999
15730,79656112,2023-02-04,-199.41,491.44999999999993
15731,79656355,2023-01-31,,766.41
15732,79656355,2023-02-01,1820.3,2586.71
15733,79656355,2023-02-02,186.07,2772.7799999999997
15734,79656355,2023-02-05,-85.62,2687.16
15735,79656355,2023-02-07,68.86,2756.02
15736,79656355,2023-02-08,-115.99,2640.0299999999997
15737,79656355,2023-02-09,-49.28,2590.75
15738,79656355,2023-02-10,-165.02,2425.7299999999996
15739,79656355,2023-02-11,-57.3,2368.43
15740,79656355,2023-02-13,94.19,2462.62
15741,79656355,2023-02-14,666.1,3128.72
15742,79656355,2023-02-14,-150.19,2978.5299999999997
15743,79757019,2023-01-31,,369.26
15744,79757019,2023-02-01,-116.57,252.69
15745,79757019,2023-02-04,-116.65,136.04
15746,79757019,2023-02-05,51.76,187.79999999999998
15747,79757019,2023-02-07,74.11,261.90999999999997
15748,79757019,2023-02-13,-93.14,168.76999999999998
15749,79771974,2023-01-31,,350.67
15750,79771974,2023-02-03,613.0,963.6700000000001
15751,79771974,2023-02-04,159.42,1123.0900000000001
15752,79771974,2023-02-04,-104.45,1018.6400000000001
15753,79771974,2023-02-07,-98.57,920.07
15754,79771974,2023-02-09,67.76,987.83
15755,79771974,2023-02-14,-43.95,943.8800000000001
15756,79792810,2023-01-31,,505.57
15757,79792810,2023-02-02,-308.77,196.8
15758,79792810,2023-02-11,-75.1,121.70000000000002
15759,79792810,2023-02-12,98.23,219.93
15760,79792810,2023-02-12,-142.78,77.15000000000003
15761,79933337,2023-01-31,,508.79
15762,79933337,2023-02-01,84.25,593.04
15763,79933337,2023-02-02,-78.21,514.83
15764,79933337,2023-02-03,1253.8,1768.63
15765,79933337,2023-02-04,113.62,1882.25
15766,79933337,2023-02-09,-125.98,1756.27
15767,79933337,2023-02-12,-123.95,1632.32
15768,80001684,2023-01-31,,572.24
15769,80001684,2023-02-05,41.33,613.57
15770,80001684,2023-02-05,-539.8,73.7700000000001
15771,80005822,2023-01-31,,930.08
15772,80005822,2023-02-05,160.23,1090.31
15773,80005822,2023-02-10,90.04,1180.3500000000001
15774,80005822,2023-02-10,-119.92,1060.43
15775,80005822,2023-02-12,61.43,1121.8600000000001
15776,80005822,2023-02-14,756.9,1878.76
15777,80015485,2023-01-31,,310.56
15778,80015485,2023-02-05,-56.51,254.05
15779,80015485,2023-02-10,-92.86,161.19
15780,80015485,2023-02-14,153.23,314.41999999999996
15781,80040176,2023-01-31,,533.74
15782,80040176,2023-02-03,137.98,671.72
15783,80040176,2023-02-03,-94.07,577.65
15784,80040176,2023-02-07,-21.02,556.63
15785,80040176,2023-02-07,-156.4,400.23
15786,80040176,2023-02-08,110.48,510.71
15787,80040176,2023-02-11,-245.04,265.67
15788,80040176,2023-02-13,-60.19,205.48000000000002
15789,80046304,2023-01-31,,951.74
15790,80046304,2023-02-03,99.68,1051.42
15791,80046304,2023-02-03,-70.99,980.4300000000001
15792,80046304,2023-02-04,53.03,1033.46
15793,80046304,2023-02-04,-167.73,865.73
15794,80046304,2023-02-05,190.01,1055.74
15795,80046304,2023-02-06,-109.48,946.26
15796,80046304,2023-02-13,120.16,1066.42
15797,80046304,2023-02-14,36.6,1103.02
15798,80135904,2023-01-31,,120.34
15799,80135904,2023-02-03,993.7,1114.04
15800,80135904,2023-02-05,-92.28,1021.7600000000001
15801,80135904,2023-02-07,-86.83,934.9300000000001
15802,80135904,2023-02-08,119.48,1054.41
15803,80135904,2023-02-13,375.1,1429.5100000000002
15804,80168427,2023-01-31,,19.01
15805,80168427,2023-02-01,-81.22,-62.209999999999994
15806,80168427,2023-02-01,-181.06,-243.26999999999998
15807,80168427,2023-02-03,75.28,-167.98999999999998
15808,80168427,2023-02-04,-138.34,-306.33
15809,80168427,2023-02-06,102.2,-204.13
15810,80184223,2023-01-31,,52.59
15811,80184223,2023-02-07,-153.24,-100.65
15812,80184223,2023-02-10,195.79,95.13999999999999
15813,80184223,2023-02-12,95.71,190.84999999999997
15814,80184223,2023-02-12,-13.57,177.27999999999997
15815,80244844,2023-01-31,,774.54
15816,80244844,2023-02-01,-90.07,684.47
15817,80244844,2023-02-04,128.19,812.66
15818,80244844,2023-02-04,-115.56,697.0999999999999
15819,80244844,2023-02-04,-199.36,497.73999999999995
15820,80244844,2023-02-08,140.07,637.81
15821,80244844,2023-02-08,-149.73,488.0799999999999
15822,80244844,2023-02-09,136.3,624.38
15823,80244844,2023-02-11,139.56,763.9399999999999
15824,80244844,2023-02-11,40.81,804.75
15825,80244844,2023-02-14,51.9,856.65
15826,80283776,2023-01-31,,334.03
15827,80283776,2023-02-02,83.88,417.90999999999997
15828,80283776,2023-02-02,-148.09,269.81999999999994
15829,80283776,2023-02-06,-22.17,247.64999999999998
15830,80283776,2023-02-07,-121.67,125.97999999999996
15831,80283776,2023-02-08,92.84,218.81999999999996
15832,80283776,2023-02-08,-123.29,95.52999999999996
15833,80283776,2023-02-13,-40.02,55.509999999999955
15834,80291188,2023-01-31,,338.65
15835,80291188,2023-02-01,70.27,408.91999999999996
15836,80291188,2023-02-05,-124.52,284.4
15837,80291188,2023-02-07,38.29,322.69
15838,80291188,2023-02-08,23.79,346.47999999999996
15839,80291188,2023-02-11,-71.24,275.24
15840,80291188,2023-02-11,-75.48,199.76
15841,80291188,2023-02-12,-75.56,124.19999999999997
15842,80291188,2023-02-13,111.96,236.15999999999997
15843,80304720,2023-01-31,,614.87
15844,80304720,2023-02-01,170.25,785.12
15845,80304720,2023-02-05,-68.75,716.37
15846,80325529,2023-01-31,,996.6
15847,80325529,2023-02-03,44.0,1040.6
15848,80325529,2023-02-03,-125.34,915.26
15849,80325529,2023-02-05,145.13,1060.39
15850,80325529,2023-02-05,-196.0,864.39
15851,80325529,2023-02-11,590.6,1454.99
15852,80325529,2023-02-13,71.7,1526.69
15853,80355773,2023-01-31,,906.28
15854,80355773,2023-02-01,-37.94,868.3399999999999
15855,80355773,2023-02-03,122.53,990.87
15856,80355773,2023-02-03,-5.38,985.49
15857,80355773,2023-02-05,-122.18,863.31
15858,80355773,2023-02-09,-82.14,781.17
15859,80355773,2023-02-13,56.91,838.0799999999999
15860,80355773,2023-02-14,-553.6,284.4799999999999
15861,80360244,2023-01-31,,658.35
15862,80360244,2023-02-03,-134.13,524.22
15863,80360244,2023-02-05,-83.59,440.63
15864,80360244,2023-02-06,-81.68,358.95000000000005
15865,80360244,2023-02-06,-1947.3,-1588.35
15866,80360244,2023-02-07,14.81,-1573.54
15867,80360244,2023-02-09,76.61,-1496.9299999999998
15868,80360244,2023-02-10,-11.31,-1508.24
15869,80379245,2023-01-31,,793.17
15870,80379245,2023-02-01,-56.06,737.1099999999999
15871,80379245,2023-02-03,146.59,883.6999999999999
15872,80379245,2023-02-06,61.92,945.62
15873,80379245,2023-02-06,-1.58,944.04
15874,80379245,2023-02-07,106.24,1050.28
15875,80379245,2023-02-08,-85.29,964.99
15876,80379245,2023-02-09,-40.77,924.2199999999999
15877,80379245,2023-02-13,107.98,1032.2
15878,80391084,2023-01-31,,466.35
15879,80391084,2023-02-03,-584.3,-117.94999999999993
15880,80391084,2023-02-06,28.34,-89.60999999999993
15881,80391084,2023-02-07,-122.13,-211.73999999999992
15882,80391084,2023-02-14,-116.9,-328.63999999999993
15883,80428983,2023-01-31,,323.32
15884,80428983,2023-02-02,-53.59,269.73
15885,80428983,2023-02-04,158.41,428.14
15886,80428983,2023-02-09,87.99,516.13
15887,80428983,2023-02-11,-58.01,458.12
15888,80428983,2023-02-12,-564.4,-106.27999999999997
15889,80428983,2023-02-13,-68.69,-174.96999999999997
15890,80428983,2023-02-13,-177.52,-352.49
15891,80428983,2023-02-14,-60.97,-413.46
15892,80439799,2023-01-31,,968.23
15893,80439799,2023-02-05,49.95,1018.1800000000001
15894,80439799,2023-02-11,62.33,1080.51
15895,80439799,2023-02-11,-156.49,924.02
15896,80439799,2023-02-14,-90.74,833.28
15897,80464084,2023-01-31,,12.73
15898,80464084,2023-02-02,145.27,158.0
15899,80464084,2023-02-03,-32.08,125.92
15900,80464084,2023-02-04,-189.06,-63.14
15901,80464084,2023-02-05,80.67,17.53
15902,80464084,2023-02-06,-70.94,-53.41
15903,80464084,2023-02-06,-213.44,-266.85
15904,80504934,2023-01-31,,759.22
15905,80504934,2023-02-04,-74.95,684.27
15906,80504934,2023-02-06,165.65,849.9200000000001
15907,80504934,2023-02-11,-160.29,689.63
15908,80504934,2023-02-14,114.98,804.61
15909,80596699,2023-01-31,,47.06
15910,80596699,2023-02-01,130.93,177.99
15911,80596699,2023-02-01,123.08,301.07
15912,80596699,2023-02-03,168.33,469.40000000000003
15913,80596699,2023-02-03,91.37,560.77
15914,80596699,2023-02-04,58.03,618.8000000000001
15915,80596699,2023-02-06,85.9,704.7
15916,80596699,2023-02-06,-35.38,669.32
15917,80596699,2023-02-07,48.65,717.97
15918,80596699,2023-02-13,-26.24,691.73
15919,80610910,2023-01-31,,139.54
15920,80610910,2023-02-02,-143.95,-4.409999999999997
15921,80610910,2023-02-05,164.35,159.94
15922,80610910,2023-02-06,-1032.3,-872.3599999999999
15923,80610910,2023-02-07,214.17,-658.1899999999999
15924,80678427,2023-01-31,,97.72
15925,80678427,2023-02-01,102.9,200.62
15926,80678427,2023-02-01,53.43,254.05
15927,80678427,2023-02-04,-87.1,166.95000000000002
15928,80678427,2023-02-05,142.28,309.23
15929,80678427,2023-02-08,-136.73,172.50000000000003
15930,80678427,2023-02-08,-144.26,28.240000000000038
15931,80678427,2023-02-08,-1051.4,-1023.1600000000001
15932,80678427,2023-02-12,106.86,-916.3000000000001
15933,80678427,2023-02-12,-140.79,-1057.0900000000001
15934,80678427,2023-02-13,136.9,-920.19
15935,80678577,2023-01-31,,288.61
15936,80678577,2023-02-04,94.62,383.23
15937,80678577,2023-02-11,163.65,546.88
15938,80678577,2023-02-13,75.02,621.9
15939,80709302,2023-01-31,,280.92
15940,80709302,2023-02-05,144.79,425.71000000000004
15941,80709302,2023-02-11,2044.6,2470.31
15942,80747298,2023-01-31,,768.33
15943,80747298,2023-02-09,119.77,888.1
15944,80747298,2023-02-13,138.24,1026.3400000000001
15945,80758476,2023-01-31,,977.44
15946,80758476,2023-02-06,91.53,1068.97
15947,80758476,2023-02-07,-5.07,1063.9
15948,80758476,2023-02-11,171.55,1235.45
15949,80761210,2023-01-31,,545.59
15950,80761210,2023-02-01,-143.85,401.74
15951,80761210,2023-02-04,173.75,575.49
15952,80761210,2023-02-04,-160.27,415.22
15953,80761210,2023-02-07,-105.09,310.13
15954,80761210,2023-02-08,73.68,383.81000000000006
15955,80761210,2023-02-10,113.99,497.8
15956,80778066,2023-01-31,,217.49
15957,80778066,2023-02-01,-55.58,161.91000000000003
15958,80778066,2023-02-03,149.87,311.78000000000003
15959,80778066,2023-02-03,36.57,348.35
15960,80778066,2023-02-07,56.13,404.48
15961,80778066,2023-02-08,-2.72,401.76000000000005
15962,80787776,2023-01-31,,460.46
15963,80787776,2023-02-01,142.26,602.72
15964,80787776,2023-02-03,72.41,675.13
15965,80787776,2023-02-03,-22.26,652.87
15966,80787776,2023-02-05,-102.9,549.9699999999999
15967,80787776,2023-02-05,-1295.5,-745.5300000000001
15968,80787776,2023-02-10,-112.36,-857.8900000000001
15969,80787776,2023-02-11,-172.5,-1030.39
15970,80787776,2023-02-14,150.42,-879.9700000000001
15971,80808205,2023-01-31,,280.92
15972,80808205,2023-02-01,-88.1,192.82000000000002
15973,80808205,2023-02-02,-1082.7,-889.88
15974,80808205,2023-02-02,-1698.0,-2587.88
15975,80808205,2023-02-03,133.1,-2454.78
15976,80808205,2023-02-05,73.78,-2381.0
15977,80808205,2023-02-06,-59.6,-2440.6
15978,80808205,2023-02-11,-193.89,-2634.4900000000002
15979,80808205,2023-02-13,214.61,-2419.88
15980,80808205,2023-02-13,-1017.6,-3437.48
15981,80811957,2023-01-31,,139.95
15982,80811957,2023-02-05,85.92,225.87
15983,80811957,2023-02-07,-112.22,113.64999999999999
15984,80811957,2023-02-13,40.65,154.29999999999998
15985,80812213,2023-01-31,,277.14
15986,80812213,2023-02-07,-81.75,195.39
15987,80812213,2023-02-07,-103.35,92.03999999999999
15988,80812213,2023-02-08,-67.93,24.109999999999985
15989,80818151,2023-01-31,,320.64
15990,80818151,2023-02-01,75.36,396.0
15991,80818151,2023-02-02,-10.1,385.9
15992,80818151,2023-02-06,436.1,822.0
15993,80877479,2023-01-31,,210.98
15994,80877479,2023-02-03,101.25,312.23
15995,80877479,2023-02-05,-112.01,200.21999999999997
15996,80877479,2023-02-06,-84.1,116.11999999999999
15997,80877479,2023-02-06,-1457.8,-1341.68
15998,80877479,2023-02-07,66.67,-1275.01
15999,80877479,2023-02-09,203.24,-1071.77
16000,80884901,2023-01-31,,453.71
16001,80884901,2023-02-05,-179.02,274.68999999999994
16002,80884901,2023-02-06,-59.73,214.95999999999998
16003,80884901,2023-02-07,-85.23,129.72999999999996
16004,80884901,2023-02-09,-128.31,1.419999999999959
16005,80884901,2023-02-11,34.89,36.30999999999996
16006,80884901,2023-02-14,61.16,97.46999999999996
16007,80889919,2023-01-31,,298.45
16008,80889919,2023-02-06,-20.39,278.06
16009,80889919,2023-02-08,130.71,408.77
16010,80938878,2023-01-31,,29.73
16011,80938878,2023-02-02,24.23,53.96
16012,80938878,2023-02-08,-70.5,-16.54
16013,80938878,2023-02-12,151.29,134.75
16014,80939694,2023-01-31,,923.76
16015,80939694,2023-02-04,861.1,1784.8600000000001
16016,80939694,2023-02-05,102.47,1887.33
16017,80939694,2023-02-08,66.57,1953.9
16018,80939694,2023-02-08,-79.57,1874.33
16019,80939694,2023-02-13,-64.31,1810.02
16020,80940019,2023-01-31,,957.41
16021,80940019,2023-02-02,308.77,1266.1799999999998
16022,80940019,2023-02-03,-612.6,653.5799999999999
16023,80940019,2023-02-07,-301.0,352.5799999999999
16024,80940019,2023-02-11,152.11,504.68999999999994
16025,81049128,2023-01-31,,694.91
16026,81049128,2023-02-06,113.47,808.38
16027,81049128,2023-02-09,-1727.8,-919.42
16028,81049128,2023-02-10,-191.56,-1110.98
16029,81049128,2023-02-11,74.61,-1036.37
16030,81075588,2023-01-31,,297.73
16031,81075588,2023-02-01,99.3,397.03000000000003
16032,81075588,2023-02-01,93.43,490.46000000000004
16033,81075588,2023-02-06,100.09,590.5500000000001
16034,81075588,2023-02-08,143.85,734.4000000000001
16035,81075588,2023-02-08,117.07,851.47
16036,81075588,2023-02-09,128.74,980.21
16037,81075588,2023-02-09,-123.35,856.86
16038,81075588,2023-02-10,-167.51,689.35
16039,81075588,2023-02-10,-169.0,520.35
16040,81075588,2023-02-11,-96.34,424.01000000000005
16041,81075588,2023-02-11,-152.76,271.25000000000006
16042,81087182,2023-01-31,,861.31
16043,81087182,2023-02-04,-107.78,753.53
16044,81087182,2023-02-05,-142.19,611.3399999999999
16045,81087182,2023-02-06,-136.6,474.73999999999995
16046,81087182,2023-02-09,-165.96,308.78
16047,81087182,2023-02-14,153.66,462.43999999999994
16048,81099534,2023-01-31,,216.8
16049,81099534,2023-02-01,-99.68,117.12
16050,81099534,2023-02-04,138.04,255.16
16051,81099534,2023-02-11,68.14,323.3
16052,81099534,2023-02-14,-117.23,206.07
16053,81145048,2023-01-31,,290.02
16054,81145048,2023-02-02,-115.05,174.96999999999997
16055,81145048,2023-02-03,-131.54,43.43000000000001
16056,81145048,2023-02-05,859.9,903.3299999999999
16057,81145048,2023-02-06,51.78,955.11
16058,81145048,2023-02-09,-898.2,56.90999999999997
16059,81145048,2023-02-12,-99.41,-42.50000000000003
16060,81145048,2023-02-12,-170.71,-213.21000000000004
16061,81159651,2023-01-31,,466.71
16062,81159651,2023-02-02,-44.56,422.15
16063,81159651,2023-02-05,126.51,548.66
16064,81159651,2023-02-07,55.28,603.9399999999999
16065,81159651,2023-02-08,-132.1,471.84
16066,81159651,2023-02-09,-67.99,403.84999999999997
16067,81159651,2023-02-12,-109.6,294.25
16068,81159651,2023-02-13,437.5,731.75
16069,81159651,2023-02-14,-42.19,689.56
16070,81181209,2023-01-31,,828.91
16071,81181209,2023-02-02,-58.23,770.68
16072,81181209,2023-02-09,181.77,952.45
16073,81181209,2023-02-09,118.7,1071.15
16074,81181209,2023-02-09,7.44,1078.59
16075,81181209,2023-02-10,1210.3,2288.89
16076,81181209,2023-02-11,-104.35,2184.54
16077,81191580,2023-01-31,,584.56
16078,81191580,2023-02-06,-14.55,570.01
16079,81191580,2023-02-10,-145.53,424.4799999999999
16080,81191580,2023-02-12,143.1,567.5799999999999
16081,81191580,2023-02-12,76.93,644.51
16082,81191580,2023-02-14,-135.36,509.1499999999999
16083,81200849,2023-01-31,,479.29
16084,81200849,2023-02-03,132.53,611.82
16085,81200849,2023-02-06,63.33,675.15
16086,81200849,2023-02-06,-99.31,575.84
16087,81200849,2023-02-07,-76.35,499.49
16088,81200849,2023-02-08,9.98,509.47
16089,81200849,2023-02-11,18.39,527.86
16090,81200849,2023-02-12,-165.42,362.44000000000005
16091,81206535,2023-01-31,,452.69
16092,81206535,2023-02-05,117.78,570.47
16093,81206535,2023-02-05,84.4,654.87
16094,81206535,2023-02-05,29.75,684.62
16095,81206535,2023-02-08,42.59,727.21
16096,81206535,2023-02-09,-22.93,704.28
16097,81206535,2023-02-10,190.89,895.17
16098,81206535,2023-02-13,47.54,942.71
16099,81206535,2023-02-14,-836.0,106.71000000000004
16100,81227009,2023-01-31,,475.45
16101,81227009,2023-02-01,95.83,571.28
16102,81227009,2023-02-01,-33.49,537.79
16103,81227009,2023-02-03,90.64,628.43
16104,81227009,2023-02-03,-59.28,569.15
16105,81227009,2023-02-07,91.92,661.0699999999999
16106,81227009,2023-02-10,144.33,805.4
16107,81227009,2023-02-11,75.12,880.52
16108,81227009,2023-02-11,-39.39,841.13
16109,81227009,2023-02-12,541.9,1383.03
16110,81227009,2023-02-12,144.19,1527.22
16111,81227009,2023-02-13,-136.4,1390.82
16112,81227009,2023-02-14,50.66,1441.48
16113,81227009,2023-02-14,-111.15,1330.33
16114,81245588,2023-01-31,,775.87
16115,81245588,2023-02-05,-85.92,689.95
16116,81245588,2023-02-10,83.51,773.46
16117,81245588,2023-02-10,-120.39,653.07
16118,81245588,2023-02-13,69.73,722.8
16119,81245588,2023-02-14,136.73,859.53
16120,81267006,2023-01-31,,425.16
16121,81267006,2023-02-02,168.67,593.83
16122,81267006,2023-02-03,-69.26,524.57
16123,81267006,2023-02-05,107.8,632.37
16124,81267006,2023-02-10,1430.6,2062.97
16125,81267006,2023-02-10,-135.89,1927.08
16126,81336389,2023-01-31,,210.06
16127,81336389,2023-02-01,119.5,329.56
16128,81336389,2023-02-03,77.36,406.92
16129,81336389,2023-02-03,-188.47,218.45
16130,81336389,2023-02-05,-106.54,111.90999999999998
16131,81336389,2023-02-06,-109.52,2.3899999999999864
16132,81336389,2023-02-09,83.99,86.37999999999998
16133,81336389,2023-02-10,-216.08,-129.70000000000005
16134,81336389,2023-02-13,99.54,-30.16000000000001
16135,81336389,2023-02-13,-149.91,-180.07
16136,81336468,2023-01-31,,935.41
16137,81336468,2023-02-02,807.9,1743.31
16138,81336468,2023-02-02,779.9,2523.21
16139,81336468,2023-02-02,-663.6,1859.61
16140,81336468,2023-02-02,-1327.5,532.1099999999999
16141,81336468,2023-02-05,37.98,570.0899999999999
16142,81336468,2023-02-06,75.77,645.8599999999999
16143,81336468,2023-02-07,127.56,773.4199999999998
16144,81336468,2023-02-09,154.98,928.3999999999999
16145,81336468,2023-02-09,146.02,1074.4199999999998
16146,81337623,2023-01-31,,815.36
16147,81337623,2023-02-04,-185.63,629.73
16148,81337623,2023-02-07,183.44,813.1700000000001
16149,81337623,2023-02-10,167.13,980.3
16150,81337623,2023-02-10,101.56,1081.8600000000001
16151,81337623,2023-02-12,-26.35,1055.51
16152,81337623,2023-02-14,69.51,1125.02
16153,81340143,2023-01-31,,647.34
16154,81340143,2023-02-05,103.36,750.7
16155,81340143,2023-02-09,-682.6,68.10000000000002
16156,81340143,2023-02-11,-47.38,20.72000000000002
16157,81384411,2023-01-31,,175.86
16158,81384411,2023-02-03,174.31,350.17
16159,81384411,2023-02-04,-1361.0,-1010.8299999999999
16160,81384411,2023-02-10,-63.87,-1074.6999999999998
16161,81384411,2023-02-11,67.21,-1007.4899999999999
16162,81384411,2023-02-11,-205.44,-1212.9299999999998
16163,81384411,2023-02-12,-114.27,-1327.1999999999998
16164,81398388,2023-01-31,,979.87
16165,81398388,2023-02-02,120.93,1100.8
16166,81398388,2023-02-02,15.93,1116.73
16167,81398388,2023-02-09,-115.5,1001.23
16168,81398388,2023-02-10,-97.88,903.35
16169,81398388,2023-02-13,-43.87,859.48
16170,81445756,2023-01-31,,267.66
16171,81445756,2023-02-03,-1253.8,-986.1399999999999
16172,81445756,2023-02-04,-110.0,-1096.1399999999999
16173,81475774,2023-01-31,,568.11
16174,81475774,2023-02-03,-156.2,411.91
16175,81475774,2023-02-04,1059.1,1471.01
16176,81475774,2023-02-04,89.97,1560.98
16177,81475774,2023-02-07,118.92,1679.9
16178,81475774,2023-02-10,-58.79,1621.11
16179,81475774,2023-02-12,-196.98,1424.13
16180,81475774,2023-02-13,-66.54,1357.59
16181,81527490,2023-01-31,,234.05
16182,81527490,2023-02-01,-102.61,131.44
16183,81527490,2023-02-02,108.67,240.11
16184,81527490,2023-02-05,135.59,375.70000000000005
16185,81527490,2023-02-06,1.14,376.84000000000003
16186,81527490,2023-02-07,69.94,446.78000000000003
16187,81527490,2023-02-07,-17.58,429.20000000000005
16188,81527490,2023-02-09,-181.77,247.43
16189,81527490,2023-02-09,-254.92,-7.489999999999981
16190,81527490,2023-02-12,174.92,167.43
16191,81527490,2023-02-13,100.05,267.48
16192,81527490,2023-02-13,-115.44,152.04000000000002
16193,81561788,2023-01-31,,454.89
16194,81561788,2023-02-02,-1106.9,-652.0100000000001
16195,81561788,2023-02-05,821.8,169.78999999999985
16196,81561788,2023-02-05,-94.45,75.33999999999985
16197,81561788,2023-02-06,48.45,123.78999999999985
16198,81561788,2023-02-07,96.93,220.71999999999986
16199,81561788,2023-02-08,85.01,305.72999999999985
16200,81561788,2023-02-09,-109.32,196.40999999999985
16201,81561788,2023-02-11,1777.8,1974.2099999999998
16202,81561788,2023-02-11,121.33,2095.54
16203,81590655,2023-01-31,,742.17
16204,81590655,2023-02-04,54.34,796.51
16205,81590655,2023-02-05,103.0,899.51
16206,81590655,2023-02-09,-54.35,845.16
16207,81590655,2023-02-10,712.2,1557.3600000000001
16208,81646873,2023-01-31,,188.36
16209,81646873,2023-02-02,-95.2,93.16000000000001
16210,81646873,2023-02-03,-62.59,30.570000000000007
16211,81646873,2023-02-04,78.93,109.50000000000001
16212,81646873,2023-02-06,89.63,199.13
16213,81646873,2023-02-07,81.96,281.09000000000003
16214,81646873,2023-02-09,10.45,291.54
16215,81646873,2023-02-09,-161.02,130.51999999999998
16216,81646873,2023-02-10,679.8,810.3199999999999
16217,81646873,2023-02-13,-100.5,709.8199999999999
16218,81651344,2023-01-31,,219.55
16219,81651344,2023-02-06,155.37,374.92
16220,81651344,2023-02-08,-92.38,282.54
16221,81651344,2023-02-09,-78.16,204.38000000000002
16222,81655495,2023-01-31,,315.33
16223,81655495,2023-02-01,-1139.7,-824.3700000000001
16224,81655495,2023-02-02,-1091.2,-1915.5700000000002
16225,81655495,2023-02-03,89.14,-1826.43
16226,81655495,2023-02-06,191.25,-1635.1800000000003
16227,81655495,2023-02-14,-81.21,-1716.39
16228,81662619,2023-01-31,,712.33
16229,81662619,2023-02-01,-137.9,574.4300000000001
16230,81662619,2023-02-06,82.51,656.94
16231,81662619,2023-02-07,152.96,809.9000000000001
16232,81662619,2023-02-10,-34.99,774.9100000000001
16233,81662619,2023-02-12,-109.89,665.02
16234,81662619,2023-02-14,141.21,806.23
16235,81727860,2023-01-31,,192.44
16236,81727860,2023-02-05,-99.25,93.19
16237,81727860,2023-02-08,76.65,169.84
16238,81727860,2023-02-09,-193.78,-23.939999999999998
16239,81740267,2023-01-31,,67.86
16240,81740267,2023-02-02,110.38,178.24
16241,81740267,2023-02-06,81.53,259.77
16242,81740267,2023-02-06,-110.09,149.68
16243,81823420,2023-01-31,,259.73
16244,81823420,2023-02-01,102.1,361.83000000000004
16245,81823420,2023-02-04,201.15,562.98
16246,81823420,2023-02-06,-49.47,513.51
16247,81823420,2023-02-10,8.29,521.8000000000001
16248,81823420,2023-02-11,38.25,560.0500000000001
16249,81855175,2023-01-31,,907.59
16250,81855175,2023-02-01,-42.34,865.25
16251,81855175,2023-02-01,-49.37,815.88
16252,81855175,2023-02-02,75.11,890.99
16253,81855175,2023-02-03,102.49,993.48
16254,81855175,2023-02-09,-892.4,101.08000000000004
16255,81855175,2023-02-10,-90.2,10.880000000000038
16256,81855175,2023-02-12,-1801.4,-1790.52
16257,81855175,2023-02-14,-32.96,-1823.48
16258,81923993,2023-01-31,,686.37
16259,81923993,2023-02-05,-637.3,49.07000000000005
16260,81923993,2023-02-10,27.72,76.79000000000005
16261,81923993,2023-02-11,142.72,219.51000000000005
16262,81923993,2023-02-11,130.08,349.59000000000003
16263,81923993,2023-02-12,-181.41,168.18000000000006
16264,81923993,2023-02-14,541.0,709.1800000000001
16265,81932657,2023-01-31,,146.81
16266,81932657,2023-02-01,80.7,227.51
16267,81932657,2023-02-01,58.0,285.51
16268,81932657,2023-02-08,1044.7,1330.21
16269,81932657,2023-02-09,-4.61,1325.6000000000001
16270,81932657,2023-02-12,-79.12,1246.48
16271,81994568,2023-01-31,,578.86
16272,81994568,2023-02-03,47.78,626.64
16273,81994568,2023-02-03,-20.43,606.21
16274,81994568,2023-02-04,1510.5,2116.71
16275,81994568,2023-02-06,58.84,2175.55
16276,81994568,2023-02-10,1463.6,3639.1499999999996
16277,81994568,2023-02-10,30.61,3669.7599999999998
16278,81994568,2023-02-10,-75.99,3593.77
16279,82002852,2023-01-31,,816.53
16280,82002852,2023-02-04,148.35,964.88
16281,82002852,2023-02-06,-49.21,915.67
16282,82002852,2023-02-09,-61.13,854.54
16283,82002852,2023-02-12,-119.03,735.51
16284,82023979,2023-01-31,,744.37
16285,82023979,2023-02-02,-1019.5,-275.13
16286,82023979,2023-02-03,104.62,-170.51
16287,82023979,2023-02-10,-107.4,-277.90999999999997
16288,82027257,2023-01-31,,681.1
16289,82027257,2023-02-02,129.77,810.87
16290,82027257,2023-02-07,-118.19,692.6800000000001
16291,82027257,2023-02-11,147.54,840.22
16292,82027257,2023-02-11,122.19,962.4100000000001
16293,82027257,2023-02-11,-184.66,777.75
16294,82027257,2023-02-12,-154.82,622.9300000000001
16295,82027257,2023-02-13,88.79,711.72
16296,82027257,2023-02-13,-74.3,637.4200000000001
16297,82043720,2023-01-31,,803.68
16298,82043720,2023-02-01,52.9,856.5799999999999
16299,82043720,2023-02-04,-118.34,738.24
16300,82043720,2023-02-08,119.51,857.75
16301,82043720,2023-02-10,-62.15,795.5999999999999
16302,82043720,2023-02-12,96.27,891.8699999999999
16303,82101740,2023-01-31,,469.34
16304,82101740,2023-02-01,-72.19,397.15
16305,82101740,2023-02-02,68.21,465.35999999999996
16306,82101740,2023-02-11,30.14,495.5
16307,82101740,2023-02-12,-153.41,342.09
16308,82101740,2023-02-13,-43.53,298.55999999999995
16309,82115900,2023-01-31,,446.89
16310,82115900,2023-02-14,1308.6,1755.4899999999998
16311,82177278,2023-01-31,,236.32
16312,82177278,2023-02-02,924.0,1160.32
16313,82177278,2023-02-02,-123.02,1037.3
16314,82177278,2023-02-08,-105.67,931.6299999999999
16315,82177278,2023-02-09,95.76,1027.3899999999999
16316,82177278,2023-02-10,75.98,1103.37
16317,82177278,2023-02-11,-64.7,1038.6699999999998
16318,82177278,2023-02-12,-130.79,907.8799999999999
16319,82177278,2023-02-13,-123.69,784.1899999999999
16320,82177278,2023-02-14,191.52,975.7099999999999
16321,82188502,2023-01-31,,788.02
16322,82188502,2023-02-01,66.19,854.21
16323,82188502,2023-02-01,-96.2,758.01
16324,82188502,2023-02-02,109.3,867.31
16325,82188502,2023-02-03,45.41,912.72
16326,82188502,2023-02-09,-109.88,802.8399999999999
16327,82188502,2023-02-09,-127.38,675.46
16328,82188502,2023-02-10,110.41,785.87
16329,82188502,2023-02-10,-73.39,712.48
16330,82233451,2023-01-31,,795.71
16331,82233451,2023-02-01,97.37,893.08
16332,82233451,2023-02-05,-167.85,725.23
16333,82233451,2023-02-13,155.44,880.6700000000001
16334,82259327,2023-01-31,,982.72
16335,82259327,2023-02-03,-134.35,848.37
16336,82259327,2023-02-04,-944.5,-96.13
16337,82259327,2023-02-05,1463.6,1367.4699999999998
16338,82259327,2023-02-07,112.11,1479.5799999999997
16339,82259327,2023-02-07,46.81,1526.3899999999999
16340,82259327,2023-02-09,107.63,1634.0199999999998
16341,82259327,2023-02-10,-94.84,1539.1799999999998
16342,82263080,2023-01-31,,928.54
16343,82263080,2023-02-03,-180.52,748.02
16344,82263080,2023-02-04,98.52,846.54
16345,82263080,2023-02-11,782.2,1628.74
16346,82263080,2023-02-12,133.67,1762.41
16347,82263080,2023-02-13,-59.69,1702.72
16348,82283956,2023-01-31,,745.72
16349,82283956,2023-02-01,-158.92,586.8000000000001
16350,82283956,2023-02-02,58.23,645.0300000000001
16351,82283956,2023-02-03,-349.6,295.43
16352,82303710,2023-01-31,,619.98
16353,82303710,2023-02-03,102.85,722.83
16354,82303710,2023-02-10,112.61,835.44
16355,82303710,2023-02-14,208.0,1043.44
16356,82303710,2023-02-14,-91.7,951.74
16357,82303710,2023-02-14,-1674.0,-722.26
16358,82314789,2023-01-31,,735.77
16359,82314789,2023-02-01,53.09,788.86
16360,82314789,2023-02-04,-87.35,701.51
16361,82314789,2023-02-06,155.01,856.52
16362,82314789,2023-02-09,-1340.1,-483.5799999999999
16363,82314789,2023-02-13,-75.81,-559.3899999999999
16364,82424659,2023-01-31,,568.77
16365,82424659,2023-02-02,56.94,625.71
16366,82424659,2023-02-05,-186.17,439.53999999999996
16367,82424659,2023-02-09,140.61,580.15
16368,82424659,2023-02-09,-87.15,493.0
16369,82424659,2023-02-12,151.48,644.48
16370,82424659,2023-02-13,21.73,666.21
16371,82461559,2023-01-31,,652.26
16372,82461559,2023-02-03,-98.38,553.88
16373,82461559,2023-02-07,117.08,670.96
16374,82461559,2023-02-07,-117.08,553.88
16375,82461559,2023-02-08,85.07,638.95
16376,82461559,2023-02-09,-6.95,632.0
16377,82461559,2023-02-12,37.14,669.14
16378,82461559,2023-02-13,-167.76,501.38
16379,82461559,2023-02-14,-118.75,382.63
16380,82543932,2023-01-31,,279.1
16381,82543932,2023-02-03,-104.78,174.32000000000002
16382,82543932,2023-02-05,170.9,345.22
16383,82543932,2023-02-05,-167.18,178.04000000000002
16384,82543932,2023-02-10,-98.45,79.59000000000002
16385,82543932,2023-02-12,-187.21,-107.61999999999999
16386,82558079,2023-01-31,,381.22
16387,82558079,2023-02-02,106.05,487.27000000000004
16388,82558079,2023-02-07,-65.45,421.82000000000005
16389,82558079,2023-02-12,26.9,448.72
16390,82558079,2023-02-13,-54.59,394.13
16391,82558079,2023-02-13,-77.1,317.03000000000003
16392,82568859,2023-01-31,,32.21
16393,82568859,2023-02-03,432.2,464.40999999999997
16394,82568859,2023-02-03,37.0,501.40999999999997
16395,82568859,2023-02-05,87.66,589.0699999999999
16396,82568859,2023-02-06,-102.1,486.96999999999997
16397,82568859,2023-02-10,110.62,597.5899999999999
16398,82589836,2023-01-31,,648.06
16399,82589836,2023-02-02,-39.13,608.93
16400,82589836,2023-02-03,207.91,816.8399999999999
16401,82589836,2023-02-08,77.26,894.0999999999999
16402,82589836,2023-02-09,-146.02,748.0799999999999
16403,82589836,2023-02-13,-113.04,635.04
16404,82589836,2023-02-13,-137.63,497.4099999999999
16405,82696309,2023-01-31,,352.08
16406,82696309,2023-02-01,90.9,442.98
16407,82696309,2023-02-11,-114.97,328.01
16408,82696309,2023-02-13,-63.14,264.87
16409,82734145,2023-01-31,,278.57
16410,82734145,2023-02-02,185.74,464.31
16411,82734145,2023-02-07,124.86,589.17
16412,82734145,2023-02-09,-94.06,495.11
16413,82734145,2023-02-12,-85.04,410.07
16414,82734145,2023-02-13,650.5,1060.57
16415,82734145,2023-02-13,116.52,1177.09
16416,82734145,2023-02-13,85.84,1262.9299999999998
16417,82764940,2023-01-31,,876.37
16418,82764940,2023-02-01,42.34,918.71
16419,82764940,2023-02-02,1117.0,2035.71
16420,82764940,2023-02-02,-100.46,1935.25
16421,82764940,2023-02-10,-1580.9,354.3499999999999
16422,82764940,2023-02-12,153.05,507.3999999999999
16423,82764940,2023-02-12,127.13,634.53
16424,82764940,2023-02-14,182.1,816.6299999999999
16425,82776251,2023-01-31,,747.11
16426,82776251,2023-02-01,91.77,838.88
16427,82776251,2023-02-03,123.38,962.26
16428,82776251,2023-02-04,-1315.2,-352.94000000000005
16429,82776251,2023-02-11,202.15,-150.79000000000005
16430,82807528,2023-01-31,,117.15
16431,82807528,2023-02-02,128.03,245.18
16432,82807528,2023-02-02,-109.57,135.61
16433,82807528,2023-02-03,79.68,215.29000000000002
16434,82807528,2023-02-09,-18.91,196.38000000000002
16435,82807528,2023-02-13,-45.1,151.28000000000003
16436,82807528,2023-02-14,-71.88,79.40000000000002
16437,82807528,2023-02-14,-113.52,-34.119999999999976
16438,82879607,2023-01-31,,72.18
16439,82879607,2023-02-06,-171.29,-99.10999999999999
16440,82879607,2023-02-08,102.11,3.000000000000014
16441,82879607,2023-02-11,164.37,167.37
16442,82879607,2023-02-12,-109.8,57.57000000000001
16443,82879607,2023-02-13,75.81,133.38
16444,82879607,2023-02-14,-117.24,16.140000000000015
16445,82911152,2023-01-31,,564.11
16446,82911152,2023-02-02,109.06,673.1700000000001
16447,82911152,2023-02-02,-68.58,604.59
16448,82911152,2023-02-11,118.19,722.78
16449,82911152,2023-02-11,42.9,765.6800000000001
16450,82911152,2023-02-11,-1104.0,-338.31999999999994
16451,82911152,2023-02-13,-169.23,-507.54999999999995
16452,82911152,2023-02-14,-156.79,-664.3399999999999
16453,82920281,2023-01-31,,41.13
16454,82920281,2023-02-02,94.2,135.33
16455,82920281,2023-02-03,-1791.6,-1656.27
16456,82920281,2023-02-06,-543.9,-2200.17
16457,82920281,2023-02-10,114.72,-2085.45
16458,82927034,2023-01-31,,435.71
16459,82927034,2023-02-03,-131.87,303.84
16460,82927034,2023-02-04,63.83,367.66999999999996
16461,82927034,2023-02-08,-66.93,300.73999999999995
16462,82927034,2023-02-09,86.0,386.73999999999995
16463,82927034,2023-02-11,-116.46,270.28
16464,82927034,2023-02-14,99.21,369.48999999999995
16465,82930132,2023-01-31,,131.87
16466,82930132,2023-02-03,192.08,323.95000000000005
16467,82930132,2023-02-03,175.68,499.63
16468,82930132,2023-02-04,69.05,568.6800000000001
16469,82930132,2023-02-05,119.88,688.5600000000001
16470,82930132,2023-02-06,-105.81,582.75
16471,82930132,2023-02-11,-137.86,444.89
16472,82930132,2023-02-12,0.94,445.83
16473,83003822,2023-01-31,,286.54
16474,83003822,2023-02-03,-143.42,143.12000000000003
16475,83003822,2023-02-10,-1430.6,-1287.4799999999998
16476,83003822,2023-02-11,-99.93,-1387.4099999999999
16477,83056011,2023-01-31,,968.4
16478,83056011,2023-02-03,129.38,1097.78
16479,83056011,2023-02-08,168.14,1265.92
16480,83056011,2023-02-11,-66.39,1199.53
16481,83067540,2023-01-31,,258.33
16482,83067540,2023-02-03,-37.0,221.32999999999998
16483,83067540,2023-02-03,-111.0,110.32999999999998
16484,83067540,2023-02-06,944.2,1054.53
16485,83067540,2023-02-11,133.67,1188.2
16486,83081615,2023-01-31,,301.32
16487,83081615,2023-02-02,141.97,443.28999999999996
16488,83081615,2023-02-04,41.77,485.06
16489,83081615,2023-02-05,113.82,598.88
16490,83081615,2023-02-07,139.96,738.84
16491,83081615,2023-02-11,67.03,805.87
16492,83124388,2023-01-31,,504.59
16493,83124388,2023-02-02,101.47,606.06
16494,83124388,2023-02-03,94.07,700.13
16495,83124388,2023-02-04,97.81,797.9399999999999
16496,83124388,2023-02-09,-46.08,751.86
16497,83124388,2023-02-09,-64.47,687.39
16498,83124388,2023-02-14,-71.41,615.98
16499,83128181,2023-01-31,,816.12
16500,83128181,2023-02-01,-97.36,718.76
16501,83128181,2023-02-03,82.71,801.47
16502,83128181,2023-02-07,132.91,934.38
16503,83128181,2023-02-09,-1325.7,-391.32000000000005
16504,83128181,2023-02-12,-1681.9,-2073.2200000000003
16505,83128544,2023-01-31,,25.71
16506,83128544,2023-02-05,21.67,47.38
16507,83128544,2023-02-07,181.11,228.49
16508,83128544,2023-02-07,1.03,229.52
16509,83128544,2023-02-07,-153.16,76.36000000000001
16510,83128544,2023-02-08,-128.53,-52.16999999999999
16511,83128544,2023-02-13,-132.3,-184.47
16512,83128544,2023-02-14,85.67,-98.8
16513,83166098,2023-01-31,,827.81
16514,83166098,2023-02-01,-116.71,711.0999999999999
16515,83166098,2023-02-06,-135.81,575.29
16516,83166098,2023-02-07,99.87,675.16
16517,83166098,2023-02-07,-46.92,628.24
16518,83166098,2023-02-08,-170.98,457.26
16519,83166098,2023-02-10,989.8,1447.06
16520,83166098,2023-02-11,-110.56,1336.5
16521,83166098,2023-02-13,37.83,1374.33
16522,83166098,2023-02-13,-165.82,1208.51
16523,83187508,2023-01-31,,714.42
16524,83187508,2023-02-01,130.8,845.22
16525,83187508,2023-02-05,35.44,880.66
16526,83187508,2023-02-05,-85.78,794.88
16527,83187508,2023-02-06,106.03,900.91
16528,83187508,2023-02-06,90.78,991.6899999999999
16529,83187508,2023-02-08,-126.03,865.66
16530,83187508,2023-02-09,65.38,931.04
16531,83187508,2023-02-09,-122.79,808.25
16532,83187508,2023-02-10,1048.2,1856.45
16533,83187508,2023-02-11,-158.35,1698.1000000000001
16534,83187508,2023-02-13,1207.6,2905.7
16535,83187508,2023-02-14,-140.97,2764.73
16536,83191889,2023-01-31,,344.33
16537,83191889,2023-02-02,-91.54,252.78999999999996
16538,83191889,2023-02-02,-101.15,151.64
16539,83191889,2023-02-02,-115.12,36.51999999999997
16540,83191889,2023-02-04,398.1,434.62
16541,83191889,2023-02-10,90.73,525.35
16542,83191889,2023-02-10,-88.72,436.63
16543,83191889,2023-02-12,170.43,607.06
16544,83191889,2023-02-13,128.78,735.84
16545,83202693,2023-01-31,,165.41
16546,83202693,2023-02-02,85.17,250.57999999999998
16547,83202693,2023-02-03,-195.91,54.670000000000016
16548,83202693,2023-02-07,-336.2,-281.53
16549,83202693,2023-02-09,129.57,-151.95999999999998
16550,83202693,2023-02-11,93.53,-58.42999999999998
16551,83202693,2023-02-13,-33.04,-91.46999999999997
16552,83281565,2023-01-31,,968.83
16553,83281565,2023-02-06,68.88,1037.71
16554,83281565,2023-02-08,-23.79,1013.9200000000001
16555,83281565,2023-02-08,-126.11,887.8100000000001
16556,83281565,2023-02-08,-146.5,741.3100000000001
16557,83281565,2023-02-09,150.23,891.54
16558,83281565,2023-02-12,-174.92,716.62
16559,83281565,2023-02-13,106.97,823.59
16560,83281565,2023-02-14,124.76,948.35
16561,83302154,2023-01-31,,465.25
16562,83302154,2023-02-02,-110.35,354.9
16563,83302154,2023-02-03,-936.3,-581.4
16564,83302154,2023-02-04,598.4,17.0
16565,83302154,2023-02-04,72.97,89.97
16566,83302154,2023-02-06,-141.54,-51.56999999999999
16567,83302154,2023-02-10,206.87,155.3
16568,83302154,2023-02-13,-166.98,-11.679999999999978
16569,83443439,2023-01-31,,97.61
16570,83443439,2023-02-03,1218.0,1315.61
16571,83443439,2023-02-03,-4.02,1311.59
16572,83443439,2023-02-04,-95.13,1216.4599999999998
16573,83443439,2023-02-05,-103.0,1113.4599999999998
16574,83443439,2023-02-06,-55.3,1058.1599999999999
16575,83443439,2023-02-10,216.08,1274.24
16576,83443439,2023-02-10,117.1,1391.34
16577,83443439,2023-02-13,114.78,1506.12
16578,83475318,2023-01-31,,228.96
16579,83475318,2023-02-01,-95.83,133.13
16580,83475318,2023-02-12,79.07,212.2
16581,83475318,2023-02-14,-107.71,104.49000000000001
16582,83530155,2023-01-31,,638.57
16583,83530155,2023-02-02,-58.65,579.9200000000001
16584,83530155,2023-02-10,-136.31,443.61
16585,83530155,2023-02-12,-11.78,431.83000000000004
16586,83530155,2023-02-12,-1006.5,-574.67
16587,83530155,2023-02-13,80.6,-494.06999999999994
16588,83530541,2023-01-31,,630.6
16589,83530541,2023-02-07,33.35,663.95
16590,83530541,2023-02-08,-1316.4,-652.45
16591,83530541,2023-02-13,-97.98,-750.4300000000001
16592,83531401,2023-01-31,,445.24
16593,83531401,2023-02-09,-11.67,433.57
16594,83531401,2023-02-10,123.19,556.76
16595,83531401,2023-02-12,67.65,624.41
16596,83539050,2023-01-31,,172.33
16597,83539050,2023-02-09,64.03,236.36
16598,83539050,2023-02-09,-138.19,98.17000000000002
16599,83539050,2023-02-14,114.54,212.71000000000004
16600,83557419,2023-01-31,,374.69
16601,83557419,2023-02-03,-115.71,258.98
16602,83557419,2023-02-05,-98.9,160.07999999999998
16603,83557419,2023-02-13,194.21,354.29
16604,83565726,2023-01-31,,910.38
16605,83565726,2023-02-02,-90.49,819.89
16606,83565726,2023-02-02,-792.0,27.889999999999986
16607,83565726,2023-02-03,-68.43,-40.54000000000002
16608,83565726,2023-02-07,162.23,121.68999999999997
16609,83565726,2023-02-07,-87.52,34.16999999999997
16610,83565726,2023-02-11,954.4,988.5699999999999
16611,83565726,2023-02-12,119.09,1107.6599999999999
16612,83565726,2023-02-12,100.74,1208.3999999999999
16613,83565726,2023-02-13,-959.6,248.79999999999995
16614,83573848,2023-01-31,,818.5
16615,83573848,2023-02-01,-94.56,723.94
16616,83573848,2023-02-02,133.09,857.03
16617,83573848,2023-02-02,123.95,980.98
16618,83573848,2023-02-05,-170.9,810.0799999999999
16619,83573848,2023-02-09,193.78,1003.86
16620,83573848,2023-02-09,-125.67,878.1899999999999
16621,83573848,2023-02-10,83.89,962.0799999999999
16622,83639740,2023-01-31,,266.62
16623,83639740,2023-02-02,128.3,394.92
16624,83639740,2023-02-02,105.52,500.44
16625,83639740,2023-02-03,38.14,538.58
16626,83639740,2023-02-09,587.9,1126.48
16627,83639740,2023-02-11,200.58,1327.06
16628,83659554,2023-01-31,,548.94
16629,83659554,2023-02-08,1537.1,2086.04
16630,83659554,2023-02-12,60.3,2146.34
16631,83659554,2023-02-12,-144.19,2002.15
16632,83668302,2023-01-31,,686.96
16633,83668302,2023-02-03,-46.29,640.6700000000001
16634,83668302,2023-02-07,-11.37,629.3000000000001
16635,83668302,2023-02-12,36.33,665.63
16636,83668302,2023-02-12,-28.61,637.02
16637,83668302,2023-02-12,-209.98,427.0400000000001
16638,83672404,2023-01-31,,269.57
16639,83672404,2023-02-01,164.06,433.63
16640,83672404,2023-02-02,-131.02,302.61
16641,83672404,2023-02-04,-150.01,152.6
16642,83672404,2023-02-04,-614.0,-461.4
16643,83672404,2023-02-07,-111.08,-572.48
16644,83672404,2023-02-09,75.46,-497.02
16645,83672404,2023-02-09,55.42,-441.59999999999997
16646,83693383,2023-01-31,,138.05
16647,83693383,2023-02-02,-57.51,80.54000000000002
16648,83693383,2023-02-07,-38.04,42.500000000000014
16649,83693383,2023-02-07,-166.87,-124.36999999999999
16650,83693383,2023-02-07,-905.3,-1029.6699999999998
16651,83693383,2023-02-08,189.71,-839.9599999999999
16652,83693383,2023-02-10,67.01,-772.9499999999999
16653,83693383,2023-02-14,136.49,-636.4599999999999
16654,83693383,2023-02-14,64.89,-571.5699999999999
16655,83698413,2023-01-31,,223.67
16656,83698413,2023-02-07,113.6,337.27
16657,83698413,2023-02-09,-44.19,293.08
16658,83698413,2023-02-12,-100.01,193.07
16659,83698413,2023-02-13,141.46,334.53
16660,83698413,2023-02-13,-90.0,244.52999999999997
16661,83788130,2023-01-31,,833.68
16662,83788130,2023-02-01,-132.46,701.2199999999999
16663,83788130,2023-02-02,-76.14,625.0799999999999
16664,83788130,2023-02-03,-136.61,488.4699999999999
16665,83788130,2023-02-03,-196.73,291.7399999999999
16666,83788130,2023-02-06,-161.03,130.70999999999992
16667,83788130,2023-02-08,134.23,264.93999999999994
16668,83788130,2023-02-11,69.84,334.7799999999999
16669,83796561,2023-01-31,,410.08
16670,83796561,2023-02-01,-2239.3,-1829.2200000000003
16671,83796561,2023-02-03,-115.16,-1944.3800000000003
16672,83796561,2023-02-04,69.83,-1874.5500000000002
16673,83796561,2023-02-13,124.65,-1749.9000000000003
16674,83796561,2023-02-14,187.3,-1562.6000000000004
16675,83828891,2023-01-31,,780.59
16676,83828891,2023-02-05,40.41,821.0
16677,83828891,2023-02-05,-136.6,684.4000000000001
16678,83828891,2023-02-08,120.57,804.97
16679,83828891,2023-02-09,-51.97,753.0
16680,83828891,2023-02-12,84.03,837.03
16681,83828891,2023-02-13,116.37,953.4000000000001
16682,83828891,2023-02-14,68.67,1022.07
16683,83852014,2023-01-31,,830.02
16684,83852014,2023-02-01,103.4,933.42
16685,83852014,2023-02-04,57.49,990.91
16686,83852014,2023-02-04,-61.88,929.03
16687,83852014,2023-02-05,-82.33,846.7
16688,83852014,2023-02-06,154.07,1000.77
16689,83852014,2023-02-12,-84.13,916.64
16690,83852014,2023-02-14,37.22,953.86
16691,83854141,2023-01-31,,280.06
16692,83854141,2023-02-02,-126.94,153.12
16693,83854141,2023-02-04,-71.57,81.55000000000001
16694,83854141,2023-02-05,26.38,107.93
16695,83854141,2023-02-13,109.04,216.97000000000003
16696,83854141,2023-02-14,59.91,276.88
16697,83891783,2023-01-31,,158.08
16698,83891783,2023-02-01,-144.25,13.830000000000013
16699,83891783,2023-02-02,15.77,29.600000000000012
16700,83891783,2023-02-02,-128.31,-98.71
16701,83891783,2023-02-08,118.11,19.400000000000006
16702,83891783,2023-02-09,-123.62,-104.22
16703,83891783,2023-02-13,-760.4,-864.62
16704,83891783,2023-02-14,32.8,-831.82
16705,83975923,2023-01-31,,837.45
16706,83975923,2023-02-01,-156.79,680.6600000000001
16707,83975923,2023-02-06,-68.31,612.35
16708,83975923,2023-02-07,-12.66,599.69
16709,83975923,2023-02-12,-131.34,468.35
16710,83981442,2023-01-31,,89.35
16711,83981442,2023-02-02,133.34,222.69
16712,83981442,2023-02-02,93.56,316.25
16713,83981442,2023-02-06,-1138.4,-822.1500000000001
16714,83981442,2023-02-07,85.6,-736.5500000000001
16715,84070285,2023-01-31,,796.6
16716,84070285,2023-02-02,-936.1,-139.5
16717,84070285,2023-02-04,-32.62,-172.12
16718,84070285,2023-02-06,160.17,-11.950000000000017
16719,84070285,2023-02-08,117.53,105.57999999999998
16720,84070285,2023-02-12,1128.7,1234.28
16721,84070285,2023-02-12,-128.19,1106.09
16722,84070285,2023-02-13,82.37,1188.46
16723,84070285,2023-02-13,75.77,1264.23
16724,84070285,2023-02-13,-69.55,1194.68
16725,84107088,2023-01-31,,2.2
16726,84107088,2023-02-04,116.65,118.85000000000001
16727,84107088,2023-02-05,105.33,224.18
16728,84107088,2023-02-05,-65.92,158.26
16729,84107088,2023-02-07,-591.2,-432.94000000000005
16730,84107088,2023-02-09,-35.02,-467.96000000000004
16731,84107088,2023-02-09,-78.03,-545.99
16732,84187157,2023-01-31,,252.9
16733,84187157,2023-02-04,-125.07,127.83000000000001
16734,84187157,2023-02-05,184.86,312.69000000000005
16735,84187157,2023-02-07,106.8,419.49
16736,84187157,2023-02-09,-96.36,323.13
16737,84187157,2023-02-14,1485.7,1808.83
16738,84187157,2023-02-14,-178.46,1630.3700000000001
16739,84188877,2023-01-31,,624.29
16740,84188877,2023-02-03,104.82,729.1099999999999
16741,84188877,2023-02-04,-58.55,670.56
16742,84188877,2023-02-05,-183.91,486.65
16743,84188877,2023-02-06,92.7,579.35
16744,84188877,2023-02-06,-110.83,468.52
16745,84188877,2023-02-09,-56.12,412.4
16746,84188877,2023-02-09,-67.84,344.55999999999995
16747,84188877,2023-02-10,-1800.7,-1456.14
16748,84188877,2023-02-11,102.13,-1354.0100000000002
16749,84188877,2023-02-11,-1273.1,-2627.11
16750,84188877,2023-02-12,183.73,-2443.38
16751,84275961,2023-01-31,,625.24
16752,84275961,2023-02-01,138.19,763.4300000000001
16753,84275961,2023-02-03,110.96,874.39
16754,84275961,2023-02-03,98.41,972.8
16755,84275961,2023-02-07,-79.84,892.96
16756,84275961,2023-02-09,7.96,900.92
16757,84275961,2023-02-10,-182.75,718.17
16758,84280969,2023-01-31,,161.7
16759,84280969,2023-02-02,92.47,254.17
16760,84280969,2023-02-09,103.44,357.61
16761,84280969,2023-02-10,-75.83,281.78
16762,84280969,2023-02-12,-92.56,189.21999999999997
16763,84280969,2023-02-12,-119.08,70.13999999999999
16764,84290934,2023-01-31,,914.5
16765,84290934,2023-02-05,-81.8,832.7
16766,84290934,2023-02-06,-67.41,765.29
16767,84290934,2023-02-06,-107.8,657.49
16768,84290934,2023-02-07,-71.52,585.97
16769,84290934,2023-02-09,185.1,771.0699999999999
16770,84295462,2023-01-31,,154.03
16771,84295462,2023-02-01,913.5,1067.53
16772,84295462,2023-02-10,136.73,1204.26
16773,84295462,2023-02-10,89.47,1293.73
16774,84295462,2023-02-11,128.07,1421.8
16775,84295462,2023-02-12,-49.41,1372.3899999999999
16776,84310867,2023-01-31,,258.66
16777,84310867,2023-02-01,65.12,323.78000000000003
16778,84310867,2023-02-10,-144.29,179.49000000000004
16779,84310867,2023-02-11,104.35,283.84000000000003
16780,84310867,2023-02-12,893.8,1177.6399999999999
16781,84310867,2023-02-12,70.46,1248.1
16782,84310867,2023-02-14,-1295.6,-47.5
16783,84333228,2023-01-31,,330.99
16784,84333228,2023-02-02,190.92,521.91
16785,84333228,2023-02-02,-75.84,446.07
16786,84333228,2023-02-03,114.6,560.67
16787,84333228,2023-02-05,-96.05,464.62
16788,84333228,2023-02-05,-118.78,345.84
16789,84333228,2023-02-11,84.08,429.91999999999996
16790,84334262,2023-01-31,,525.57
16791,84334262,2023-02-02,93.94,619.51
16792,84334262,2023-02-04,-110.05,509.46000000000004
16793,84334262,2023-02-06,133.3,642.76
16794,84334262,2023-02-11,409.8,1052.56
16795,84334262,2023-02-11,105.66,1158.22
16796,84334262,2023-02-12,-207.6,950.6200000000001
16797,84334262,2023-02-13,104.24,1054.8600000000001
16798,84334262,2023-02-14,-201.83,853.03
16799,84366763,2023-01-31,,734.48
16800,84366763,2023-02-02,-110.43,624.05
16801,84366763,2023-02-05,76.24,700.29
16802,84366763,2023-02-06,-470.6,229.69
16803,84366763,2023-02-11,107.54,337.23
16804,84366763,2023-02-11,74.51,411.74
16805,84366763,2023-02-11,-1012.8,-601.06
16806,84375036,2023-01-31,,356.1
16807,84375036,2023-02-01,114.22,470.32000000000005
16808,84375036,2023-02-07,115.15,585.47
16809,84375036,2023-02-07,-313.5,271.97
16810,84375036,2023-02-08,155.15,427.12
16811,84375036,2023-02-11,69.64,496.76000000000005
16812,84375036,2023-02-11,-130.89,365.87000000000006
16813,84375036,2023-02-13,510.4,876.27
16814,84396180,2023-01-31,,103.83
16815,84396180,2023-02-04,54.15,157.98
16816,84396180,2023-02-08,-130.54,27.439999999999998
16817,84396180,2023-02-10,100.43,127.87
16818,84396180,2023-02-10,-964.8,-836.93
16819,84396180,2023-02-11,31.4,-805.53
16820,84396180,2023-02-13,156.37,-649.16
16821,84406205,2023-01-31,,818.63
16822,84406205,2023-02-05,46.34,864.97
16823,84406205,2023-02-08,94.34,959.31
16824,84406205,2023-02-13,-1827.6,-868.29
16825,84406205,2023-02-14,-72.94,-941.23
16826,84411377,2023-01-31,,870.25
16827,84411377,2023-02-07,112.51,982.76
16828,84411377,2023-02-12,-351.6,631.16
16829,84411377,2023-02-13,139.83,770.99
16830,84411930,2023-01-31,,916.61
16831,84411930,2023-02-04,-58.05,858.5600000000001
16832,84411930,2023-02-05,-36.77,821.79
16833,84411930,2023-02-05,-95.84,725.95
16834,84411930,2023-02-06,-52.31,673.64
16835,84411930,2023-02-07,-56.32,617.32
16836,84411930,2023-02-12,163.83,781.1500000000001
16837,84416510,2023-01-31,,793.45
16838,84416510,2023-02-02,-31.64,761.8100000000001
16839,84416510,2023-02-02,-88.86,672.95
16840,84416510,2023-02-09,84.55,757.5
16841,84416510,2023-02-11,954.4,1711.9
16842,84416510,2023-02-12,124.59,1836.49
16843,84416510,2023-02-13,72.94,1909.43
16844,84416510,2023-02-14,-404.9,1504.53
16845,84418749,2023-01-31,,457.27
16846,84418749,2023-02-01,200.4,657.67
16847,84418749,2023-02-01,-78.47,579.2
16848,84418749,2023-02-02,46.77,625.97
16849,84418749,2023-02-08,-109.06,516.91
16850,84418749,2023-02-09,116.81,633.72
16851,84418749,2023-02-12,21.61,655.33
16852,84418749,2023-02-13,93.39,748.72
16853,84448752,2023-01-31,,412.15
16854,84448752,2023-02-06,1409.6,1821.75
16855,84448752,2023-02-06,88.91,1910.66
16856,84448752,2023-02-08,1368.6,3279.26
16857,84448752,2023-02-08,-1253.6,2025.66
16858,84471701,2023-01-31,,89.27
16859,84471701,2023-02-01,62.0,151.26999999999998
16860,84471701,2023-02-02,97.37,248.64
16861,84471701,2023-02-05,-55.81,192.82999999999998
16862,84471701,2023-02-08,77.23,270.06
16863,84656105,2023-01-31,,547.59
16864,84656105,2023-02-03,-56.77,490.82000000000005
16865,84656105,2023-02-06,1457.8,1948.62
16866,84656105,2023-02-06,109.51,2058.13
16867,84656105,2023-02-07,100.78,2158.9100000000003
16868,84656105,2023-02-08,189.28,2348.19
16869,84656105,2023-02-13,-105.18,2243.01
16870,84682032,2023-01-31,,612.1
16871,84682032,2023-02-03,-3.5,608.6
16872,84682032,2023-02-09,-149.44,459.16
16873,84682032,2023-02-14,-79.89,379.27000000000004
16874,84682032,2023-02-14,-123.85,255.42000000000002
16875,84695068,2023-01-31,,693.94
16876,84695068,2023-02-09,-74.41,619.5300000000001
16877,84695068,2023-02-10,34.71,654.24
16878,84695068,2023-02-12,1764.4,2418.6400000000003
16879,84695068,2023-02-13,-9.8,2408.84
16880,84714323,2023-01-31,,667.61
16881,84714323,2023-02-03,-43.31,624.3
16882,84714323,2023-02-04,1268.7,1893.0
16883,84746166,2023-01-31,,806.73
16884,84746166,2023-02-03,20.43,827.16
16885,84746166,2023-02-04,24.15,851.3100000000001
16886,84746166,2023-02-05,-59.8,791.51
16887,84746166,2023-02-08,-157.06,634.45
16888,84746166,2023-02-09,-1202.9,-568.45
16889,84746166,2023-02-11,-32.0,-600.45
16890,84746166,2023-02-13,-124.65,-725.1
16891,84746166,2023-02-14,-98.03,-823.1300000000001
16892,84778718,2023-01-31,,521.14
16893,84778718,2023-02-03,37.49,558.63
16894,84778718,2023-02-05,101.46,660.0899999999999
16895,84778718,2023-02-09,133.43,793.52
16896,84778718,2023-02-11,-78.25,715.27
16897,84778718,2023-02-12,1183.8,1899.07
16898,84778718,2023-02-13,70.58,1969.6499999999999
16899,84822607,2023-01-31,,425.79
16900,84822607,2023-02-02,-93.16,332.63
16901,84822607,2023-02-03,65.15,397.78000000000003
16902,84822607,2023-02-07,77.96,475.74
16903,84822607,2023-02-07,-209.73,266.01000000000005
16904,84822607,2023-02-08,134.18,400.19000000000005
16905,84822607,2023-02-10,90.33,490.52000000000004
16906,84853260,2023-01-31,,925.31
16907,84853260,2023-02-07,-74.75,850.56
16908,84853260,2023-02-09,-72.3,778.26
16909,84853260,2023-02-13,128.84,907.0999999999999
16910,84853260,2023-02-14,142.57,1049.67
16911,84928531,2023-01-31,,236.36
16912,84928531,2023-02-01,-75.09,161.27
16913,84928531,2023-02-04,186.01,347.28
16914,84928531,2023-02-06,138.32,485.6
16915,84928531,2023-02-06,-87.2,398.4
16916,84928531,2023-02-09,-69.41,328.99
16917,84951477,2023-01-31,,316.2
16918,84951477,2023-02-02,-68.17,248.02999999999997
16919,84951477,2023-02-03,39.9,287.93
16920,84951477,2023-02-06,144.68,432.61
16921,84951477,2023-02-10,174.71,607.3199999999999
16922,84951477,2023-02-10,141.06,748.38
16923,84951477,2023-02-10,-551.6,196.77999999999997
16924,84951477,2023-02-13,-61.34,135.43999999999997
16925,84964879,2023-01-31,,629.81
16926,84964879,2023-02-01,106.68,736.49
16927,84964879,2023-02-03,15.12,751.6099999999999
16928,84964879,2023-02-05,45.42,797.03
16929,84964879,2023-02-07,1653.3,2450.33
16930,84964879,2023-02-08,-113.98,2336.35
16931,84964879,2023-02-11,-59.1,2277.25
16932,84969883,2023-01-31,,672.74
16933,84969883,2023-02-02,-128.13,544.61
16934,84969883,2023-02-03,-1179.0,-634.39
16935,84969883,2023-02-05,139.34,-495.04999999999995
16936,84969883,2023-02-12,845.0,349.95000000000005
16937,84969883,2023-02-13,57.17,407.12000000000006
16938,84969883,2023-02-14,-117.34,289.78000000000003
16939,84969883,2023-02-14,-707.3,-417.5199999999999
16940,84995019,2023-01-31,,731.41
16941,84995019,2023-02-01,-89.01,642.4
16942,84995019,2023-02-01,-126.06,516.3399999999999
16943,84995019,2023-02-02,-118.32,398.02
16944,84995019,2023-02-03,195.63,593.65
16945,84995019,2023-02-03,64.43,658.0799999999999
16946,84995019,2023-02-04,482.7,1140.78
16947,84995019,2023-02-04,133.46,1274.24
16948,84995019,2023-02-04,85.5,1359.74
16949,84995019,2023-02-04,-64.93,1294.81
16950,84995019,2023-02-05,146.21,1441.02
16951,84995019,2023-02-10,148.09,1589.11
16952,84995019,2023-02-11,-69.11,1520.0
16953,84995019,2023-02-14,58.59,1578.59
16954,85001424,2023-01-31,,653.31
16955,85001424,2023-02-01,-103.68,549.6299999999999
16956,85001424,2023-02-06,-82.51,467.11999999999995
16957,85001424,2023-02-09,-126.2,340.91999999999996
16958,85001424,2023-02-11,149.84,490.75999999999993
16959,85001424,2023-02-11,-107.51,383.24999999999994
16960,85001424,2023-02-14,94.55,477.79999999999995
16961,85001424,2023-02-14,44.4,522.1999999999999
16962,85057916,2023-01-31,,656.89
16963,85057916,2023-02-03,18.28,675.17
16964,85057916,2023-02-05,74.52,749.6899999999999
16965,85057916,2023-02-09,26.26,775.9499999999999
16966,85057916,2023-02-10,150.39,926.3399999999999
16967,85057916,2023-02-10,76.06,1002.4
16968,85057916,2023-02-10,-167.69,834.71
16969,85128569,2023-01-31,,340.68
16970,85128569,2023-02-03,114.58,455.26
16971,85128569,2023-02-07,-65.37,389.89
16972,85128569,2023-02-11,-105.27,284.62
16973,85128569,2023-02-14,-122.97,161.65
16974,85140734,2023-01-31,,699.57
16975,85140734,2023-02-01,205.89,905.46
16976,85140734,2023-02-01,131.36,1036.8200000000002
16977,85140734,2023-02-02,70.63,1107.45
16978,85140734,2023-02-03,-79.37,1028.08
16979,85140734,2023-02-04,77.13,1105.21
16980,85140734,2023-02-08,-2113.3,-1008.0900000000001
16981,85140734,2023-02-12,71.65,-936.4400000000002
16982,85140734,2023-02-12,-143.0,-1079.44
16983,85156953,2023-01-31,,900.09
16984,85156953,2023-02-02,-16.74,883.35
16985,85156953,2023-02-03,81.73,965.08
16986,85156953,2023-02-05,103.29,1068.3700000000001
16987,85156953,2023-02-10,168.19,1236.56
16988,85156953,2023-02-12,-93.42,1143.14
16989,85156953,2023-02-13,68.93,1212.0700000000002
16990,85156953,2023-02-14,2134.6,3346.67
16991,85177718,2023-01-31,,478.18
16992,85177718,2023-02-03,513.3,991.48
16993,85177718,2023-02-05,-131.36,860.12
16994,85177718,2023-02-14,125.03,985.15
16995,85182642,2023-01-31,,451.38
16996,85182642,2023-02-07,-108.09,343.28999999999996
16997,85182642,2023-02-08,-96.42,246.87
16998,85182642,2023-02-11,99.35,346.21999999999997
16999,85192761,2023-01-31,,982.48
17000,85192761,2023-02-04,95.76,1078.24
17001,85192761,2023-02-05,-1922.5,-844.26
17002,85192761,2023-02-08,52.45,-791.81
17003,85192761,2023-02-12,151.09,-640.72
17004,85238291,2023-01-31,,665.68
17005,85238291,2023-02-01,-142.98,522.6999999999999
17006,85238291,2023-02-02,-28.99,493.71
17007,85238291,2023-02-02,-645.8,-152.08999999999997
17008,85238291,2023-02-05,-94.84,-246.92999999999998
17009,85238291,2023-02-07,163.8,-83.12999999999997
17010,85238291,2023-02-08,197.96,114.83000000000004
17011,85238291,2023-02-13,115.9,230.73000000000005
17012,85250129,2023-01-31,,400.91
17013,85250129,2023-02-01,-119.21,281.70000000000005
17014,85250129,2023-02-02,77.14,358.84000000000003
17015,85250129,2023-02-06,-87.33,271.51000000000005
17016,85250129,2023-02-08,952.0,1223.51
17017,85250129,2023-02-08,-118.76,1104.75
17018,85250129,2023-02-10,-135.21,969.54
17019,85250129,2023-02-12,-56.37,913.17
17020,85265080,2023-01-31,,992.6
17021,85265080,2023-02-01,-78.22,914.38
17022,85265080,2023-02-01,-126.36,788.02
17023,85265080,2023-02-12,-1111.4,-323.3800000000001
17024,85310930,2023-01-31,,688.91
17025,85310930,2023-02-07,108.09,797.0
17026,85310930,2023-02-09,121.5,918.5
17027,85310930,2023-02-11,-81.42,837.0799999999999
17028,85336547,2023-01-31,,785.57
17029,85336547,2023-02-03,120.76,906.33
17030,85336547,2023-02-08,-83.2,823.1300000000001
17031,85336547,2023-02-10,222.4,1045.53
17032,85341369,2023-01-31,,932.11
17033,85341369,2023-02-01,146.39,1078.5
17034,85341369,2023-02-02,-149.36,929.14
17035,85341369,2023-02-02,-187.4,741.74
17036,85341369,2023-02-05,36.56,778.3
17037,85341369,2023-02-06,178.4,956.7
17038,85341369,2023-02-06,-34.38,922.3199999999999
17039,85341369,2023-02-09,67.84,990.16
17040,85341369,2023-02-11,28.34,1018.5
17041,85341369,2023-02-13,137.63,1156.13
17042,85344981,2023-01-31,,874.46
17043,85344981,2023-02-05,-85.08,789.38
17044,85344981,2023-02-06,1024.2,1813.58
17045,85344981,2023-02-08,203.1,2016.68
17046,85344981,2023-02-09,121.16,2137.84
17047,85344981,2023-02-11,120.98,2258.82
17048,85344981,2023-02-12,-1128.7,1130.1200000000001
17049,85344981,2023-02-13,105.71,1235.8300000000002
17050,85344981,2023-02-14,64.22,1300.0500000000002
17051,85362253,2023-01-31,,790.41
17052,85362253,2023-02-01,-63.28,727.13
17053,85362253,2023-02-03,-178.54,548.5899999999999
17054,85362253,2023-02-04,-61.06,487.53
17055,85362253,2023-02-07,78.85,566.38
17056,85362253,2023-02-08,92.43,658.81
17057,85362253,2023-02-12,-76.86,581.9499999999999
17058,85362253,2023-02-14,544.0,1125.9499999999998
17059,85399459,2023-01-31,,705.94
17060,85399459,2023-02-02,-89.7,616.24
17061,85399459,2023-02-07,-169.12,447.12000000000006
17062,85399459,2023-02-10,37.83,484.95000000000005
17063,85399459,2023-02-11,-1037.0,-552.05
17064,85399459,2023-02-13,-89.1,-641.15
17065,85420056,2023-01-31,,107.03
17066,85420056,2023-02-04,26.76,133.79
17067,85420056,2023-02-08,-120.11,13.680000000000007
17068,85420056,2023-02-09,94.81,108.49000000000001
17069,85420056,2023-02-11,177.1,285.59000000000003
17070,85420056,2023-02-13,48.77,334.36
17071,85423742,2023-01-31,,131.14
17072,85423742,2023-02-02,84.91,216.04999999999998
17073,85423742,2023-02-09,106.29,322.34
17074,85423742,2023-02-11,858.7,1181.04
17075,85423742,2023-02-11,11.69,1192.73
17076,85423742,2023-02-12,122.62,1315.35
17077,85423742,2023-02-12,-79.07,1236.28
17078,85423742,2023-02-14,-87.55,1148.73
17079,85435135,2023-01-31,,106.63
17080,85435135,2023-02-02,-72.58,34.05
17081,85435135,2023-02-03,127.62,161.67000000000002
17082,85435135,2023-02-03,56.77,218.44
17083,85435135,2023-02-03,-90.48,127.96000000000001
17084,85435135,2023-02-07,127.93,255.89000000000001
17085,85435135,2023-02-11,141.75,397.64
17086,85435135,2023-02-11,110.28,507.92
17087,85435135,2023-02-12,-178.37,329.55
17088,85435135,2023-02-13,126.46,456.01
17089,85482194,2023-01-31,,997.62
17090,85482194,2023-02-03,160.1,1157.72
17091,85482194,2023-02-05,114.53,1272.25
17092,85482194,2023-02-07,145.86,1418.1100000000001
17093,85482194,2023-02-08,141.86,1559.97
17094,85482194,2023-02-08,45.23,1605.2
17095,85482194,2023-02-09,-1216.6,388.60000000000014
17096,85482194,2023-02-11,33.64,422.2400000000001
17097,85482194,2023-02-11,-137.43,284.8100000000001
17098,85490561,2023-01-31,,512.78
17099,85490561,2023-02-03,119.2,631.98
17100,85490561,2023-02-03,-140.5,491.47999999999996
17101,85490561,2023-02-07,75.08,566.56
17102,85490561,2023-02-08,190.37,756.93
17103,85490561,2023-02-09,-97.54,659.39
17104,85490561,2023-02-09,-205.74,453.6499999999999
17105,85490561,2023-02-13,-86.25,367.3999999999999
17106,85493851,2023-01-31,,796.35
17107,85493851,2023-02-05,-121.03,675.32
17108,85493851,2023-02-06,1.46,676.78
17109,85493851,2023-02-08,96.95,773.73
17110,85493851,2023-02-09,-134.75,638.98
17111,85493851,2023-02-09,-142.59,496.39
17112,85493851,2023-02-14,93.61,590.0
17113,85496714,2023-01-31,,353.13
17114,85496714,2023-02-03,-129.19,223.94
17115,85496714,2023-02-04,-91.41,132.53
17116,85496714,2023-02-04,-117.79,14.739999999999995
17117,85496714,2023-02-06,60.39,75.13
17118,85496714,2023-02-08,-153.79,-78.66
17119,85496714,2023-02-09,63.04,-15.619999999999997
17120,85496714,2023-02-10,-116.54,-132.16
17121,85496714,2023-02-11,110.56,-21.60000000000001
17122,85496714,2023-02-12,1314.3,1292.7
17123,85496714,2023-02-12,69.85,1362.55
17124,85496714,2023-02-13,99.37,1461.92
17125,85496714,2023-02-13,32.94,1494.8600000000001
17126,85498335,2023-01-31,,745.08
17127,85498335,2023-02-04,-80.51,664.57
17128,85498335,2023-02-07,84.97,749.5400000000001
17129,85498335,2023-02-09,149.64,899.1800000000001
17130,85498335,2023-02-09,122.79,1021.97
17131,85498936,2023-01-31,,47.77
17132,85498936,2023-02-03,-1935.5,-1887.73
17133,85498936,2023-02-09,158.52,-1729.21
17134,85498936,2023-02-10,39.45,-1689.76
17135,85498936,2023-02-13,0.58,-1689.18
17136,85501046,2023-01-31,,354.76
17137,85501046,2023-02-01,-152.04,202.72
17138,85501046,2023-02-05,158.24,360.96000000000004
17139,85501046,2023-02-08,-57.32,303.64
17140,85503501,2023-01-31,,13.66
17141,85503501,2023-02-01,53.46,67.12
17142,85503501,2023-02-04,-148.08,-80.96000000000001
17143,85503501,2023-02-05,186.17,105.20999999999998
17144,85503501,2023-02-05,-55.52,49.689999999999976
17145,85503501,2023-02-06,394.5,444.19
17146,85503501,2023-02-08,178.49,622.6800000000001
17147,85503501,2023-02-09,190.68,813.36
17148,85503501,2023-02-13,59.04,872.4
17149,85551186,2023-01-31,,909.25
17150,85551186,2023-02-07,102.52,1011.77
17151,85551186,2023-02-07,-1198.9,-187.1300000000001
17152,85551186,2023-02-09,99.59,-87.5400000000001
17153,85559926,2023-01-31,,423.28
17154,85559926,2023-02-01,-125.68,297.59999999999997
17155,85559926,2023-02-06,16.67,314.27
17156,85559926,2023-02-07,-56.13,258.14
17157,85559926,2023-02-09,1727.8,1985.94
17158,85559926,2023-02-10,89.09,2075.0299999999997
17159,85559926,2023-02-10,71.14,2146.1699999999996
17160,85559926,2023-02-11,50.07,2196.24
17161,85559926,2023-02-12,1071.4,3267.64
17162,85559926,2023-02-12,-177.52,3090.12
17163,85562851,2023-01-31,,499.37
17164,85562851,2023-02-02,-144.51,354.86
17165,85562851,2023-02-03,-141.05,213.81
17166,85562851,2023-02-07,119.25,333.06
17167,85562851,2023-02-07,-226.83,106.22999999999999
17168,85562851,2023-02-08,-19.11,87.11999999999999
17169,85562851,2023-02-08,-186.34,-99.22000000000001
17170,85562851,2023-02-09,158.25,59.02999999999999
17171,85562851,2023-02-12,-66.67,-7.640000000000015
17172,85609963,2023-01-31,,424.83
17173,85609963,2023-02-04,189.72,614.55
17174,85609963,2023-02-05,142.79,757.3399999999999
17175,85609963,2023-02-10,156.22,913.56
17176,85652943,2023-01-31,,424.5
17177,85652943,2023-02-02,-95.52,328.98
17178,85652943,2023-02-03,110.59,439.57
17179,85652943,2023-02-03,-854.4,-414.83
17180,85652943,2023-02-09,121.95,-292.88
17181,85679194,2023-01-31,,891.99
17182,85679194,2023-02-06,104.32,996.31
17183,85679194,2023-02-07,-185.02,811.29
17184,85679194,2023-02-09,79.45,890.74
17185,85679194,2023-02-10,31.28,922.02
17186,85679194,2023-02-13,38.26,960.28
17187,85709972,2023-01-31,,936.57
17188,85709972,2023-02-05,45.1,981.6700000000001
17189,85709972,2023-02-11,173.7,1155.3700000000001
17190,85723355,2023-01-31,,745.34
17191,85723355,2023-02-05,-6.72,738.62
17192,85723355,2023-02-08,-187.24,551.38
17193,85723355,2023-02-12,112.23,663.61
17194,85723355,2023-02-13,-30.37,633.24
17195,85723355,2023-02-14,-1773.6,-1140.36
17196,85724829,2023-01-31,,189.94
17197,85724829,2023-02-02,49.63,239.57
17198,85724829,2023-02-02,-2.63,236.94
17199,85724829,2023-02-03,-23.5,213.44
17200,85724829,2023-02-08,108.96,322.4
17201,85724829,2023-02-08,-122.81,199.58999999999997
17202,85724829,2023-02-10,148.63,348.21999999999997
17203,85724829,2023-02-10,141.46,489.67999999999995
17204,85724829,2023-02-10,-74.15,415.53
17205,85724829,2023-02-11,185.47,601.0
17206,85724829,2023-02-13,39.15,640.15
17207,85771346,2023-01-31,,458.88
17208,85771346,2023-02-07,-201.7,257.18
17209,85771346,2023-02-08,-570.9,-313.71999999999997
17210,85826354,2023-01-31,,611.74
17211,85826354,2023-02-02,-80.3,531.44
17212,85826354,2023-02-03,52.49,583.9300000000001
17213,85826354,2023-02-05,100.81,684.74
17214,85826354,2023-02-13,64.85,749.59
17215,85826354,2023-02-13,-44.38,705.21
17216,85839285,2023-01-31,,728.06
17217,85839285,2023-02-01,637.1,1365.1599999999999
17218,85839285,2023-02-03,-136.43,1228.73
17219,85839285,2023-02-06,104.85,1333.58
17220,85839285,2023-02-07,124.7,1458.28
17221,85839285,2023-02-09,-65.77,1392.51
17222,85839285,2023-02-10,-193.12,1199.3899999999999
17223,85839285,2023-02-13,-68.86,1130.53
17224,85841767,2023-01-31,,458.43
17225,85841767,2023-02-01,-111.89,346.54
17226,85841767,2023-02-03,90.58,437.12
17227,85841767,2023-02-04,14.63,451.75
17228,85841767,2023-02-04,-90.44,361.31
17229,85841767,2023-02-06,-110.66,250.65
17230,85841767,2023-02-08,-70.92,179.73000000000002
17231,85841767,2023-02-08,-134.88,44.85000000000002
17232,85841767,2023-02-10,-168.64,-123.78999999999996
17233,85841767,2023-02-13,-216.37,-340.15999999999997
17234,85841767,2023-02-14,-37.74,-377.9
17235,85846175,2023-01-31,,22.88
17236,85846175,2023-02-03,56.99,79.87
17237,85846175,2023-02-04,112.13,192.0
17238,85846175,2023-02-04,-117.97,74.03
17239,85846175,2023-02-07,15.66,89.69
17240,85846175,2023-02-08,-113.65,-23.960000000000008
17241,85846175,2023-02-09,-101.26,-125.22000000000001
17242,85846175,2023-02-11,197.9,72.67999999999999
17243,85846175,2023-02-11,114.34,187.01999999999998
17244,85846175,2023-02-12,115.87,302.89
17245,85846175,2023-02-14,164.38,467.27
17246,85848442,2023-01-31,,118.46
17247,85848442,2023-02-02,-141.97,-23.510000000000005
17248,85848442,2023-02-07,301.0,277.49
17249,85848442,2023-02-07,-118.92,158.57
17250,85848442,2023-02-08,-103.57,55.000000000000014
17251,85848442,2023-02-08,-1537.1,-1482.1
17252,85848442,2023-02-10,87.35,-1394.75
17253,85848442,2023-02-10,74.72,-1320.03
17254,85848442,2023-02-10,-168.35,-1488.3799999999999
17255,85848442,2023-02-11,-45.67,-1534.05
17256,85848442,2023-02-11,-77.54,-1611.59
17257,85874418,2023-01-31,,151.83
17258,85874418,2023-02-01,-151.41,0.4200000000000159
17259,85874418,2023-02-02,110.52,110.94000000000001
17260,85874418,2023-02-02,-33.06,77.88000000000001
17261,85874418,2023-02-03,113.54,191.42000000000002
17262,85874418,2023-02-03,-247.64,-56.21999999999997
17263,85874418,2023-02-06,111.97,55.75000000000003
17264,85874418,2023-02-08,-1805.6,-1749.85
17265,85874418,2023-02-12,-61.36,-1811.2099999999998
17266,85902834,2023-01-31,,357.94
17267,85902834,2023-02-02,88.86,446.8
17268,85902834,2023-02-03,23.24,470.04
17269,85902834,2023-02-06,178.37,648.41
17270,85902834,2023-02-06,-107.61,540.8
17271,85902834,2023-02-07,-127.93,412.87
17272,85902834,2023-02-08,-120.35,292.52
17273,85902834,2023-02-10,-160.72,131.8
17274,85902834,2023-02-11,138.48,270.28
17275,85902834,2023-02-13,731.4,1001.68
17276,85902834,2023-02-13,-83.84,917.8399999999999
17277,85919813,2023-01-31,,647.36
17278,85919813,2023-02-01,106.8,754.16
17279,85919813,2023-02-07,-171.45,582.71
17280,85919813,2023-02-09,-77.66,505.05000000000007
17281,85919813,2023-02-12,-81.83,423.22
17282,85924719,2023-01-31,,472.05
17283,85924719,2023-02-08,1872.8,2344.85
17284,85924719,2023-02-09,-77.33,2267.52
17285,85924719,2023-02-11,1010.6,3278.12
17286,85939269,2023-01-31,,223.1
17287,85939269,2023-02-01,-121.91,101.19
17288,85939269,2023-02-02,534.5,635.69
17289,85939269,2023-02-05,-181.23,454.46000000000004
17290,85939269,2023-02-06,-151.33,303.13000000000005
17291,85939269,2023-02-10,-174.71,128.42000000000004
17292,85939269,2023-02-13,154.15,282.57000000000005
17293,85939269,2023-02-13,-121.3,161.27000000000004
17294,85940057,2023-01-31,,521.37
17295,85940057,2023-02-01,1069.7,1591.0700000000002
17296,85940057,2023-02-04,-100.53,1490.54
17297,85940057,2023-02-05,49.85,1540.3899999999999
17298,85940057,2023-02-05,-1136.4,403.9899999999998
17299,85940057,2023-02-12,-110.14,293.8499999999998
17300,85940057,2023-02-12,-989.2,-695.3500000000003
17301,85951663,2023-01-31,,385.0
17302,85951663,2023-02-01,99.45,484.45
17303,85951663,2023-02-02,233.36,717.81
17304,85951663,2023-02-02,184.29,902.1
17305,85951663,2023-02-02,-133.67,768.4300000000001
17306,85951663,2023-02-03,-122.22,646.21
17307,85951663,2023-02-04,255.0,901.21
17308,85951663,2023-02-08,-105.97,795.24
17309,85951663,2023-02-08,-215.14,580.1
17310,85951663,2023-02-14,-125.03,455.07000000000005
17311,85994636,2023-01-31,,819.24
17312,85994636,2023-02-01,-114.04,705.2
17313,85994636,2023-02-02,-104.79,600.41
17314,85994636,2023-02-04,1361.0,1961.4099999999999
17315,85994636,2023-02-04,-1410.9,550.5099999999998
17316,85994636,2023-02-08,65.85,616.3599999999998
17317,85994636,2023-02-09,-96.08,520.2799999999997
17318,85994636,2023-02-12,123.24,643.5199999999998
17319,85994636,2023-02-12,63.33,706.8499999999998
17320,85994636,2023-02-13,104.7,811.5499999999997
17321,86007729,2023-01-31,,320.78
17322,86007729,2023-02-05,97.55,418.33
17323,86007729,2023-02-10,-29.52,388.80999999999995
17324,86007729,2023-02-12,111.6,500.40999999999997
17325,86007729,2023-02-13,72.81,573.22
17326,86020532,2023-01-31,,972.95
17327,86020532,2023-02-05,-95.98,876.97
17328,86020532,2023-02-11,120.19,997.1600000000001
17329,86020532,2023-02-12,44.97,1042.13
17330,86020532,2023-02-13,-56.91,985.22
17331,86031592,2023-01-31,,637.42
17332,86031592,2023-02-01,124.24,761.66
17333,86031592,2023-02-01,-135.0,626.66
17334,86031592,2023-02-02,180.16,806.8199999999999
17335,86031592,2023-02-02,51.28,858.0999999999999
17336,86031592,2023-02-03,70.8,928.9
17337,86031592,2023-02-03,-56.89,872.01
17338,86031592,2023-02-04,-398.1,473.90999999999997
17339,86031592,2023-02-05,78.96,552.87
17340,86031592,2023-02-10,144.29,697.16
17341,86031592,2023-02-11,-331.8,365.35999999999996
17342,86031592,2023-02-13,86.51,451.86999999999995
17343,86053438,2023-01-31,,303.06
17344,86053438,2023-02-01,1152.9,1455.96
17345,86053438,2023-02-02,116.0,1571.96
17346,86053438,2023-02-04,-150.45,1421.51
17347,86053438,2023-02-10,-42.14,1379.3700000000001
17348,86053438,2023-02-13,147.5,1526.8700000000001
17349,86053438,2023-02-13,77.52,1604.39
17350,86068003,2023-01-31,,567.14
17351,86068003,2023-02-03,3.24,570.38
17352,86068003,2023-02-03,-129.77,440.61
17353,86068003,2023-02-06,63.7,504.31
17354,86068003,2023-02-07,79.99,584.3
17355,86068003,2023-02-08,-693.4,-109.10000000000002
17356,86068003,2023-02-11,-42.95,-152.05
17357,86068003,2023-02-11,-56.7,-208.75000000000003
17358,86068003,2023-02-12,84.03,-124.72000000000003
17359,86068003,2023-02-14,2620.1,2495.38
17360,86086812,2023-01-31,,832.82
17361,86086812,2023-02-02,-106.61,726.21
17362,86086812,2023-02-13,-105.74,620.47
17363,86092750,2023-01-31,,261.57
17364,86092750,2023-02-03,952.0,1213.57
17365,86092750,2023-02-08,-91.53,1122.04
17366,86092750,2023-02-09,155.22,1277.26
17367,86092750,2023-02-10,-80.91,1196.35
17368,86106528,2023-01-31,,238.55
17369,86106528,2023-02-02,120.72,359.27
17370,86106528,2023-02-06,11.94,371.21000000000004
17371,86108287,2023-01-31,,523.61
17372,86108287,2023-02-05,61.25,584.86
17373,86108287,2023-02-08,167.35,752.21
17374,86108287,2023-02-10,-86.14,666.07
17375,86108287,2023-02-10,-1210.3,-544.2299999999999
17376,86108287,2023-02-11,40.3,-503.9299999999999
17377,86131065,2023-01-31,,920.08
17378,86131065,2023-02-05,-114.02,806.0600000000001
17379,86131065,2023-02-07,26.33,832.3900000000001
17380,86131065,2023-02-08,154.2,986.59
17381,86131065,2023-02-09,-73.98,912.61
17382,86155528,2023-01-31,,772.38
17383,86155528,2023-02-01,81.56,853.94
17384,86155528,2023-02-06,161.12,1015.06
17385,86155528,2023-02-08,-63.8,951.26
17386,86155528,2023-02-09,-107.63,843.63
17387,86155528,2023-02-13,33.04,876.67
17388,86169883,2023-01-31,,452.25
17389,86169883,2023-02-06,-52.84,399.40999999999997
17390,86169883,2023-02-07,98.66,498.07
17391,86169883,2023-02-08,-165.79,332.28
17392,86169883,2023-02-12,-151.06,181.22
17393,86169883,2023-02-12,-164.03,17.189999999999998
17394,86169883,2023-02-12,-191.61,-174.42000000000002
17395,86169883,2023-02-13,-57.17,-231.59000000000003
17396,86169883,2023-02-14,69.79,-161.8
17397,86169883,2023-02-14,-143.83,-305.63
17398,86190489,2023-01-31,,237.72
17399,86190489,2023-02-03,-108.09,129.63
17400,86190489,2023-02-05,860.7,990.33
17401,86190489,2023-02-07,-182.27,808.0600000000001
17402,86190489,2023-02-07,-184.29,623.77
17403,86190489,2023-02-13,-89.42,534.35
17404,86190489,2023-02-13,-136.67,397.68000000000006
17405,86190489,2023-02-14,191.09,588.7700000000001
17406,86207903,2023-01-31,,911.44
17407,86207903,2023-02-01,-41.18,870.2600000000001
17408,86207903,2023-02-01,-131.27,738.99
17409,86207903,2023-02-05,-97.55,641.44
17410,86207903,2023-02-06,1085.4,1726.8400000000001
17411,86207903,2023-02-06,-54.71,1672.13
17412,86207903,2023-02-07,-189.62,1482.5100000000002
17413,86207903,2023-02-10,-108.81,1373.7
17414,86207903,2023-02-11,-1035.1,338.60000000000014
17415,86207903,2023-02-12,-92.53,246.07000000000014
17416,86218347,2023-01-31,,481.16
17417,86218347,2023-02-01,165.66,646.82
17418,86218347,2023-02-07,1581.8,2228.62
17419,86218347,2023-02-07,-80.47,2148.15
17420,86218347,2023-02-09,-52.73,2095.42
17421,86218347,2023-02-10,146.12,2241.54
17422,86218347,2023-02-10,-1463.6,777.9400000000003
17423,86218347,2023-02-11,100.23,878.1700000000003
17424,86218347,2023-02-14,156.02,1034.1900000000003
17425,86228741,2023-01-31,,562.04
17426,86228741,2023-02-06,-114.11,447.92999999999995
17427,86228741,2023-02-10,-139.65,308.28
17428,86228741,2023-02-13,156.49,464.77
17429,86263956,2023-01-31,,852.67
17430,86263956,2023-02-10,-80.77,771.9
17431,86263956,2023-02-12,-111.68,660.2199999999999
17432,86266595,2023-01-31,,539.96
17433,86266595,2023-02-01,-156.73,383.23
17434,86266595,2023-02-02,115.05,498.28000000000003
17435,86266595,2023-02-05,357.9,856.1800000000001
17436,86266595,2023-02-05,-159.3,696.88
17437,86266595,2023-02-09,-8.38,688.5
17438,86266595,2023-02-09,-47.07,641.43
17439,86266595,2023-02-10,122.66,764.09
17440,86266595,2023-02-11,-60.37,703.72
17441,86266595,2023-02-13,-100.05,603.67
17442,86266595,2023-02-14,-36.2,567.47
17443,86268635,2023-01-31,,679.32
17444,86268635,2023-02-02,77.54,756.86
17445,86268635,2023-02-03,84.12,840.98
17446,86268635,2023-02-04,152.48,993.46
17447,86272488,2023-01-31,,11.73
17448,86272488,2023-02-01,-90.79,-79.06
17449,86272488,2023-02-03,13.61,-65.45
17450,86272488,2023-02-03,-156.35,-221.8
17451,86272488,2023-02-05,144.1,-77.69999999999999
17452,86272488,2023-02-14,88.35,10.650000000000006
17453,86297017,2023-01-31,,803.81
17454,86297017,2023-02-01,103.04,906.8499999999999
17455,86297017,2023-02-03,-80.26,826.5899999999999
17456,86297017,2023-02-04,-67.91,758.68
17457,86297017,2023-02-10,715.5,1474.1799999999998
17458,86297017,2023-02-11,531.4,2005.58
17459,86297017,2023-02-13,-89.3,1916.28
17460,86339581,2023-01-31,,91.76
17461,86339581,2023-02-02,126.16,217.92000000000002
17462,86339581,2023-02-03,48.23,266.15
17463,86339581,2023-02-04,-47.33,218.82
17464,86339581,2023-02-06,-246.82,-28.0
17465,86339581,2023-02-07,-108.09,-136.09
17466,86339581,2023-02-08,166.36,30.27000000000001
17467,86339581,2023-02-10,-74.6,-44.329999999999984
17468,86339581,2023-02-11,133.59,89.26000000000002
17469,86339581,2023-02-11,-1107.1,-1017.8399999999999
17470,86339899,2023-01-31,,460.69
17471,86339899,2023-02-01,615.8,1076.49
17472,86339899,2023-02-01,-601.7,474.78999999999996
17473,86339899,2023-02-03,171.99,646.78
17474,86339899,2023-02-04,-127.8,518.98
17475,86339899,2023-02-06,1792.7,2311.6800000000003
17476,86339899,2023-02-06,-138.32,2173.36
17477,86339899,2023-02-07,71.01,2244.37
17478,86339899,2023-02-10,80.58,2324.9500000000003
17479,86339899,2023-02-10,-64.28,2260.67
17480,86339899,2023-02-11,-114.84,2145.83
17481,86406958,2023-01-31,,842.43
17482,86406958,2023-02-02,-27.69,814.7399999999999
17483,86406958,2023-02-06,-687.1,127.63999999999987
17484,86406958,2023-02-10,34.99,162.62999999999988
17485,86406958,2023-02-13,93.14,255.76999999999987
17486,86406958,2023-02-14,68.7,324.46999999999986
17487,86406958,2023-02-14,66.88,391.34999999999985
17488,86439949,2023-01-31,,782.42
17489,86439949,2023-02-02,66.42,848.8399999999999
17490,86439949,2023-02-02,12.87,861.7099999999999
17491,86439949,2023-02-03,-27.88,833.8299999999999
17492,86439949,2023-02-03,-56.99,776.8399999999999
17493,86439949,2023-02-05,-109.7,667.14
17494,86439949,2023-02-09,-735.1,-67.96000000000004
17495,86489618,2023-01-31,,488.7
17496,86489618,2023-02-03,-5.31,483.39
17497,86489618,2023-02-06,37.9,521.29
17498,86489618,2023-02-09,166.16,687.45
17499,86489618,2023-02-13,2.0,689.45
17500,86496446,2023-01-31,,124.84
17501,86496446,2023-02-01,-85.61,39.230000000000004
17502,86496446,2023-02-07,137.51,176.74
17503,86496446,2023-02-08,138.31,315.05
17504,86496446,2023-02-11,151.17,466.22
17505,86496446,2023-02-14,95.87,562.09
17506,86530050,2023-01-31,,447.17
17507,86530050,2023-02-01,103.16,550.33
17508,86530050,2023-02-03,-90.66,459.67
17509,86530050,2023-02-04,-128.26,331.41
17510,86530050,2023-02-07,-169.25,162.16000000000003
17511,86530050,2023-02-09,138.85,301.01
17512,86530050,2023-02-09,31.87,332.88
17513,86530050,2023-02-09,-57.36,275.52000000000004
17514,86530050,2023-02-09,-102.35,173.17000000000002
17515,86530050,2023-02-14,158.33,331.50000000000006
17516,86530050,2023-02-14,30.74,362.24000000000007
17517,86530050,2023-02-14,-119.1,243.14000000000004
17518,86596620,2023-01-31,,512.69
17519,86596620,2023-02-04,42.74,555.4300000000001
17520,86596620,2023-02-07,-24.34,531.09
17521,86596620,2023-02-10,-70.43,460.6600000000001
17522,86596620,2023-02-11,84.35,545.01
17523,86596620,2023-02-12,-142.86,402.15000000000003
17524,86624158,2023-01-31,,818.29
17525,86624158,2023-02-04,-124.23,694.06
17526,86624158,2023-02-05,97.55,791.6099999999999
17527,86624158,2023-02-07,169.03,960.64
17528,86624158,2023-02-08,-101.89,858.75
17529,86624158,2023-02-09,56.03,914.78
17530,86624158,2023-02-10,-94.45,820.3299999999999
17531,86624158,2023-02-11,179.27,999.5999999999999
17532,86624158,2023-02-11,126.42,1126.02
17533,86637863,2023-01-31,,672.86
17534,86637863,2023-02-03,105.11,777.97
17535,86637863,2023-02-04,155.63,933.6
17536,86637863,2023-02-05,-78.36,855.24
17537,86637863,2023-02-06,-27.56,827.6800000000001
17538,86637863,2023-02-08,87.73,915.4100000000001
17539,86637863,2023-02-12,-91.23,824.1800000000001
17540,86655008,2023-01-31,,671.72
17541,86655008,2023-02-01,84.07,755.79
17542,86655008,2023-02-01,-52.9,702.89
17543,86655008,2023-02-03,-198.29,504.6
17544,86655008,2023-02-04,-900.7,-396.1
17545,86655008,2023-02-09,98.31,-297.79
17546,86655008,2023-02-09,-66.83,-364.62
17547,86655008,2023-02-13,-142.99,-507.61
17548,86655008,2023-02-14,115.38,-392.23
17549,86698396,2023-01-31,,314.21
17550,86698396,2023-02-03,113.68,427.89
17551,86728138,2023-01-31,,175.36
17552,86728138,2023-02-04,-214.78,-39.41999999999999
17553,86728138,2023-02-07,162.23,122.81
17554,86728138,2023-02-07,-113.6,9.210000000000008
17555,86728138,2023-02-08,-157.76,-148.54999999999998
17556,86737119,2023-01-31,,432.69
17557,86737119,2023-02-04,244.13,676.8199999999999
17558,86737119,2023-02-04,-158.98,517.84
17559,86737119,2023-02-05,-772.5,-254.65999999999997
17560,86737119,2023-02-06,-193.27,-447.92999999999995
17561,86737119,2023-02-07,197.12,-250.80999999999997
17562,86737119,2023-02-07,123.68,-127.12999999999997
17563,86737119,2023-02-07,76.84,-50.289999999999964
17564,86737119,2023-02-07,-152.63,-202.91999999999996
17565,86737119,2023-02-09,176.56,-26.359999999999957
17566,86737119,2023-02-13,148.57,122.21000000000004
17567,86737119,2023-02-14,73.77,195.98000000000002
17568,86765156,2023-01-31,,290.53
17569,86765156,2023-02-02,118.87,409.4
17570,86765156,2023-02-05,-65.68,343.71999999999997
17571,86765156,2023-02-09,176.29,520.01
17572,86765156,2023-02-09,97.79,617.8
17573,86785126,2023-01-31,,148.21
17574,86785126,2023-02-02,-225.34,-77.13
17575,86785126,2023-02-03,104.95,27.820000000000007
17576,86785126,2023-02-04,-103.81,-75.99
17577,86785126,2023-02-05,-80.83,-156.82
17578,86785126,2023-02-07,147.04,-9.780000000000001
17579,86785126,2023-02-11,-47.98,-57.76
17580,86785126,2023-02-14,643.9,586.14
17581,86785126,2023-02-14,-412.8,173.33999999999997
17582,86788651,2023-01-31,,593.38
17583,86788651,2023-02-01,218.14,811.52
17584,86788651,2023-02-01,152.04,963.56
17585,86788651,2023-02-04,-85.5,878.06
17586,86788651,2023-02-07,-101.07,776.99
17587,86788651,2023-02-07,-283.4,493.59000000000003
17588,86788651,2023-02-13,128.76,622.35
17589,86788651,2023-02-14,-90.79,531.5600000000001
17590,86788651,2023-02-14,-162.35,369.21000000000004
17591,86795912,2023-01-31,,295.95
17592,86795912,2023-02-05,-119.75,176.2
17593,86795912,2023-02-08,-98.0,78.19999999999999
17594,86795912,2023-02-09,132.48,210.67999999999998
17595,86795912,2023-02-12,-877.5,-666.82
17596,86795912,2023-02-14,170.78,-496.0400000000001
17597,86816054,2023-01-31,,391.59
17598,86816054,2023-02-03,109.86,501.45
17599,86816054,2023-02-06,-83.26,418.18999999999994
17600,86816054,2023-02-07,-1255.9,-837.7100000000002
17601,86816054,2023-02-09,164.72,-672.9900000000001
17602,86816054,2023-02-09,69.0,-603.9900000000001
17603,86816054,2023-02-12,80.44,-523.5500000000002
17604,86864320,2023-01-31,,611.14
17605,86864320,2023-02-01,-103.58,507.56
17606,86864320,2023-02-05,183.42,690.98
17607,86864320,2023-02-06,138.14,829.1199999999999
17608,86864320,2023-02-06,-63.43,765.6899999999999
17609,86864320,2023-02-13,99.8,865.49
17610,86864320,2023-02-14,126.71,992.1999999999999
17611,86870860,2023-01-31,,987.14
17612,86870860,2023-02-02,130.93,1118.07
17613,86870860,2023-02-02,-1556.9,-438.83000000000015
17614,86870860,2023-02-05,-146.29,-585.1200000000001
17615,86870860,2023-02-06,-187.58,-772.7000000000002
17616,86870860,2023-02-07,78.9,-693.8000000000002
17617,86870860,2023-02-10,-98.63,-792.4300000000002
17618,86870860,2023-02-12,228.38,-564.0500000000002
17619,86870860,2023-02-13,-133.35,-697.4000000000001
17620,86870860,2023-02-14,-131.53,-828.9300000000002
17621,86893452,2023-01-31,,641.84
17622,86893452,2023-02-01,108.17,750.01
17623,86893452,2023-02-01,-1152.9,-402.8900000000001
17624,86893452,2023-02-04,-46.13,-449.0200000000001
17625,86893452,2023-02-06,119.58,-329.4400000000001
17626,86893452,2023-02-07,152.63,-176.81000000000012
17627,86893452,2023-02-08,92.25,-84.56000000000012
17628,86893452,2023-02-09,-96.28,-180.84000000000012
17629,86893452,2023-02-10,79.77,-101.07000000000012
17630,86893452,2023-02-10,-46.29,-147.36000000000013
17631,86893452,2023-02-12,-94.03,-241.39000000000013
17632,86893452,2023-02-14,-124.48,-365.8700000000001
17633,86941058,2023-01-31,,337.99
17634,86941058,2023-02-01,466.7,804.69
17635,86941058,2023-02-01,150.96,955.65
17636,86941058,2023-02-01,148.96,1104.6100000000001
17637,86941058,2023-02-01,-92.85,1011.76
17638,86941058,2023-02-03,-21.03,990.73
17639,86941058,2023-02-05,1233.7,2224.4300000000003
17640,86941058,2023-02-07,110.05,2334.48
17641,86941058,2023-02-07,-53.6,2280.88
17642,86941058,2023-02-07,-64.02,2216.86
17643,86941058,2023-02-08,-1800.8,416.0600000000002
17644,86941058,2023-02-09,105.33,521.3900000000002
17645,86941058,2023-02-09,-85.04,436.35000000000014
17646,86941058,2023-02-09,-102.59,333.76000000000016
17647,86941058,2023-02-11,173.15,506.9100000000002
17648,86941058,2023-02-13,159.64,666.5500000000002
17649,86941058,2023-02-14,505.6,1172.15
17650,86941058,2023-02-14,-148.07,1024.0800000000002
17651,86995846,2023-01-31,,956.26
17652,86995846,2023-02-04,-50.69,905.5699999999999
17653,86995846,2023-02-06,132.29,1037.86
17654,86995846,2023-02-07,96.08,1133.94
17655,86995846,2023-02-09,45.7,1179.6399999999999
17656,86995846,2023-02-09,-88.73,1090.91
17657,86995846,2023-02-10,-126.15,964.76
17658,87010556,2023-01-31,,175.33
17659,87010556,2023-02-03,41.04,216.37
17660,87010556,2023-02-07,112.22,328.59000000000003
17661,87010556,2023-02-07,105.53,434.12
17662,87010556,2023-02-11,90.36,524.48
17663,87010556,2023-02-12,99.56,624.04
17664,87010556,2023-02-13,-0.58,623.46
17665,87101816,2023-01-31,,862.87
17666,87101816,2023-02-01,-150.96,711.91
17667,87101816,2023-02-04,-567.7,144.20999999999992
17668,87101816,2023-02-07,164.85,309.05999999999995
17669,87101816,2023-02-08,7.94,316.99999999999994
17670,87101816,2023-02-10,182.87,499.8699999999999
17671,87101816,2023-02-11,77.75,577.6199999999999
17672,87101816,2023-02-14,-81.74,495.87999999999994
17673,87101816,2023-02-14,-99.95,395.92999999999995
17674,87121270,2023-01-31,,122.09
17675,87121270,2023-02-04,-86.9,35.19
17676,87121270,2023-02-04,-94.72,-59.53
17677,87121270,2023-02-08,-175.97,-235.5
17678,87121270,2023-02-12,-109.65,-345.15
17679,87133080,2023-01-31,,947.42
17680,87133080,2023-02-05,-197.22,750.1999999999999
17681,87133080,2023-02-07,-1151.1,-400.9
17682,87133080,2023-02-08,-85.98,-486.88
17683,87133080,2023-02-10,127.34,-359.53999999999996
17684,87133080,2023-02-14,-67.47,-427.01
17685,87171530,2023-01-31,,705.41
17686,87171530,2023-02-01,-102.91,602.5
17687,87171530,2023-02-03,107.8,710.3
17688,87171530,2023-02-05,-55.38,654.92
17689,87171530,2023-02-06,21.12,676.04
17690,87171530,2023-02-06,-784.3,-108.25999999999999
17691,87171530,2023-02-10,112.36,4.1000000000000085
17692,87171530,2023-02-10,-39.48,-35.37999999999999
17693,87171530,2023-02-11,182.68,147.3
17694,87171530,2023-02-13,-36.43,110.87
17695,87171530,2023-02-14,-113.78,-2.9099999999999966
17696,87179572,2023-01-31,,527.23
17697,87179572,2023-02-01,1292.5,1819.73
17698,87179572,2023-02-02,-107.47,1712.26
17699,87179572,2023-02-03,74.5,1786.76
17700,87179572,2023-02-04,185.63,1972.39
17701,87179572,2023-02-05,-69.93,1902.46
17702,87179572,2023-02-07,-43.28,1859.18
17703,87179572,2023-02-07,-109.43,1749.75
17704,87179572,2023-02-13,223.88,1973.63
17705,87179572,2023-02-13,91.43,2065.06
17706,87195449,2023-01-31,,493.58
17707,87195449,2023-02-09,126.81,620.39
17708,87195449,2023-02-10,110.9,731.29
17709,87195449,2023-02-13,-445.8,285.49
17710,87231063,2023-01-31,,305.69
17711,87231063,2023-02-04,83.95,389.64
17712,87231063,2023-02-07,-96.86,292.78
17713,87261089,2023-01-31,,613.62
17714,87261089,2023-02-13,152.6,766.22
17715,87261106,2023-01-31,,203.16
17716,87261106,2023-02-06,-57.88,145.28
17717,87261106,2023-02-08,-24.94,120.33999999999999
17718,87261106,2023-02-09,187.78,308.12
17719,87261106,2023-02-09,-55.42,252.7
17720,87261106,2023-02-09,-126.81,125.88999999999997
17721,87261106,2023-02-11,-149.28,-23.39000000000003
17722,87261106,2023-02-13,-18.04,-41.43000000000003
17723,87276000,2023-01-31,,826.21
17724,87276000,2023-02-01,179.6,1005.8100000000001
17725,87276000,2023-02-01,119.88,1125.69
17726,87276000,2023-02-05,-74.37,1051.32
17727,87276000,2023-02-09,46.3,1097.6200000000001
17728,87276000,2023-02-10,-40.2,1057.42
17729,87276000,2023-02-13,90.4,1147.82
17730,87297577,2023-01-31,,351.06
17731,87297577,2023-02-03,109.74,460.8
17732,87297577,2023-02-03,-101.75,359.05
17733,87297577,2023-02-04,-155.57,203.48000000000002
17734,87297577,2023-02-05,117.54,321.02000000000004
17735,87297577,2023-02-14,-49.4,271.62
17736,87325576,2023-01-31,,354.27
17737,87325576,2023-02-01,-185.45,168.82
17738,87325576,2023-02-03,134.13,302.95
17739,87325576,2023-02-07,-79.32,223.63
17740,87325576,2023-02-10,-196.24,27.389999999999986
17741,87325576,2023-02-11,116.37,143.76
17742,87325576,2023-02-13,2.26,146.01999999999998
17743,87356428,2023-01-31,,705.05
17744,87356428,2023-02-06,42.19,747.24
17745,87356428,2023-02-08,79.16,826.4
17746,87356428,2023-02-10,213.8,1040.2
17747,87356428,2023-02-10,101.74,1141.94
17748,87373821,2023-01-31,,945.0
17749,87373821,2023-02-01,-69.91,875.09
17750,87373821,2023-02-01,-163.82,711.27
17751,87373821,2023-02-03,27.88,739.15
17752,87373821,2023-02-06,999.1,1738.25
17753,87373821,2023-02-07,-54.28,1683.97
17754,87373821,2023-02-08,133.65,1817.62
17755,87373821,2023-02-08,-111.05,1706.57
17756,87373821,2023-02-14,175.48,1882.05
17757,87433733,2023-01-31,,34.77
17758,87433733,2023-02-02,104.72,139.49
17759,87433733,2023-02-02,-139.25,0.2400000000000091
17760,87433733,2023-02-05,-71.17,-70.92999999999999
17761,87433733,2023-02-06,-83.76,-154.69
17762,87433733,2023-02-08,-158.67,-313.36
17763,87433733,2023-02-09,239.1,-74.25999999999999
17764,87433733,2023-02-12,-139.75,-214.01
17765,87433733,2023-02-13,-159.64,-373.65
17766,87456121,2023-01-31,,257.5
17767,87456121,2023-02-01,76.69,334.19
17768,87456121,2023-02-06,-29.95,304.24
17769,87456121,2023-02-09,-58.71,245.53
17770,87456121,2023-02-09,-82.14,163.39
17771,87456121,2023-02-10,62.31,225.7
17772,87456121,2023-02-11,51.18,276.88
17773,87504607,2023-01-31,,605.63
17774,87504607,2023-02-01,86.21,691.84
17775,87504607,2023-02-03,91.97,783.81
17776,87504607,2023-02-11,142.53,926.3399999999999
17777,87504607,2023-02-11,-83.49,842.85
17778,87504607,2023-02-13,162.05,1004.9
17779,87533652,2023-01-31,,156.61
17780,87533652,2023-02-03,22.57,179.18
17781,87533652,2023-02-06,-176.4,2.780000000000001
17782,87533652,2023-02-07,199.97,202.75
17783,87533652,2023-02-07,-67.88,134.87
17784,87533652,2023-02-10,153.19,288.06
17785,87533652,2023-02-14,81.26,369.32
17786,87543952,2023-01-31,,14.85
17787,87543952,2023-02-07,-93.88,-79.03
17788,87543952,2023-02-08,77.04,-1.9899999999999949
17789,87543952,2023-02-09,125.94,123.95
17790,87543952,2023-02-11,112.24,236.19
17791,87556975,2023-01-31,,657.17
17792,87556975,2023-02-02,-57.04,600.13
17793,87556975,2023-02-05,-200.2,399.92999999999995
17794,87556975,2023-02-06,-173.27,226.65999999999997
17795,87556975,2023-02-07,1372.5,1599.1599999999999
17796,87556975,2023-02-13,99.78,1698.9399999999998
17797,87556975,2023-02-14,1469.3,3168.24
17798,87726203,2023-01-31,,55.92
17799,87726203,2023-02-06,152.16,208.07999999999998
17800,87726203,2023-02-07,-21.61,186.47000000000003
17801,87726203,2023-02-09,-124.33,62.140000000000015
17802,87726203,2023-02-10,-57.63,4.510000000000012
17803,87726203,2023-02-12,-28.57,-24.059999999999988
17804,87735660,2023-01-31,,990.25
17805,87735660,2023-02-03,28.0,1018.25
17806,87735660,2023-02-04,-82.87,935.38
17807,87735660,2023-02-11,-64.84,870.54
17808,87735660,2023-02-11,-138.99,731.55
17809,87735660,2023-02-12,101.83,833.38
17810,87735660,2023-02-13,152.92,986.3
17811,87735660,2023-02-13,79.81,1066.11
17812,87746071,2023-01-31,,215.91
17813,87746071,2023-02-01,-106.3,109.61
17814,87746071,2023-02-06,135.04,244.64999999999998
17815,87746071,2023-02-14,259.3,503.95000000000005
17816,87801896,2023-01-31,,181.56
17817,87801896,2023-02-03,1632.0,1813.56
17818,87801896,2023-02-05,118.55,1932.11
17819,87801896,2023-02-06,108.14,2040.25
17820,87801896,2023-02-12,-171.12,1869.1299999999999
17821,87807990,2023-01-31,,317.4
17822,87807990,2023-02-01,72.79,390.19
17823,87807990,2023-02-02,-97.47,292.71999999999997
17824,87807990,2023-02-04,957.5,1250.22
17825,87807990,2023-02-06,178.88,1429.1
17826,87807990,2023-02-08,57.32,1486.42
17827,87807990,2023-02-10,38.88,1525.3
17828,87817645,2023-01-31,,983.36
17829,87817645,2023-02-01,181.11,1164.47
17830,87817645,2023-02-03,-17.26,1147.21
17831,87817645,2023-02-04,64.93,1212.14
17832,87817645,2023-02-05,-114.48,1097.66
17833,87817645,2023-02-05,-141.51,956.1500000000001
17834,87817645,2023-02-06,-660.3,295.85000000000014
17835,87817645,2023-02-08,-103.89,191.96000000000015
17836,87817645,2023-02-09,-155.76,36.20000000000016
17837,87817645,2023-02-10,616.1,652.3000000000002
17838,87817645,2023-02-10,80.91,733.2100000000002
17839,87827496,2023-01-31,,935.66
17840,87827496,2023-02-02,-103.39,832.27
17841,87827496,2023-02-05,-107.8,724.47
17842,87827496,2023-02-13,72.65,797.12
17843,87836000,2023-01-31,,937.46
17844,87836000,2023-02-07,-115.15,822.3100000000001
17845,87836000,2023-02-13,-93.97,728.34
17846,87876065,2023-01-31,,627.15
17847,87876065,2023-02-01,1821.6,2448.75
17848,87876065,2023-02-01,123.29,2572.04
17849,87876065,2023-02-11,140.15,2712.19
17850,87876065,2023-02-11,-75.65,2636.54
17851,87876065,2023-02-12,-84.4,2552.14
17852,87876065,2023-02-14,-64.45,2487.69
17853,87906438,2023-01-31,,196.99
17854,87906438,2023-02-05,-144.67,52.32000000000002
17855,87906438,2023-02-07,0.83,53.15000000000002
17856,87906438,2023-02-09,136.48,189.63
17857,87906438,2023-02-10,174.95,364.58000000000004
17858,87906438,2023-02-10,40.2,404.78000000000003
17859,87906438,2023-02-10,-75.98,328.8
17860,87906438,2023-02-12,159.82,488.62
17861,87906438,2023-02-12,-99.99,388.63
17862,87911550,2023-01-31,,149.29
17863,87911550,2023-02-02,-91.54,57.749999999999986
17864,87911550,2023-02-04,74.75,132.5
17865,87911550,2023-02-11,-72.76,59.73999999999998
17866,87911550,2023-02-13,24.32,84.05999999999997
17867,87913244,2023-01-31,,730.48
17868,87913244,2023-02-01,136.95,867.4300000000001
17869,87913244,2023-02-02,-237.02,630.41
17870,87913244,2023-02-06,-123.31,507.1
17871,87913244,2023-02-08,104.55,611.65
17872,87913244,2023-02-08,-54.56,557.09
17873,87913244,2023-02-10,-210.07,347.02
17874,87913244,2023-02-11,-139.07,207.95
17875,87913244,2023-02-12,-131.58,76.36999999999998
17876,87967388,2023-01-31,,682.7
17877,87967388,2023-02-03,-114.6,568.1
17878,87967388,2023-02-05,135.04,703.1400000000001
17879,87967388,2023-02-05,77.0,780.1400000000001
17880,87967388,2023-02-10,932.3,1712.44
17881,87967388,2023-02-12,-882.7,829.74
17882,87967388,2023-02-13,1393.1,2222.84
17883,87967388,2023-02-13,89.23,2312.0699999999997
17884,87967388,2023-02-13,-2359.1,-47.0300000000002
17885,87967388,2023-02-14,-137.37,-184.4000000000002
17886,88033693,2023-01-31,,917.7
17887,88033693,2023-02-06,-114.15,803.5500000000001
17888,88033693,2023-02-07,19.21,822.76
17889,88033693,2023-02-07,-109.39,713.37
17890,88033693,2023-02-09,81.22,794.59
17891,88033693,2023-02-12,-19.56,775.0300000000001
17892,88040274,2023-01-31,,550.79
17893,88040274,2023-02-03,-89.14,461.65
17894,88040274,2023-02-05,158.27,619.92
17895,88040274,2023-02-06,1743.5,2363.42
17896,88040274,2023-02-14,76.31,2439.73
17897,88074391,2023-01-31,,851.54
17898,88074391,2023-02-02,-111.21,740.3299999999999
17899,88074391,2023-02-05,-127.52,612.81
17900,88074391,2023-02-06,115.19,728.0
17901,88074391,2023-02-09,-83.26,644.74
17902,88074391,2023-02-10,-121.44,523.3
17903,88106566,2023-01-31,,477.78
17904,88106566,2023-02-02,211.27,689.05
17905,88106566,2023-02-02,93.52,782.5699999999999
17906,88106566,2023-02-03,-221.11,561.46
17907,88106566,2023-02-05,12.23,573.6899999999999
17908,88106566,2023-02-09,140.26,713.9499999999999
17909,88106566,2023-02-14,-134.69,579.26
17910,88160468,2023-01-31,,640.07
17911,88160468,2023-02-01,-84.03,556.0400000000001
17912,88160468,2023-02-01,-1041.9,-485.86
17913,88160468,2023-02-04,127.8,-358.06
17914,88160468,2023-02-07,46.31,-311.75
17915,88160468,2023-02-08,-103.69,-415.44
17916,88160468,2023-02-09,142.59,-272.85
17917,88160468,2023-02-12,-143.47,-416.32000000000005
17918,88160468,2023-02-13,44.17,-372.15000000000003
17919,88160468,2023-02-14,-151.02,-523.1700000000001
17920,88229109,2023-01-31,,730.76
17921,88229109,2023-02-05,-65.1,665.66
17922,88229109,2023-02-10,182.81,848.47
17923,88229109,2023-02-12,140.82,989.29
17924,88229109,2023-02-12,76.6,1065.8899999999999
17925,88229109,2023-02-12,67.02,1132.91
17926,88229109,2023-02-14,115.32,1248.23
17927,88235115,2023-01-31,,150.58
17928,88235115,2023-02-02,-51.28,99.30000000000001
17929,88235115,2023-02-02,-137.17,-37.869999999999976
17930,88235115,2023-02-05,167.85,129.98000000000002
17931,88235115,2023-02-07,-74.11,55.87000000000002
17932,88235115,2023-02-08,89.97,145.84000000000003
17933,88235115,2023-02-08,-118.94,26.90000000000002
17934,88235115,2023-02-09,98.98,125.88000000000002
17935,88235115,2023-02-12,154.56,280.44000000000005
17936,88235115,2023-02-12,-797.7,-517.26
17937,88235115,2023-02-14,-643.9,-1161.1599999999999
17938,88285378,2023-01-31,,473.79
17939,88285378,2023-02-03,94.79,568.58
17940,88285378,2023-02-06,887.9,1456.48
17941,88285378,2023-02-08,180.39,1636.87
17942,88285378,2023-02-09,-230.97,1405.9
17943,88285378,2023-02-14,-104.53,1301.37
17944,88293767,2023-01-31,,487.22
17945,88293767,2023-02-04,-102.71,384.51000000000005
17946,88293767,2023-02-07,-82.79,301.72
17947,88293767,2023-02-09,-65.38,236.34000000000003
17948,88306714,2023-01-31,,808.0
17949,88306714,2023-02-08,36.71,844.71
17950,88306714,2023-02-13,-114.54,730.17
17951,88306714,2023-02-14,-112.72,617.45
17952,88343796,2023-01-31,,338.0
17953,88343796,2023-02-02,-224.12,113.88
17954,88343796,2023-02-08,-30.57,83.31
17955,88343796,2023-02-11,66.07,149.38
17956,88381437,2023-01-31,,472.65
17957,88381437,2023-02-04,-100.94,371.71
17958,88381437,2023-02-05,-65.54,306.16999999999996
17959,88381437,2023-02-05,-74.21,231.95999999999998
17960,88399132,2023-01-31,,751.13
17961,88399132,2023-02-02,56.02,807.15
17962,88399132,2023-02-03,-83.69,723.46
17963,88399132,2023-02-08,195.95,919.41
17964,88399132,2023-02-10,151.6,1071.01
17965,88399132,2023-02-10,69.69,1140.7
17966,88399132,2023-02-11,32.0,1172.7
17967,88399132,2023-02-14,-159.09,1013.61
17968,88436283,2023-01-31,,689.71
17969,88436283,2023-02-09,-233.91,455.80000000000007
17970,88466448,2023-01-31,,920.61
17971,88466448,2023-02-03,-640.4,280.21000000000004
17972,88466448,2023-02-03,-1453.5,-1173.29
17973,88466448,2023-02-04,131.11,-1042.1799999999998
17974,88466448,2023-02-04,-79.47,-1121.6499999999999
17975,88466448,2023-02-05,627.1,-494.54999999999995
17976,88466448,2023-02-05,-51.26,-545.81
17977,88466448,2023-02-07,-143.04,-688.8499999999999
17978,88466448,2023-02-08,-58.82,-747.67
17979,88466448,2023-02-09,11.47,-736.1999999999999
17980,88466448,2023-02-10,-121.97,-858.17
17981,88466448,2023-02-12,112.58,-745.5899999999999
17982,88476961,2023-01-31,,524.76
17983,88476961,2023-02-01,75.85,600.61
17984,88476961,2023-02-04,86.15,686.76
17985,88476961,2023-02-05,138.66,825.42
17986,88476961,2023-02-07,75.95,901.37
17987,88476961,2023-02-10,-55.13,846.24
17988,88476961,2023-02-11,-133.78,712.46
17989,88482062,2023-01-31,,149.31
17990,88482062,2023-02-01,-321.2,-171.89
17991,88482062,2023-02-07,130.23,-41.66
17992,88482062,2023-02-07,85.25,43.59
17993,88482062,2023-02-08,-1096.2,-1052.6100000000001
17994,88482062,2023-02-10,-87.07,-1139.68
17995,88489173,2023-01-31,,476.26
17996,88489173,2023-02-01,169.18,645.44
17997,88489173,2023-02-02,-115.09,530.35
17998,88489173,2023-02-08,-0.47,529.88
17999,88489173,2023-02-09,-145.71,384.16999999999996
18000,88489173,2023-02-13,-133.97,250.2
18001,88538200,2023-01-31,,518.77
18002,88538200,2023-02-02,-83.89,434.88
18003,88538200,2023-02-06,40.91,475.78999999999996
18004,88538200,2023-02-10,1394.1,1869.8899999999999
18005,88538200,2023-02-12,1077.3,2947.1899999999996
18006,88538200,2023-02-12,127.83,3075.02
18007,88538200,2023-02-13,76.09,3151.1099999999997
18008,88551691,2023-01-31,,979.24
18009,88551691,2023-02-01,89.41,1068.65
18010,88551691,2023-02-05,1136.4,2205.05
18011,88551691,2023-02-07,-75.03,2130.02
18012,88551691,2023-02-08,-118.77,2011.2500000000002
18013,88558016,2023-01-31,,156.64
18014,88558016,2023-02-04,84.53,241.17
18015,88558016,2023-02-09,-37.65,203.51999999999998
18016,88558016,2023-02-12,84.83,288.35
18017,88558016,2023-02-12,76.51,364.86
18018,88558016,2023-02-14,76.93,441.79
18019,88568543,2023-01-31,,472.83
18020,88568543,2023-02-01,-168.34,304.49
18021,88568543,2023-02-02,-86.62,217.86999999999998
18022,88568543,2023-02-02,-723.0,-505.13
18023,88568543,2023-02-03,-102.35,-607.48
18024,88568543,2023-02-07,126.03,-481.45
18025,88568543,2023-02-10,-65.54,-546.99
18026,88568543,2023-02-11,1215.8,668.81
18027,88568543,2023-02-13,26.24,695.05
18028,88568543,2023-02-14,-17.11,677.9399999999999
18029,88570753,2023-01-31,,62.48
18030,88570753,2023-02-07,1440.9,1503.38
18031,88570753,2023-02-07,-99.56,1403.8200000000002
18032,88570753,2023-02-09,-127.53,1276.2900000000002
18033,88570753,2023-02-12,-90.66,1185.63
18034,88570753,2023-02-14,89.9,1275.5300000000002
18035,88580402,2023-01-31,,118.18
18036,88580402,2023-02-01,104.47,222.65
18037,88580402,2023-02-03,59.01,281.66
18038,88580402,2023-02-06,143.3,424.96000000000004
18039,88580402,2023-02-09,-83.99,340.97
18040,88580402,2023-02-14,-175.7,165.27000000000004
18041,88646863,2023-01-31,,250.52
18042,88646863,2023-02-03,35.32,285.84000000000003
18043,88646863,2023-02-08,947.8,1233.6399999999999
18044,88657589,2023-01-31,,712.85
18045,88657589,2023-02-03,-97.96,614.89
18046,88657589,2023-02-04,94.72,709.61
18047,88657589,2023-02-05,98.03,807.64
18048,88657589,2023-02-07,50.49,858.13
18049,88657589,2023-02-09,163.99,1022.12
18050,88657589,2023-02-09,11.2,1033.32
18051,88657589,2023-02-10,-129.33,903.99
18052,88657589,2023-02-13,26.71,930.7
18053,88657589,2023-02-14,77.4,1008.1
18054,88676459,2023-01-31,,285.95
18055,88676459,2023-02-01,94.56,380.51
18056,88676459,2023-02-03,-493.5,-112.99000000000001
18057,88676459,2023-02-09,-113.5,-226.49
18058,88676459,2023-02-12,-183.53,-410.02
18059,88676459,2023-02-14,-42.94,-452.96000000000004
18060,88681540,2023-01-31,,531.01
18061,88681540,2023-02-01,122.46,653.47
18062,88681540,2023-02-01,-158.59,494.88
18063,88681540,2023-02-03,-11.36,483.52
18064,88681540,2023-02-08,-96.66,386.86
18065,88681540,2023-02-13,144.82,531.6800000000001
18066,88710457,2023-01-31,,818.28
18067,88710457,2023-02-03,-49.28,769.0
18068,88710457,2023-02-03,-70.8,698.1999999999999
18069,88710457,2023-02-09,156.03,854.23
18070,88710457,2023-02-11,-128.07,726.16
18071,88710457,2023-02-14,-137.37,588.79
18072,88732093,2023-01-31,,57.56
18073,88732093,2023-02-01,81.49,139.05
18074,88732093,2023-02-01,-132.52,6.529999999999973
18075,88732093,2023-02-06,1502.6,1509.1299999999999
18076,88732093,2023-02-06,878.3,2387.43
18077,88732093,2023-02-08,-88.5,2298.93
18078,88732093,2023-02-12,-164.29,2134.64
18079,88824263,2023-01-31,,295.9
18080,88824263,2023-02-01,-28.95,266.95
18081,88824263,2023-02-02,-38.78,228.16999999999996
18082,88824263,2023-02-09,-132.11,96.05999999999995
18083,88824263,2023-02-12,133.13,229.18999999999994
18084,88824263,2023-02-12,31.2,260.38999999999993
18085,88831746,2023-01-31,,565.27
18086,88831746,2023-02-03,128.25,693.52
18087,88831746,2023-02-04,-101.49,592.03
18088,88831746,2023-02-07,64.68,656.71
18089,88831746,2023-02-08,-179.3,477.40999999999997
18090,88831746,2023-02-10,204.71,682.12
18091,88834465,2023-01-31,,18.3
18092,88834465,2023-02-05,-87.06,-68.76
18093,88834465,2023-02-06,26.04,-42.720000000000006
18094,88834465,2023-02-10,-400.1,-442.82000000000005
18095,88837750,2023-01-31,,269.14
18096,88837750,2023-02-03,116.84,385.98
18097,88837750,2023-02-04,111.74,497.71999999999997
18098,88837750,2023-02-05,-61.25,436.46999999999997
18099,88837750,2023-02-06,-127.59,308.88
18100,88837750,2023-02-07,-26.09,282.78999999999996
18101,88837750,2023-02-09,-38.34,244.45
18102,88837750,2023-02-10,187.69,432.14
18103,88837750,2023-02-10,-149.53,282.61
18104,88837750,2023-02-12,76.82,359.42999999999995
18105,88857879,2023-01-31,,601.01
18106,88857879,2023-02-03,-16.43,584.58
18107,88857879,2023-02-08,86.36,670.94
18108,88857879,2023-02-11,181.25,852.19
18109,88857879,2023-02-11,-85.41,766.78
18110,88926132,2023-01-31,,275.1
18111,88926132,2023-02-02,12.65,287.75
18112,88926132,2023-02-04,1618.2,1905.95
18113,88926132,2023-02-04,1031.4,2937.3500000000004
18114,88926132,2023-02-04,-381.6,2555.75
18115,88926132,2023-02-07,-64.68,2491.07
18116,88926132,2023-02-08,113.38,2604.4500000000003
18117,88926132,2023-02-10,-75.67,2528.78
18118,88926132,2023-02-13,152.58,2681.36
18119,88926132,2023-02-13,-116.52,2564.84
18120,88926132,2023-02-13,-2264.3,300.53999999999996
18121,88926132,2023-02-14,175.7,476.23999999999995
18122,88933315,2023-01-31,,289.79
18123,88933315,2023-02-01,115.4,405.19000000000005
18124,88933315,2023-02-01,101.08,506.27000000000004
18125,88933315,2023-02-06,-114.74,391.53000000000003
18126,88933315,2023-02-09,108.34,499.87
18127,88933315,2023-02-09,-82.08,417.79
18128,88933315,2023-02-11,-150.26,267.53000000000003
18129,88933315,2023-02-11,-1828.9,-1561.3700000000001
18130,88933315,2023-02-13,-61.19,-1622.5600000000002
18131,88933315,2023-02-14,87.23,-1535.3300000000002
18132,88933315,2023-02-14,-157.43,-1692.7600000000002
18133,88968006,2023-01-31,,952.66
18134,88968006,2023-02-02,57.04,1009.6999999999999
18135,88968006,2023-02-04,-89.95,919.75
18136,88968006,2023-02-04,-129.7,790.05
18137,88968006,2023-02-08,176.94,966.99
18138,88974311,2023-01-31,,501.47
18139,88974311,2023-02-01,-152.59,348.88
18140,88974311,2023-02-02,-153.2,195.68000000000004
18141,89065134,2023-01-31,,447.32
18142,89065134,2023-02-02,153.04,600.36
18143,89065134,2023-02-02,-93.52,506.84
18144,89065134,2023-02-02,-111.91,394.93
18145,89065134,2023-02-02,-119.89,275.03999999999996
18146,89065134,2023-02-14,-120.46,154.57999999999998
18147,89088715,2023-01-31,,336.6
18148,89088715,2023-02-02,1180.2,1516.8000000000002
18149,89088715,2023-02-03,36.14,1552.94
18150,89088715,2023-02-04,104.24,1657.1799999999998
18151,89088715,2023-02-07,-65.96,1591.22
18152,89088715,2023-02-10,-63.35,1527.87
18153,89088715,2023-02-11,79.06,1606.9299999999998
18154,89088715,2023-02-12,77.54,1684.47
18155,89088715,2023-02-14,117.34,1801.81
18156,89117536,2023-01-31,,123.22
18157,89117536,2023-02-02,150.57,273.78999999999996
18158,89117536,2023-02-02,74.5,348.28999999999996
18159,89117536,2023-02-06,27.56,375.84999999999997
18160,89194917,2023-01-31,,332.56
18161,89194917,2023-02-08,61.4,393.96
18162,89194917,2023-02-10,-99.66,294.3
18163,89194917,2023-02-12,-122.32,171.98000000000002
18164,89194917,2023-02-13,-75.77,96.21000000000002
18165,89223056,2023-01-31,,139.98
18166,89223056,2023-02-08,149.64,289.62
18167,89223056,2023-02-09,-39.08,250.53999999999996
18168,89223056,2023-02-09,-98.06,152.47999999999996
18169,89223056,2023-02-09,-141.4,11.079999999999984
18170,89223056,2023-02-11,48.78,59.859999999999985
18171,89223056,2023-02-14,1660.2,1720.06
18172,89225677,2023-01-31,,660.05
18173,89225677,2023-02-04,-52.76,607.29
18174,89225677,2023-02-05,-80.23,527.06
18175,89225677,2023-02-06,24.38,551.4399999999999
18176,89225677,2023-02-06,-141.06,410.37999999999994
18177,89225677,2023-02-07,1107.6,1517.9799999999998
18178,89225677,2023-02-09,-123.84,1394.1399999999999
18179,89225677,2023-02-11,90.85,1484.9899999999998
18180,89225677,2023-02-12,108.0,1592.9899999999998
18181,89225677,2023-02-12,-104.9,1488.0899999999997
18182,89244577,2023-01-31,,706.67
18183,89244577,2023-02-02,555.5,1262.17
18184,89244577,2023-02-05,134.55,1396.72
18185,89244577,2023-02-06,-50.86,1345.86
18186,89244577,2023-02-06,-117.46,1228.4
18187,89244577,2023-02-08,-96.58,1131.82
18188,89244577,2023-02-09,103.8,1235.62
18189,89244577,2023-02-11,-122.21,1113.41
18190,89244577,2023-02-12,55.85,1169.26
18191,89309725,2023-01-31,,858.68
18192,89309725,2023-02-02,-124.23,734.4499999999999
18193,89309725,2023-02-03,1453.5,2187.95
18194,89309725,2023-02-04,-135.89,2052.06
18195,89309725,2023-02-07,121.91,2173.97
18196,89309725,2023-02-08,63.8,2237.77
18197,89309725,2023-02-09,45.07,2282.8399999999997
18198,89309725,2023-02-12,146.24,2429.08
18199,89318229,2023-01-31,,675.08
18200,89318229,2023-02-02,-72.72,602.36
18201,89318229,2023-02-02,-98.51,503.85
18202,89318229,2023-02-07,209.73,713.58
18203,89318229,2023-02-08,132.6,846.1800000000001
18204,89318229,2023-02-09,46.37,892.5500000000001
18205,89318229,2023-02-14,-85.66,806.8900000000001
18206,89353946,2023-01-31,,809.48
18207,89353946,2023-02-05,142.19,951.6700000000001
18208,89353946,2023-02-07,117.45,1069.1200000000001
18209,89353946,2023-02-07,-1.03,1068.09
18210,89353946,2023-02-08,-94.96,973.13
18211,89353946,2023-02-11,-161.25,811.88
18212,89369216,2023-01-31,,404.56
18213,89369216,2023-02-01,-99.09,305.47
18214,89369216,2023-02-02,57.51,362.98
18215,89369216,2023-02-06,-87.82,275.15999999999997
18216,89369216,2023-02-07,93.19,368.35
18217,89369216,2023-02-07,-141.99,226.35999999999999
18218,89369216,2023-02-08,80.72,307.08
18219,89369216,2023-02-10,100.23,407.31
18220,89369216,2023-02-10,61.16,468.46999999999997
18221,89369216,2023-02-10,-107.56,360.90999999999997
18222,89369216,2023-02-11,1944.9,2305.81
18223,89406032,2023-01-31,,453.31
18224,89406032,2023-02-05,-123.79,329.52
18225,89406032,2023-02-05,-176.37,153.14999999999998
18226,89406032,2023-02-11,-141.71,11.43999999999997
18227,89407337,2023-01-31,,211.2
18228,89438779,2023-01-31,,347.92
18229,89438779,2023-02-01,-104.57,243.35000000000002
18230,89438779,2023-02-02,-21.71,221.64000000000001
18231,89438779,2023-02-02,-205.22,16.420000000000016
18232,89438779,2023-02-07,140.14,156.56
18233,89438779,2023-02-07,125.71,282.27
18234,89438779,2023-02-07,-113.6,168.67000000000002
18235,89438779,2023-02-12,198.2,366.87
18236,89438779,2023-02-12,-69.44,297.43
18237,89438779,2023-02-13,1062.5,1359.93
18238,89471153,2023-01-31,,52.29
18239,89471153,2023-02-12,153.64,205.92999999999998
18240,89471153,2023-02-13,81.41,287.34
18241,89471153,2023-02-13,-114.78,172.55999999999997
18242,89471153,2023-02-14,-68.12,104.43999999999997
18243,89497773,2023-01-31,,637.02
18244,89497773,2023-02-02,131.02,768.04
18245,89497773,2023-02-03,-94.57,673.47
18246,89497773,2023-02-04,-100.39,573.08
18247,89497773,2023-02-06,-55.52,517.56
18248,89497773,2023-02-07,141.01,658.5699999999999
18249,89497773,2023-02-07,50.93,709.5
18250,89497773,2023-02-09,123.35,832.85
18251,89497773,2023-02-12,123.38,956.23
18252,89497773,2023-02-14,-172.96,783.27
18253,89503991,2023-01-31,,204.52
18254,89503991,2023-02-02,95.08,299.6
18255,89503991,2023-02-09,72.3,371.9
18256,89503991,2023-02-12,1030.7,1402.6
18257,89608054,2023-01-31,,495.15
18258,89608054,2023-02-04,80.37,575.52
18259,89608054,2023-02-11,92.62,668.14
18260,89608054,2023-02-12,190.17,858.31
18261,89608054,2023-02-12,-86.73,771.5799999999999
18262,89608054,2023-02-14,-116.09,655.49
18263,89629293,2023-01-31,,292.31
18264,89629293,2023-02-11,-124.56,167.75
18265,89629293,2023-02-14,-191.52,-23.77000000000001
18266,89632856,2023-01-31,,557.83
18267,89632856,2023-02-02,-126.16,431.6700000000001
18268,89632856,2023-02-03,-119.95,311.72
18269,89632856,2023-02-06,50.84,362.56000000000006
18270,89632856,2023-02-08,-1908.7,-1546.1399999999999
18271,89645445,2023-01-31,,287.29
18272,89645445,2023-02-03,-112.15,175.14000000000001
18273,89645445,2023-02-09,1726.4,1901.5400000000002
18274,89650416,2023-01-31,,146.17
18275,89650416,2023-02-01,-205.89,-59.72
18276,89650416,2023-02-04,-127.68,-187.4
18277,89650416,2023-02-10,71.44,-115.96000000000001
18278,89650416,2023-02-12,55.39,-60.57000000000001
18279,89650416,2023-02-12,-120.12,-180.69
18280,89689059,2023-01-31,,906.88
18281,89689059,2023-02-02,-173.89,732.99
18282,89689059,2023-02-03,-99.14,633.85
18283,89689059,2023-02-04,-76.44,557.41
18284,89689059,2023-02-06,100.18,657.59
18285,89689059,2023-02-06,-69.68,587.91
18286,89689059,2023-02-09,-1576.6,-988.6899999999999
18287,89689059,2023-02-14,103.89,-884.8
18288,89697097,2023-01-31,,449.71
18289,89697097,2023-02-02,128.36,578.0699999999999
18290,89697097,2023-02-08,-1737.4,-1159.3300000000002
18291,89697097,2023-02-13,44.38,-1114.95
18292,89697097,2023-02-14,100.83,-1014.1200000000001
18293,89720252,2023-01-31,,672.88
18294,89720252,2023-02-03,101.53,774.41
18295,89720252,2023-02-03,91.02,865.43
18296,89720252,2023-02-11,-55.02,810.41
18297,89720252,2023-02-12,192.75,1003.16
18298,89720252,2023-02-13,182.14,1185.3
18299,89720252,2023-02-14,40.13,1225.43
18300,89761152,2023-01-31,,923.01
18301,89761152,2023-02-05,-166.03,756.98
18302,89761152,2023-02-06,-44.43,712.55
18303,89761152,2023-02-09,-1365.7,-653.1500000000001
18304,89761152,2023-02-11,-67.06,-720.21
18305,89761152,2023-02-11,-144.17,-864.3800000000001
18306,89761152,2023-02-12,89.43,-774.95
18307,89761152,2023-02-12,85.04,-689.9100000000001
18308,89761152,2023-02-14,-99.21,-789.1200000000001
18309,89905732,2023-01-31,,883.38
18310,89905732,2023-02-02,-1921.4,-1038.02
18311,89905732,2023-02-05,-128.78,-1166.8
18312,89905732,2023-02-05,-141.29,-1308.09
18313,89905732,2023-02-10,1147.5,-160.58999999999992
18314,89905732,2023-02-14,156.56,-4.029999999999916
18315,89916489,2023-01-31,,726.43
18316,89916489,2023-02-01,-174.0,552.43
18317,89916489,2023-02-03,101.75,654.18
18318,89916489,2023-02-06,-81.53,572.65
18319,89972805,2023-01-31,,456.55
18320,89972805,2023-02-08,35.2,491.75
18321,89983842,2023-01-31,,880.93
18322,89983842,2023-02-03,39.37,920.3
18323,89983842,2023-02-05,-80.89,839.41
18324,89983842,2023-02-07,60.4,899.81
18325,89983842,2023-02-11,145.45,1045.26
18326,89983842,2023-02-11,-129.67,915.5899999999999
18327,90019913,2023-01-31,,430.21
18328,90019913,2023-02-02,-69.49,360.71999999999997
18329,90019913,2023-02-08,-1693.2,-1332.48
18330,90019913,2023-02-09,156.34,-1176.14
18331,90019913,2023-02-10,72.21,-1103.93
18332,90019913,2023-02-12,-622.0,-1725.93
18333,90019913,2023-02-14,66.36,-1659.5700000000002
18334,90044139,2023-01-31,,568.28
18335,90044139,2023-02-04,-72.06,496.21999999999997
18336,90044139,2023-02-05,-94.48,401.73999999999995
18337,90044139,2023-02-13,-138.94,262.79999999999995
18338,90054505,2023-01-31,,586.12
18339,90054505,2023-02-01,-129.54,456.58000000000004
18340,90054505,2023-02-08,88.44,545.02
18341,90054505,2023-02-10,108.6,653.62
18342,90090889,2023-01-31,,836.85
18343,90090889,2023-02-04,-105.37,731.48
18344,90090889,2023-02-05,142.54,874.02
18345,90090889,2023-02-10,-1499.1,-625.0799999999999
18346,90090889,2023-02-12,-190.9,-815.9799999999999
18347,90090889,2023-02-14,-136.43,-952.41
18348,90118682,2023-01-31,,58.16
18349,90118682,2023-02-02,-129.77,-71.61000000000001
18350,90118682,2023-02-03,149.58,77.97
18351,90118682,2023-02-03,69.26,147.23000000000002
18352,90118682,2023-02-05,-62.8,84.43
18353,90118682,2023-02-07,105.38,189.81
18354,90118682,2023-02-08,143.57,333.38
18355,90118682,2023-02-09,-203.24,130.14
18356,90118682,2023-02-10,-123.94,6.199999999999989
18357,90118682,2023-02-13,-4.66,1.5399999999999885
18358,90168031,2023-01-31,,196.48
18359,90168031,2023-02-01,-170.35,26.129999999999995
18360,90168031,2023-02-04,157.26,183.39
18361,90168031,2023-02-09,-74.6,108.78999999999999
18362,90168031,2023-02-09,-156.34,-47.55000000000001
18363,90203948,2023-01-31,,689.49
18364,90203948,2023-02-03,133.06,822.55
18365,90203948,2023-02-03,103.32,925.87
18366,90203948,2023-02-06,110.71,1036.58
18367,90203948,2023-02-08,1608.4,2644.98
18368,90203948,2023-02-11,-116.37,2528.61
18369,90203948,2023-02-13,63.14,2591.75
18370,90233696,2023-01-31,,628.02
18371,90233696,2023-02-01,73.14,701.16
18372,90233696,2023-02-02,-197.62,503.53999999999996
18373,90233696,2023-02-05,138.32,641.8599999999999
18374,90233696,2023-02-08,62.15,704.01
18375,90233696,2023-02-11,-40.3,663.7099999999999
18376,90233696,2023-02-13,-38.7,625.01
18377,90287712,2023-01-31,,316.17
18378,90287712,2023-02-01,105.25,421.42
18379,90287712,2023-02-03,-46.33,375.09000000000003
18380,90287712,2023-02-05,-108.31,266.78000000000003
18381,90287712,2023-02-08,115.99,382.77
18382,90287712,2023-02-10,-65.52,317.25
18383,90287712,2023-02-14,59.8,377.05
18384,90313378,2023-01-31,,743.7
18385,90313378,2023-02-03,622.9,1366.6
18386,90313378,2023-02-03,-99.93,1266.67
18387,90313378,2023-02-06,169.47,1436.14
18388,90313378,2023-02-07,57.59,1493.73
18389,90313378,2023-02-08,24.38,1518.1100000000001
18390,90313378,2023-02-11,-27.58,1490.53
18391,90313378,2023-02-12,-103.79,1386.74
18392,90313378,2023-02-13,74.74,1461.48
18393,90336689,2023-01-31,,847.88
18394,90336689,2023-02-02,169.64,1017.52
18395,90336689,2023-02-03,-120.88,896.64
18396,90336689,2023-02-04,973.3,1869.94
18397,90336689,2023-02-07,-48.04,1821.8999999999999
18398,90336689,2023-02-09,-69.33,1752.57
18399,90336689,2023-02-11,-954.4,798.17
18400,90338454,2023-01-31,,748.63
18401,90338454,2023-02-01,-162.02,586.61
18402,90338454,2023-02-06,57.25,643.86
18403,90338454,2023-02-08,72.15,716.01
18404,90338454,2023-02-10,-105.08,610.93
18405,90349791,2023-01-31,,568.63
18406,90349791,2023-02-06,93.16,661.79
18407,90446254,2023-01-31,,930.0
18408,90446254,2023-02-03,-372.2,557.8
18409,90446254,2023-02-12,-100.81,456.99
18410,90446254,2023-02-13,-92.53,364.46000000000004
18411,90446254,2023-02-14,-50.66,313.8
18412,90480183,2023-01-31,,465.06
18413,90480183,2023-02-03,72.03,537.09
18414,90480183,2023-02-03,-34.72,502.37
18415,90480183,2023-02-05,94.53,596.9
18416,90480183,2023-02-05,-167.77,429.13
18417,90480183,2023-02-06,-140.76,288.37
18418,90480183,2023-02-07,74.75,363.12
18419,90549616,2023-01-31,,37.69
18420,90549616,2023-02-01,-169.68,-131.99
18421,90549616,2023-02-01,-787.2,-919.19
18422,90549616,2023-02-04,27.43,-891.7600000000001
18423,90549616,2023-02-04,-99.93,-991.69
18424,90549616,2023-02-06,-1338.0,-2329.69
18425,90549616,2023-02-07,-165.34,-2495.03
18426,90549616,2023-02-08,34.93,-2460.1
18427,90549616,2023-02-10,69.64,-2390.46
18428,90549616,2023-02-12,-133.13,-2523.59
18429,90549616,2023-02-14,136.43,-2387.16
18430,90589761,2023-01-31,,535.28
18431,90589761,2023-02-02,82.9,618.18
18432,90589761,2023-02-05,108.08,726.26
18433,90589761,2023-02-06,118.48,844.74
18434,90589761,2023-02-11,-166.8,677.9399999999999
18435,90589761,2023-02-12,158.31,836.25
18436,90625637,2023-01-31,,477.46
18437,90625637,2023-02-03,-110.66,366.79999999999995
18438,90625637,2023-02-07,39.59,406.39
18439,90625637,2023-02-10,-90.09,316.29999999999995
18440,90625637,2023-02-11,107.06,423.36
18441,90625637,2023-02-13,60.63,483.99
18442,90625637,2023-02-13,-186.35,297.64
18443,90717656,2023-01-31,,409.99
18444,90717656,2023-02-02,224.91,634.9
18445,90717656,2023-02-04,668.8,1303.6999999999998
18446,90717656,2023-02-09,-39.39,1264.31
18447,90717656,2023-02-12,114.27,1378.58
18448,90717656,2023-02-12,-98.81,1279.77
18449,90745743,2023-01-31,,375.07
18450,90745743,2023-02-01,-142.99,232.07999999999998
18451,90745743,2023-02-02,111.9,343.98
18452,90745743,2023-02-03,-113.54,230.44
18453,90745743,2023-02-06,98.92,329.36
18454,90745743,2023-02-10,104.75,434.11
18455,90745743,2023-02-11,-9.21,424.9
18456,90745743,2023-02-13,49.9,474.79999999999995
18457,90824896,2023-01-31,,484.11
18458,90824896,2023-02-02,92.36,576.47
18459,90824896,2023-02-04,104.15,680.62
18460,90824896,2023-02-06,-74.25,606.37
18461,90824896,2023-02-08,-10.05,596.32
18462,90851200,2023-01-31,,361.43
18463,90851200,2023-02-02,-755.8,-394.36999999999995
18464,90851200,2023-02-06,83.26,-311.10999999999996
18465,90851200,2023-02-07,46.27,-264.8399999999999
18466,90851200,2023-02-10,150.77,-114.06999999999994
18467,90851200,2023-02-10,-81.71,-195.77999999999992
18468,90851200,2023-02-13,98.19,-97.58999999999993
18469,90851200,2023-02-14,-86.1,-183.68999999999994
18470,90871147,2023-01-31,,362.86
18471,90871147,2023-02-08,64.27,427.13
18472,90871147,2023-02-08,-76.59,350.54
18473,90871147,2023-02-09,-484.0,-133.45999999999998
18474,90871147,2023-02-10,58.45,-75.00999999999998
18475,90871147,2023-02-10,-59.42,-134.42999999999998
18476,90894195,2023-01-31,,157.01
18477,90894195,2023-02-02,90.49,247.5
18478,90894195,2023-02-03,40.13,287.63
18479,90894195,2023-02-04,-150.38,137.25
18480,90894195,2023-02-05,-112.34,24.909999999999997
18481,90894195,2023-02-07,45.83,70.74
18482,90932350,2023-01-31,,480.51
18483,90932350,2023-02-02,98.11,578.62
18484,90932350,2023-02-06,189.84,768.46
18485,90932350,2023-02-07,-65.9,702.56
18486,90932350,2023-02-08,-24.76,677.8
18487,90932350,2023-02-08,-837.3,-159.5
18488,90932350,2023-02-09,126.46,-33.040000000000006
18489,90932350,2023-02-09,67.99,34.94999999999999
18490,90932350,2023-02-10,-121.71,-86.76
18491,90951743,2023-01-31,,220.81
18492,90951743,2023-02-02,1559.2,1780.01
18493,90951743,2023-02-02,-64.9,1715.11
18494,90951743,2023-02-03,-83.25,1631.86
18495,90951743,2023-02-04,-1548.2,83.65999999999985
18496,90951743,2023-02-05,74.55,158.20999999999987
18497,90951743,2023-02-08,81.17,239.37999999999985
18498,90951743,2023-02-09,112.31,351.6899999999998
18499,90951743,2023-02-11,26.95,378.6399999999999
18500,90951743,2023-02-11,-96.88,281.7599999999999
18501,90982016,2023-01-31,,776.15
18502,90982016,2023-02-07,-92.8,683.35
18503,90982016,2023-02-09,142.5,825.8499999999999
18504,90982016,2023-02-13,124.37,950.22
18505,90982016,2023-02-14,-97.59,852.63
18506,91020929,2023-01-31,,348.12
18507,91020929,2023-02-01,-107.56,240.56
18508,91020929,2023-02-05,99.91,340.47
18509,91020929,2023-02-05,-111.54,228.93
18510,91020929,2023-02-08,-40.13,188.79999999999998
18511,91020929,2023-02-10,-165.41,23.389999999999986
18512,91020929,2023-02-11,39.39,62.77999999999999
18513,91020929,2023-02-13,102.35,165.13
18514,91020929,2023-02-14,-115.38,49.749999999999986
18515,91062192,2023-01-31,,211.52
18516,91062192,2023-02-02,-170.79,40.73000000000002
18517,91062192,2023-02-03,-130.7,-89.96999999999997
18518,91062192,2023-02-06,981.9,891.9300000000001
18519,91142310,2023-01-31,,363.08
18520,91142310,2023-02-06,162.13,525.21
18521,91142310,2023-02-07,-1225.0,-699.79
18522,91142310,2023-02-14,-666.1,-1365.8899999999999
18523,91184544,2023-01-31,,64.05
18524,91184544,2023-02-02,12.35,76.39999999999999
18525,91184544,2023-02-07,-91.56,-15.16000000000001
18526,91184544,2023-02-08,159.35,144.19
18527,91184544,2023-02-09,71.26,215.45
18528,91184544,2023-02-11,1207.7,1423.15
18529,91184544,2023-02-13,-105.4,1317.75
18530,91246568,2023-01-31,,147.43
18531,91246568,2023-02-02,88.8,236.23000000000002
18532,91246568,2023-02-02,-111.58,124.65
18533,91246568,2023-02-02,-189.79,-65.13999999999999
18534,91246568,2023-02-06,86.91,21.77000000000001
18535,91246568,2023-02-06,-88.91,-67.13999999999999
18536,91246568,2023-02-06,-120.78,-187.92
18537,91246568,2023-02-09,94.78,-93.13999999999999
18538,91246568,2023-02-13,55.07,-38.069999999999986
18539,91246568,2023-02-14,79.76,41.69000000000002
18540,91251995,2023-01-31,,244.0
18541,91251995,2023-02-05,-135.59,108.41
18542,91251995,2023-02-07,-181.11,-72.70000000000002
18543,91251995,2023-02-12,92.56,19.859999999999985
18544,91259453,2023-01-31,,816.68
18545,91259453,2023-02-02,224.1,1040.78
18546,91259453,2023-02-11,6.19,1046.97
18547,91259453,2023-02-12,1801.4,2848.37
18548,91259453,2023-02-13,-52.26,2796.11
18549,91305080,2023-01-31,,123.21
18550,91305080,2023-02-01,105.63,228.83999999999997
18551,91305080,2023-02-07,-66.78,162.06
18552,91305080,2023-02-11,-29.76,132.29999999999998
18553,91305080,2023-02-11,-125.91,6.389999999999986
18554,91305080,2023-02-14,1288.0,1294.3899999999999
18555,91305080,2023-02-14,111.08,1405.4699999999998
18556,91349198,2023-01-31,,669.58
18557,91349198,2023-02-06,-1.46,668.12
18558,91349198,2023-02-09,-54.69,613.4300000000001
18559,91349198,2023-02-10,123.66,737.09
18560,91349198,2023-02-11,-101.75,635.34
18561,91349198,2023-02-12,-1149.0,-513.66
18562,91373446,2023-01-31,,561.42
18563,91373446,2023-02-01,-87.59,473.8299999999999
18564,91373446,2023-02-03,-126.64,347.18999999999994
18565,91373446,2023-02-05,55.81,402.99999999999994
18566,91373446,2023-02-05,-112.73,290.27
18567,91373446,2023-02-06,-137.1,153.16999999999996
18568,91373446,2023-02-09,165.46,318.63
18569,91373446,2023-02-09,-64.96,253.66999999999996
18570,91373446,2023-02-11,-510.2,-256.53000000000003
18571,91373446,2023-02-14,64.61,-191.92000000000002
18572,91382872,2023-01-31,,782.62
18573,91382872,2023-02-10,96.17,878.79
18574,91382872,2023-02-12,-96.6,782.19
18575,91423814,2023-01-31,,957.99
18576,91423814,2023-02-06,-59.52,898.47
18577,91423814,2023-02-06,-113.54,784.9300000000001
18578,91445572,2023-01-31,,405.88
18579,91445572,2023-02-02,58.4,464.28
18580,91445572,2023-02-03,156.41,620.69
18581,91576212,2023-01-31,,824.71
18582,91576212,2023-02-02,-120.45,704.26
18583,91576212,2023-02-03,-117.46,586.8000000000001
18584,91576212,2023-02-05,53.81,640.61
18585,91576212,2023-02-08,1254.7,1895.31
18586,91576212,2023-02-08,-85.9,1809.41
18587,91576212,2023-02-09,-1301.5,507.9100000000001
18588,91576212,2023-02-12,989.2,1497.1100000000001
18589,91605034,2023-01-31,,560.96
18590,91605034,2023-02-02,162.1,723.0600000000001
18591,91605034,2023-02-09,91.82,814.88
18592,91605034,2023-02-12,-1030.7,-215.82000000000005
18593,91621026,2023-01-31,,834.74
18594,91621026,2023-02-06,96.79,931.53
18595,91621026,2023-02-10,-739.5,192.02999999999997
18596,91621026,2023-02-12,145.55,337.58
18597,91621026,2023-02-12,142.86,480.44
18598,91621026,2023-02-12,129.73,610.17
18599,91621026,2023-02-12,65.91,676.0799999999999
18600,91658755,2023-01-31,,347.59
18601,91658755,2023-02-01,126.06,473.65
18602,91658755,2023-02-03,59.28,532.93
18603,91658755,2023-02-03,-1016.9,-483.97
18604,91658755,2023-02-08,-69.56,-553.53
18605,91658755,2023-02-08,-189.28,-742.8100000000001
18606,91658755,2023-02-10,882.0,139.18999999999994
18607,91658755,2023-02-11,-112.56,26.62999999999994
18608,91658755,2023-02-14,166.87,193.49999999999994
18609,91703213,2023-01-31,,891.67
18610,91703213,2023-02-01,54.25,945.92
18611,91703213,2023-02-06,43.89,989.81
18612,91703213,2023-02-07,104.21,1094.02
18613,91703213,2023-02-08,-62.19,1031.83
18614,91703213,2023-02-09,-201.62,830.2099999999999
18615,91703213,2023-02-09,-780.7,49.50999999999988
18616,91703213,2023-02-10,132.35,181.85999999999987
18617,91747441,2023-01-31,,356.85
18618,91747441,2023-02-03,87.05,443.90000000000003
18619,91747441,2023-02-05,202.11,646.01
18620,91747441,2023-02-05,-103.17,542.84
18621,91747441,2023-02-09,76.74,619.58
18622,91747441,2023-02-11,108.78,728.36
18623,91747441,2023-02-11,-129.66,598.7
18624,91747441,2023-02-13,-151.93,446.77000000000004
18625,91819341,2023-01-31,,701.61
18626,91819341,2023-02-02,-99.58,602.03
18627,91819341,2023-02-07,-44.98,557.0500000000001
18628,91819341,2023-02-07,-90.26,466.79
18629,91819341,2023-02-09,115.89,582.6800000000001
18630,91819341,2023-02-09,-103.88,478.8
18631,91819341,2023-02-10,-170.55,308.25
18632,91829198,2023-01-31,,103.19
18633,91829198,2023-02-09,-1156.9,-1053.71
18634,91829198,2023-02-10,1585.0,531.29
18635,91829198,2023-02-12,90.34,621.63
18636,91829198,2023-02-13,-138.85,482.78
18637,91834926,2023-01-31,,793.19
18638,91834926,2023-02-03,53.42,846.61
18639,91834926,2023-02-04,-8.63,837.98
18640,91834926,2023-02-09,-121.5,716.48
18641,91834926,2023-02-11,-143.86,572.6200000000001
18642,91834926,2023-02-12,75.44,648.0600000000001
18643,91834926,2023-02-14,89.16,737.22
18644,91859090,2023-01-31,,10.38
18645,91859090,2023-02-02,231.9,242.28
18646,91859090,2023-02-04,97.84,340.12
18647,91859090,2023-02-06,114.75,454.87
18648,91859090,2023-02-08,206.07,660.94
18649,91859090,2023-02-09,160.06,821.0
18650,91859090,2023-02-14,52.73,873.73
18651,91885907,2023-01-31,,652.65
18652,91885907,2023-02-03,610.8,1263.4499999999998
18653,91885907,2023-02-05,107.87,1371.32
18654,91885907,2023-02-05,-125.05,1246.27
18655,91885907,2023-02-06,-70.1,1176.1699999999998
18656,91885907,2023-02-08,-110.64,1065.53
18657,91885907,2023-02-13,-114.36,951.17
18658,91939298,2023-01-31,,61.59
18659,91939298,2023-02-01,-121.69,-60.099999999999994
18660,91939298,2023-02-02,-122.81,-182.91
18661,91939298,2023-02-04,-110.99,-293.9
18662,91939298,2023-02-07,86.83,-207.07
18663,91939298,2023-02-12,-91.62,-298.69
18664,91939298,2023-02-14,126.03,-172.66
18665,91943555,2023-01-31,,438.21
18666,91943555,2023-02-04,-119.74,318.46999999999997
18667,91943555,2023-02-07,201.7,520.17
18668,91943555,2023-02-13,-112.0,408.16999999999996
18669,91944915,2023-01-31,,601.21
18670,91944915,2023-02-01,100.12,701.33
18671,91944915,2023-02-10,192.08,893.4100000000001
18672,91944915,2023-02-12,-68.26,825.1500000000001
18673,91957838,2023-01-31,,587.57
18674,91957838,2023-02-03,80.26,667.83
18675,91957838,2023-02-05,81.6,749.4300000000001
18676,91957838,2023-02-05,-100.87,648.5600000000001
18677,91957838,2023-02-05,-152.02,496.54
18678,91957838,2023-02-10,-209.84,286.70000000000005
18679,91957838,2023-02-11,169.33,456.03000000000003
18680,91971494,2023-01-31,,74.37
18681,91971494,2023-02-02,-787.6,-713.23
18682,91971494,2023-02-06,1053.5,340.27
18683,91971494,2023-02-09,-645.9,-305.63
18684,91971494,2023-02-10,-168.19,-473.82
18685,91972687,2023-01-31,,463.97
18686,91972687,2023-02-07,93.03,557.0
18687,91972687,2023-02-10,1128.4,1685.4
18688,91972687,2023-02-14,-144.57,1540.8300000000002
18689,92001688,2023-01-31,,339.08
18690,92001688,2023-02-05,-100.23,238.84999999999997
18691,92001688,2023-02-07,60.76,299.60999999999996
18692,92001688,2023-02-08,203.33,502.94
18693,92001688,2023-02-08,94.91,597.85
18694,92001688,2023-02-08,-72.05,525.8
18695,92001688,2023-02-11,62.36,588.16
18696,92001688,2023-02-14,-207.36,380.79999999999995
18697,92015508,2023-01-31,,457.52
18698,92015508,2023-02-04,-76.06,381.46
18699,92015508,2023-02-05,-52.36,329.09999999999997
18700,92015508,2023-02-06,171.67,500.77
18701,92015508,2023-02-07,-119.25,381.52
18702,92015508,2023-02-10,-83.79,297.72999999999996
18703,92015508,2023-02-11,-29.25,268.47999999999996
18704,92015508,2023-02-14,-150.24,118.23999999999995
18705,92037264,2023-01-31,,252.95
18706,92037264,2023-02-03,1131.6,1384.55
18707,92037264,2023-02-05,81.8,1466.35
18708,92037264,2023-02-05,-109.6,1356.75
18709,92037264,2023-02-09,7.4,1364.1499999999999
18710,92037264,2023-02-09,-128.74,1235.4099999999999
18711,92037264,2023-02-10,-56.59,1178.82
18712,92037264,2023-02-11,126.5,1305.32
18713,92037264,2023-02-12,-151.48,1153.84
18714,92037264,2023-02-14,-73.4,1080.44
18715,92037264,2023-02-14,-128.56,951.8799999999999
18716,92052516,2023-01-31,,466.43
18717,92052516,2023-02-02,1082.7,1549.13
18718,92052516,2023-02-06,368.9,1918.0300000000002
18719,92052516,2023-02-07,56.32,1974.3500000000001
18720,92052516,2023-02-12,-27.9,1946.45
18721,92052516,2023-02-14,-68.7,1877.75
18722,92145159,2023-01-31,,61.65
18723,92145159,2023-02-01,122.63,184.28
18724,92145159,2023-02-01,105.61,289.89
18725,92145159,2023-02-01,105.36,395.25
18726,92145159,2023-02-06,-104.1,291.15
18727,92145159,2023-02-07,-134.99,156.16
18728,92145159,2023-02-10,136.31,292.47
18729,92145159,2023-02-12,-2208.4,-1915.93
18730,92145159,2023-02-13,1370.8,-545.1300000000001
18731,92145159,2023-02-14,-615.6,-1160.73
18732,92155262,2023-01-31,,501.67
18733,92155262,2023-02-03,-95.71,405.96000000000004
18734,92155262,2023-02-08,1051.3,1457.26
18735,92155262,2023-02-09,1060.0,2517.26
18736,92155262,2023-02-10,134.54,2651.8
18737,92155262,2023-02-11,175.16,2826.96
18738,92155262,2023-02-12,58.39,2885.35
18739,92155262,2023-02-12,-39.42,2845.93
18740,92195724,2023-01-31,,726.92
18741,92195724,2023-02-01,98.75,825.67
18742,92195724,2023-02-01,-124.27,701.4
18743,92195724,2023-02-04,-1579.8,-878.4
18744,92195724,2023-02-07,-78.1,-956.5
18745,92195724,2023-02-08,-221.0,-1177.5
18746,92212099,2023-01-31,,584.21
18747,92212099,2023-02-09,-120.47,463.74
18748,92212099,2023-02-12,68.21,531.95
18749,92212099,2023-02-12,-7.59,524.36
18750,92212099,2023-02-13,-59.45,464.91
18751,92212099,2023-02-14,-122.94,341.97
18752,92214557,2023-01-31,,258.42
18753,92214557,2023-02-01,173.01,431.43
18754,92214557,2023-02-02,-80.13,351.3
18755,92214557,2023-02-04,158.56,509.86
18756,92214557,2023-02-05,98.2,608.0600000000001
18757,92214557,2023-02-07,1567.0,2175.06
18758,92214557,2023-02-07,123.67,2298.73
18759,92214557,2023-02-12,113.72,2412.45
18760,92214557,2023-02-13,95.71,2508.16
18761,92221411,2023-01-31,,849.46
18762,92221411,2023-02-01,-122.46,727.0
18763,92221411,2023-02-02,-23.22,703.7800000000001
18764,92221411,2023-02-04,72.06,775.84
18765,92221411,2023-02-06,96.4,872.24
18766,92221411,2023-02-08,122.18,994.4200000000001
18767,92221411,2023-02-08,-89.97,904.45
18768,92221411,2023-02-12,-123.13,781.32
18769,92221411,2023-02-14,-78.83,702.49
18770,92232319,2023-01-31,,416.11
18771,92232319,2023-02-02,165.3,581.4100000000001
18772,92232319,2023-02-04,-126.98,454.43
18773,92232319,2023-02-05,-212.21,242.22000000000003
18774,92232319,2023-02-08,-114.69,127.53000000000003
18775,92232319,2023-02-10,67.69,195.22000000000003
18776,92232319,2023-02-11,96.88,292.1
18777,92234913,2023-01-31,,613.18
18778,92234913,2023-02-07,-142.6,470.5799999999999
18779,92234913,2023-02-12,803.9,1274.48
18780,92234913,2023-02-13,-40.95,1233.53
18781,92287463,2023-01-31,,257.14
18782,92287463,2023-02-01,-84.96,172.18
18783,92287463,2023-02-03,-85.62,86.55999999999999
18784,92287463,2023-02-06,110.26,196.82
18785,92287463,2023-02-06,-109.51,87.30999999999999
18786,92287463,2023-02-07,-102.22,-14.91000000000001
18787,92287463,2023-02-09,111.55,96.63999999999999
18788,92287463,2023-02-11,31.41,128.04999999999998
18789,92287463,2023-02-12,79.05,207.09999999999997
18790,92319358,2023-01-31,,116.51
18791,92319358,2023-02-01,94.06,210.57
18792,92319358,2023-02-05,700.4,910.97
18793,92319358,2023-02-06,143.57,1054.54
18794,92319358,2023-02-07,-96.55,957.9899999999999
18795,92319358,2023-02-07,-135.69,822.3
18796,92319358,2023-02-09,1877.3,2699.6
18797,92319358,2023-02-09,-625.1,2074.5
18798,92319358,2023-02-10,-47.75,2026.75
18799,92319358,2023-02-10,-137.56,1889.1899999999998
18800,92319358,2023-02-11,157.6,2046.79
18801,92319358,2023-02-13,-126.66,1920.1299999999999
18802,92338537,2023-01-31,,316.24
18803,92338537,2023-02-01,-75.36,240.88
18804,92338537,2023-02-05,170.82,411.7
18805,92338537,2023-02-05,-403.6,8.099999999999966
18806,92338537,2023-02-08,30.21,38.30999999999997
18807,92338537,2023-02-13,262.4,300.7099999999999
18808,92338537,2023-02-13,-22.49,278.2199999999999
18809,92340721,2023-01-31,,844.79
18810,92340721,2023-02-05,1168.4,2013.19
18811,92340721,2023-02-06,-163.65,1849.54
18812,92340721,2023-02-07,744.0,2593.54
18813,92340721,2023-02-07,34.65,2628.19
18814,92340721,2023-02-08,110.64,2738.83
18815,92340721,2023-02-11,-58.37,2680.46
18816,92340721,2023-02-11,-187.8,2492.66
18817,92340721,2023-02-12,-112.23,2380.43
18818,92376825,2023-01-31,,323.68
18819,92376825,2023-02-01,158.59,482.27
18820,92376825,2023-02-04,100.39,582.66
18821,92376825,2023-02-05,197.01,779.6700000000001
18822,92376825,2023-02-10,145.53,925.2
18823,92376825,2023-02-11,1214.6,2139.8
18824,92376825,2023-02-12,120.9,2260.7
18825,92376825,2023-02-13,103.99,2364.69
18826,92390334,2023-01-31,,602.62
18827,92390334,2023-02-01,-136.22,466.4
18828,92390334,2023-02-04,-68.87,397.53
18829,92423759,2023-01-31,,475.1
18830,92423759,2023-02-04,131.28,606.38
18831,92423759,2023-02-04,-664.6,-58.22000000000003
18832,92423759,2023-02-06,90.64,32.41999999999997
18833,92437489,2023-01-31,,24.19
18834,92437489,2023-02-04,-40.15,-15.959999999999997
18835,92437489,2023-02-06,176.4,160.44
18836,92437489,2023-02-10,-73.65,86.78999999999999
18837,92437489,2023-02-10,-89.99,-3.200000000000003
18838,92551293,2023-01-31,,252.3
18839,92551293,2023-02-03,55.02,307.32
18840,92551293,2023-02-13,-122.87,184.45000000000002
18841,92563438,2023-01-31,,965.81
18842,92563438,2023-02-01,107.56,1073.37
18843,92563438,2023-02-01,-164.94,908.43
18844,92563438,2023-02-04,139.7,1048.1299999999999
18845,92563438,2023-02-09,-99.18,948.9499999999999
18846,92563438,2023-02-10,-118.13,830.8199999999999
18847,92563438,2023-02-13,-76.58,754.2399999999999
18848,92563438,2023-02-14,-66.88,687.3599999999999
18849,92684055,2023-01-31,,430.86
18850,92684055,2023-02-03,-165.51,265.35
18851,92684055,2023-02-11,121.16,386.51
18852,92684055,2023-02-11,59.3,445.81
18853,92684055,2023-02-13,-63.47,382.34000000000003
18854,92750088,2023-01-31,,560.4
18855,92750088,2023-02-01,-1069.7,-509.30000000000007
18856,92750088,2023-02-04,199.36,-309.94000000000005
18857,92750088,2023-02-05,149.93,-160.01000000000005
18858,92750088,2023-02-06,66.17,-93.84000000000005
18859,92750088,2023-02-07,104.75,10.909999999999954
18860,92770567,2023-01-31,,949.66
18861,92770567,2023-02-01,-120.09,829.5699999999999
18862,92770567,2023-02-04,-68.76,760.81
18863,92770567,2023-02-05,-39.31,721.5
18864,92770567,2023-02-06,-162.2,559.3
18865,92770567,2023-02-07,135.62,694.92
18866,92770567,2023-02-07,-102.52,592.4
18867,92770567,2023-02-13,136.98,729.3799999999999
18868,92770567,2023-02-13,-33.75,695.6299999999999
18869,92770567,2023-02-13,-144.25,551.3799999999999
18870,92840827,2023-01-31,,403.77
18871,92840827,2023-02-03,106.35,510.12
18872,92840827,2023-02-10,82.0,592.12
18873,92840827,2023-02-13,-78.01,514.11
18874,92840827,2023-02-13,-157.41,356.7
18875,92872571,2023-01-31,,933.03
18876,92872571,2023-02-01,96.06,1029.09
18877,92872571,2023-02-05,89.62,1118.71
18878,92872571,2023-02-09,-50.78,1067.93
18879,92872571,2023-02-12,233.91,1301.84
18880,92872571,2023-02-14,124.26,1426.1
18881,92898446,2023-01-31,,64.49
18882,92898446,2023-02-07,184.29,248.77999999999997
18883,92898446,2023-02-07,41.35,290.13
18884,92898446,2023-02-07,1.77,291.9
18885,92898446,2023-02-08,-46.43,245.47
18886,92898446,2023-02-09,6.95,252.42000000000002
18887,92898446,2023-02-09,-132.58,119.84
18888,92898446,2023-02-12,81.83,201.67000000000002
18889,92910876,2023-01-31,,643.19
18890,92910876,2023-02-04,-8.85,634.34
18891,92910876,2023-02-05,-59.2,575.1400000000001
18892,92910876,2023-02-07,173.79,748.9300000000001
18893,92910876,2023-02-11,-85.36,663.57
18894,92910876,2023-02-14,100.7,764.27
18895,92910876,2023-02-14,-86.73,677.5400000000001
18896,92920645,2023-01-31,,644.88
18897,92920645,2023-02-10,-35.64,609.24
18898,92920645,2023-02-12,-157.87,451.37
18899,92931020,2023-01-31,,754.11
18900,92931020,2023-02-02,-153.04,601.07
18901,92931020,2023-02-04,-34.82,566.25
18902,92931020,2023-02-05,-815.7,-249.45000000000005
18903,92931020,2023-02-06,48.31,-201.14000000000004
18904,92931020,2023-02-09,73.42,-127.72000000000004
18905,92931020,2023-02-10,136.1,8.379999999999953
18906,92931020,2023-02-11,-1742.7,-1734.3200000000002
18907,92931020,2023-02-12,-120.86,-1855.18
18908,92931020,2023-02-13,-77.95,-1933.13
18909,92943637,2023-01-31,,28.23
18910,92943637,2023-02-02,-140.57,-112.33999999999999
18911,92943637,2023-02-03,88.94,-23.39999999999999
18912,92943637,2023-02-05,-76.04,-99.44
18913,92943637,2023-02-08,-76.65,-176.09
18914,92943637,2023-02-10,-110.9,-286.99
18915,92944470,2023-01-31,,445.48
18916,92944470,2023-02-01,152.59,598.07
18917,92944470,2023-02-06,100.9,698.97
18918,92944470,2023-02-10,-103.91,595.0600000000001
18919,92944470,2023-02-12,110.14,705.2
18920,92963966,2023-01-31,,983.65
18921,92963966,2023-02-01,3.04,986.6899999999999
18922,92963966,2023-02-06,90.05,1076.74
18923,93009261,2023-01-31,,675.04
18924,93009261,2023-02-02,100.36,775.4
18925,93009261,2023-02-05,119.42,894.8199999999999
18926,93009261,2023-02-05,65.1,959.92
18927,93009261,2023-02-06,1695.0,2654.92
18928,93009261,2023-02-07,-108.88,2546.04
18929,93009261,2023-02-08,1169.6,3715.64
18930,93009261,2023-02-09,-76.74,3638.9
18931,93009261,2023-02-09,-97.8,3541.1
18932,93009261,2023-02-10,147.51,3688.6099999999997
18933,93009261,2023-02-10,93.3,3781.91
18934,93009261,2023-02-10,-213.83,3568.08
18935,93009261,2023-02-13,125.85,3693.93
18936,93039862,2023-01-31,,806.99
18937,93039862,2023-02-02,61.2,868.19
18938,93039862,2023-02-03,27.83,896.02
18939,93039862,2023-02-07,-66.88,829.14
18940,93039862,2023-02-09,-132.48,696.6600000000001
18941,93039862,2023-02-10,118.13,814.79
18942,93039862,2023-02-14,82.7,897.49
18943,93076057,2023-01-31,,218.56
18944,93076057,2023-02-02,143.82,362.38
18945,93076057,2023-02-04,87.35,449.73
18946,93128216,2023-01-31,,834.73
18947,93128216,2023-02-03,-10.64,824.09
18948,93128216,2023-02-03,-144.61,679.48
18949,93128216,2023-02-10,-44.74,634.74
18950,93128216,2023-02-11,168.92,803.66
18951,93128216,2023-02-14,-136.93,666.73
18952,93147630,2023-01-31,,403.93
18953,93147630,2023-02-07,148.81,552.74
18954,93147630,2023-02-11,-116.92,435.82
18955,93147630,2023-02-13,130.18,566.0
18956,93147630,2023-02-13,-136.72,429.28
18957,93192347,2023-01-31,,298.01
18958,93192347,2023-02-01,-1277.2,-979.19
18959,93192347,2023-02-04,158.04,-821.1500000000001
18960,93192347,2023-02-04,-126.02,-947.1700000000001
18961,93192347,2023-02-05,51.72,-895.45
18962,93192347,2023-02-08,92.59,-802.86
18963,93192347,2023-02-09,1325.7,522.84
18964,93192347,2023-02-12,-2147.9,-1625.06
18965,93192347,2023-02-14,-171.25,-1796.31
18966,93192347,2023-02-14,-626.8,-2423.1099999999997
18967,93248179,2023-01-31,,376.57
18968,93248179,2023-02-01,-27.36,349.21
18969,93248179,2023-02-01,-130.11,219.09999999999997
18970,93248179,2023-02-04,182.66,401.76
18971,93306742,2023-01-31,,388.54
18972,93306742,2023-02-11,181.51,570.05
18973,93306742,2023-02-13,61.83,631.88
18974,93306742,2023-02-13,43.87,675.75
18975,93325549,2023-01-31,,161.45
18976,93325549,2023-02-01,177.63,339.08
18977,93325549,2023-02-05,790.5,1129.58
18978,93325549,2023-02-08,168.29,1297.87
18979,93325549,2023-02-10,106.29,1404.1599999999999
18980,93325549,2023-02-11,-68.2,1335.96
18981,93325549,2023-02-14,79.28,1415.24
18982,93346040,2023-01-31,,816.07
18983,93346040,2023-02-01,-69.18,746.8900000000001
18984,93346040,2023-02-06,-12.77,734.12
18985,93346040,2023-02-07,10.31,744.4300000000001
18986,93346040,2023-02-07,-135.7,608.73
18987,93346040,2023-02-07,-814.4,-205.66999999999996
18988,93346040,2023-02-08,153.79,-51.87999999999997
18989,93346040,2023-02-09,118.46,66.58000000000003
18990,93346040,2023-02-10,118.13,184.71000000000004
18991,93349543,2023-01-31,,329.45
18992,93349543,2023-02-01,-122.63,206.82
18993,93349543,2023-02-03,-103.43,103.38999999999999
18994,93349543,2023-02-04,-118.6,-15.210000000000008
18995,93349543,2023-02-05,66.8,51.58999999999999
18996,93349543,2023-02-05,-86.14,-34.55000000000001
18997,93355755,2023-01-31,,753.84
18998,93355755,2023-02-03,-49.54,704.3000000000001
18999,93355755,2023-02-09,104.28,808.58
19000,93355755,2023-02-10,-11.73,796.85
19001,93388304,2023-01-31,,73.0
19002,93388304,2023-02-04,162.79,235.79
19003,93388304,2023-02-04,66.05,301.84
19004,93388304,2023-02-08,38.91,340.75
19005,93388304,2023-02-09,157.3,498.05
19006,93388304,2023-02-11,-3.02,495.03000000000003
19007,93388304,2023-02-13,142.04,637.0699999999999
19008,93409343,2023-01-31,,748.45
19009,93409343,2023-02-01,830.7,1579.15
19010,93409343,2023-02-05,-81.2,1497.95
19011,93409343,2023-02-06,-66.17,1431.7800000000002
19012,93409343,2023-02-08,94.16,1525.94
19013,93409343,2023-02-12,-110.2,1415.74
19014,93429066,2023-01-31,,652.04
19015,93429066,2023-02-04,-146.82,505.21999999999997
19016,93429066,2023-02-05,131.36,636.5799999999999
19017,93429066,2023-02-05,-149.41,487.16999999999996
19018,93429066,2023-02-12,-96.27,390.9
19019,93443317,2023-01-31,,305.29
19020,93443317,2023-02-01,124.69,429.98
19021,93443317,2023-02-02,94.47,524.45
19022,93443317,2023-02-03,-141.16,383.29
19023,93443317,2023-02-04,87.13,470.42
19024,93446276,2023-01-31,,184.74
19025,93446276,2023-02-01,187.15,371.89
19026,93446276,2023-02-01,89.8,461.69
19027,93446276,2023-02-01,-142.15,319.54
19028,93446276,2023-02-02,701.1,1020.6400000000001
19029,93446276,2023-02-02,162.35,1182.99
19030,93446276,2023-02-02,-95.1,1087.8899999999999
19031,93446276,2023-02-05,-106.71,981.18
19032,93446276,2023-02-07,-141.05,840.13
19033,93446276,2023-02-09,1679.2,2519.33
19034,93446276,2023-02-10,154.12,2673.4500000000003
19035,93529019,2023-01-31,,463.32
19036,93529019,2023-02-04,157.05,620.37
19037,93529019,2023-02-05,94.84,715.21
19038,93529019,2023-02-06,160.08,875.29
19039,93529019,2023-02-06,65.08,940.37
19040,93529019,2023-02-07,184.95,1125.32
19041,93529019,2023-02-08,-59.4,1065.92
19042,93529019,2023-02-09,-111.83,954.09
19043,93529019,2023-02-10,-82.73,871.36
19044,93529019,2023-02-11,1507.4,2378.76
19045,93529019,2023-02-14,-157.14,2221.6200000000003
19046,93559470,2023-01-31,,210.7
19047,93559470,2023-02-01,-126.64,84.05999999999999
19048,93559470,2023-02-05,64.51,148.57
19049,93559470,2023-02-05,-749.9,-601.3299999999999
19050,93559470,2023-02-08,162.59,-438.74
19051,93559470,2023-02-08,-107.7,-546.44
19052,93559470,2023-02-09,-150.22,-696.6600000000001
19053,93559470,2023-02-10,73.99,-622.6700000000001
19054,93559470,2023-02-10,-86.61,-709.28
19055,93564856,2023-01-31,,234.66
19056,93564856,2023-02-01,117.24,351.9
19057,93564856,2023-02-06,93.76,445.65999999999997
19058,93564856,2023-02-09,97.55,543.21
19059,93564856,2023-02-10,67.2,610.41
19060,93564856,2023-02-11,119.87,730.28
19061,93564856,2023-02-12,1690.9,2421.1800000000003
19062,93564856,2023-02-14,-96.41,2324.77
19063,93569124,2023-01-31,,221.11
19064,93569124,2023-02-10,156.63,377.74
19065,93569124,2023-02-11,3.02,380.76
19066,93569124,2023-02-14,-80.98,299.78
19067,93624474,2023-01-31,,622.14
19068,93624474,2023-02-02,114.87,737.01
19069,93624474,2023-02-03,85.3,822.31
19070,93624474,2023-02-04,80.51,902.8199999999999
19071,93624474,2023-02-04,-31.94,870.88
19072,93624474,2023-02-09,-940.9,-70.01999999999998
19073,93624474,2023-02-10,-57.04,-127.05999999999997
19074,93624474,2023-02-11,1058.7,931.6400000000001
19075,93624474,2023-02-14,93.52,1025.16
19076,93630048,2023-01-31,,317.95
19077,93630048,2023-02-02,35.9,353.84999999999997
19078,93630048,2023-02-03,-56.07,297.78
19079,93630048,2023-02-03,-61.29,236.48999999999998
19080,93630048,2023-02-14,34.96,271.45
19081,93630048,2023-02-14,-66.36,205.08999999999997
19082,93707181,2023-01-31,,321.91
19083,93707181,2023-02-01,99.63,421.54
19084,93707181,2023-02-03,144.82,566.36
19085,93707181,2023-02-05,87.06,653.4200000000001
19086,93745446,2023-01-31,,574.89
19087,93745446,2023-02-02,787.6,1362.49
19088,93745446,2023-02-05,177.67,1540.16
19089,93745446,2023-02-08,136.68,1676.84
19090,93745446,2023-02-09,50.28,1727.12
19091,93745446,2023-02-10,-1275.3,451.82000000000016
19092,93745446,2023-02-12,94.0,545.8200000000002
19093,93745446,2023-02-12,-64.01,481.8100000000002
19094,93745446,2023-02-12,-91.07,390.7400000000002
19095,93745446,2023-02-13,-185.27,205.47000000000014
19096,93747938,2023-01-31,,724.31
19097,93747938,2023-02-07,-1076.8,-352.49
19098,93747938,2023-02-08,55.57,-296.92
19099,93747938,2023-02-09,-158.5,-455.42
19100,93747938,2023-02-10,-59.31,-514.73
19101,93840154,2023-01-31,,159.7
19102,93840154,2023-02-05,-94.38,65.32
19103,93840154,2023-02-08,114.36,179.68
19104,93840154,2023-02-10,-90.78,88.89999999999999
19105,93840154,2023-02-14,99.95,188.85
19106,93840154,2023-02-14,-22.59,166.26
19107,93932516,2023-01-31,,575.82
19108,93932516,2023-02-02,-110.52,465.30000000000007
19109,93932516,2023-02-05,-859.9,-394.5999999999999
19110,93932516,2023-02-07,132.98,-261.6199999999999
19111,93932516,2023-02-07,-36.15,-297.7699999999999
19112,93932516,2023-02-08,217.58,-80.18999999999991
19113,93932516,2023-02-08,-15.71,-95.89999999999992
19114,93932516,2023-02-09,105.71,9.810000000000088
19115,93932516,2023-02-11,-62.36,-52.54999999999991
19116,93932516,2023-02-13,-153.14,-205.68999999999988
19117,93981472,2023-01-31,,175.68
19118,93981472,2023-02-02,1298.8,1474.48
19119,93981472,2023-02-05,178.08,1652.56
19120,93981472,2023-02-08,114.16,1766.72
19121,93981472,2023-02-08,-597.4,1169.3200000000002
19122,93981472,2023-02-10,131.62,1300.94
19123,93981472,2023-02-10,108.85,1409.79
19124,93981472,2023-02-10,-82.23,1327.56
19125,93981472,2023-02-12,-190.17,1137.39
19126,93981472,2023-02-13,-104.7,1032.69
19127,93981472,2023-02-14,-135.14,897.5500000000001
19128,94044891,2023-01-31,,367.77
19129,94044891,2023-02-03,123.6,491.37
19130,94044891,2023-02-05,-102.47,388.9
19131,94044891,2023-02-06,57.47,446.37
19132,94044891,2023-02-13,-112.88,333.49
19133,94060198,2023-01-31,,309.9
19134,94060198,2023-02-01,-1663.4,-1353.5
19135,94060198,2023-02-02,-166.1,-1519.6
19136,94060198,2023-02-03,-103.32,-1622.92
19137,94060198,2023-02-05,1317.7,-305.22
19138,94060198,2023-02-09,-82.05,-387.27000000000004
19139,94060198,2023-02-10,145.86,-241.41000000000003
19140,94060198,2023-02-10,59.66,-181.75000000000003
19141,94060198,2023-02-13,47.89,-133.86
19142,94082779,2023-01-31,,49.87
19143,94082779,2023-02-03,-76.42,-26.550000000000004
19144,94082779,2023-02-06,89.28,62.73
19145,94082779,2023-02-13,127.51,190.24
19146,94096082,2023-01-31,,342.2
19147,94096082,2023-02-05,159.46,501.65999999999997
19148,94096082,2023-02-09,-134.28,367.38
19149,94096082,2023-02-13,445.8,813.1800000000001
19150,94106013,2023-01-31,,844.86
19151,94106013,2023-02-04,87.65,932.51
19152,94106013,2023-02-04,58.55,991.0600000000001
19153,94106013,2023-02-07,119.45,1110.51
19154,94106013,2023-02-12,-94.08,1016.4300000000001
19155,94106013,2023-02-14,148.07,1164.5
19156,94163785,2023-01-31,,953.91
19157,94163785,2023-02-03,886.3,1840.21
19158,94163785,2023-02-04,-100.25,1739.96
19159,94163785,2023-02-06,-115.81,1624.1499999999999
19160,94163785,2023-02-07,-118.34,1505.81
19161,94163785,2023-02-12,-100.49,1405.32
19162,94163785,2023-02-14,-166.87,1238.4499999999998
19163,94171142,2023-01-31,,261.94
19164,94171142,2023-02-01,-123.08,138.86
19165,94171142,2023-02-02,148.35,287.21
19166,94171142,2023-02-02,-133.09,154.11999999999998
19167,94171142,2023-02-08,-522.3,-368.17999999999995
19168,94171142,2023-02-09,-65.15,-433.3299999999999
19169,94171142,2023-02-11,17.89,-415.43999999999994
19170,94171142,2023-02-11,-149.19,-564.6299999999999
19171,94171142,2023-02-14,-483.2,-1047.83
19172,94200289,2023-01-31,,207.5
19173,94200289,2023-02-05,-27.36,180.14
19174,94200289,2023-02-05,-123.78,56.36
19175,94200289,2023-02-06,178.95,235.31
19176,94200289,2023-02-06,-15.22,220.09
19177,94200289,2023-02-07,-70.76,149.32999999999998
19178,94200289,2023-02-12,153.75,303.08
19179,94200289,2023-02-14,-131.36,171.71999999999997
19180,94208888,2023-01-31,,97.84
19181,94208888,2023-02-03,-164.94,-67.1
19182,94208888,2023-02-04,109.5,42.400000000000006
19183,94208888,2023-02-11,-1944.9,-1902.5
19184,94208888,2023-02-12,-109.26,-2011.76
19185,94212460,2023-01-31,,215.27
19186,94228831,2023-01-31,,277.02
19187,94228831,2023-02-02,140.61,417.63
19188,94228831,2023-02-03,-131.74,285.89
19189,94228831,2023-02-06,109.48,395.37
19190,94228831,2023-02-06,-110.54,284.83
19191,94228831,2023-02-12,176.03,460.86
19192,94247629,2023-01-31,,308.63
19193,94247629,2023-02-04,39.76,348.39
19194,94247629,2023-02-05,105.91,454.29999999999995
19195,94247629,2023-02-07,-1738.7,-1284.4
19196,94247629,2023-02-12,110.2,-1174.2
19197,94331180,2023-01-31,,89.31
19198,94331180,2023-02-01,-54.98,34.330000000000005
19199,94331180,2023-02-07,101.44,135.77
19200,94331180,2023-02-11,-105.42,30.35000000000001
19201,94331180,2023-02-13,-70.85,-40.499999999999986
19202,94342965,2023-01-31,,282.51
19203,94342965,2023-02-02,107.51,390.02
19204,94342965,2023-02-05,-159.07,230.95
19205,94342965,2023-02-09,1208.0,1438.95
19206,94342965,2023-02-12,-133.51,1305.44
19207,94365401,2023-01-31,,81.28
19208,94365401,2023-02-02,37.62,118.9
19209,94365401,2023-02-03,-101.25,17.650000000000006
19210,94365401,2023-02-08,93.77,111.42
19211,94365401,2023-02-11,122.21,233.63
19212,94365401,2023-02-12,-31.2,202.43
19213,94409941,2023-01-31,,642.83
19214,94409941,2023-02-01,-92.51,550.32
19215,94409941,2023-02-04,629.0,1179.3200000000002
19216,94409941,2023-02-12,66.55,1245.8700000000001
19217,94409941,2023-02-14,-152.69,1093.18
19218,94409941,2023-02-14,-867.5,225.68000000000006
19219,94437482,2023-01-31,,415.91
19220,94437482,2023-02-06,94.32,510.23
19221,94437482,2023-02-06,-143.44,366.79
19222,94437482,2023-02-09,-53.97,312.82000000000005
19223,94437482,2023-02-10,-46.55,266.27000000000004
19224,94437482,2023-02-14,950.7,1216.97
19225,94457332,2023-01-31,,764.02
19226,94457332,2023-02-05,-107.79,656.23
19227,94457332,2023-02-06,146.96,803.19
19228,94457332,2023-02-14,-33.66,769.53
19229,94493359,2023-01-31,,17.96
19230,94493359,2023-02-03,-133.41,-115.44999999999999
19231,94493359,2023-02-06,-112.02,-227.46999999999997
19232,94493359,2023-02-07,-171.17,-398.64
19233,94493359,2023-02-10,-83.93,-482.57
19234,94493359,2023-02-11,129.35,-353.22
19235,94493359,2023-02-11,-102.91,-456.13
19236,94493359,2023-02-12,-106.86,-562.99
19237,94525216,2023-01-31,,635.22
19238,94525216,2023-02-02,44.56,679.78
19239,94525216,2023-02-05,-115.1,564.6800000000001
19240,94525216,2023-02-07,132.14,696.82
19241,94525216,2023-02-07,97.95,794.77
19242,94525216,2023-02-07,-183.44,611.33
19243,94525216,2023-02-09,190.82,802.1500000000001
19244,94525216,2023-02-10,139.51,941.6600000000001
19245,94566140,2023-01-31,,31.61
19246,94566140,2023-02-04,-54.15,-22.54
19247,94566140,2023-02-06,-128.91,-151.45
19248,94566140,2023-02-07,38.88,-112.57
19249,94566140,2023-02-07,-152.23,-264.79999999999995
19250,94566140,2023-02-09,44.94,-219.85999999999999
19251,94566140,2023-02-13,-104.5,-324.36
19252,94566140,2023-02-14,38.12,-286.24
19253,94615411,2023-01-31,,147.21
19254,94615411,2023-02-02,-1015.8,-868.5899999999999
19255,94615411,2023-02-04,151.32,-717.27
19256,94615411,2023-02-08,71.98,-645.29
19257,94615411,2023-02-09,176.97,-468.31999999999994
19258,94615411,2023-02-09,-109.51,-577.8299999999999
19259,94615411,2023-02-10,-79.77,-657.5999999999999
19260,94615411,2023-02-12,138.36,-519.2399999999999
19261,94615411,2023-02-12,-93.78,-613.02
19262,94629877,2023-01-31,,908.69
19263,94629877,2023-02-03,65.94,974.6300000000001
19264,94629877,2023-02-04,884.9,1859.53
19265,94629877,2023-02-04,-686.5,1173.03
19266,94629877,2023-02-04,-1031.4,141.62999999999988
19267,94629877,2023-02-05,-112.93,28.699999999999875
19268,94629877,2023-02-09,899.8,928.4999999999998
19269,94629877,2023-02-10,181.71,1110.2099999999998
19270,94629877,2023-02-12,72.46,1182.6699999999998
19271,94635297,2023-01-31,,353.43
19272,94635297,2023-02-02,-25.81,327.62
19273,94635297,2023-02-03,115.87,443.49
19274,94635297,2023-02-04,-92.27,351.22
19275,94635297,2023-02-05,82.64,433.86
19276,94635297,2023-02-08,-76.81,357.05
19277,94645169,2023-01-31,,854.22
19278,94645169,2023-02-01,-98.05,756.1700000000001
19279,94645169,2023-02-03,-12.0,744.1700000000001
19280,94645169,2023-02-07,125.24,869.4100000000001
19281,94645169,2023-02-07,-74.77,794.64
19282,94645169,2023-02-07,-133.96,660.6800000000001
19283,94645169,2023-02-11,-173.97,486.71000000000004
19284,94645169,2023-02-12,128.94,615.65
19285,94645169,2023-02-13,-127.51,488.14
19286,94645169,2023-02-14,-0.73,487.41
19287,94660017,2023-01-31,,107.29
19288,94660017,2023-02-01,-115.14,-7.849999999999994
19289,94660017,2023-02-10,86.75,78.9
19290,94660017,2023-02-12,41.61,120.51
19291,94660017,2023-02-13,123.64,244.15
19292,94660017,2023-02-13,47.03,291.18
19293,94677908,2023-01-31,,343.33
19294,94677908,2023-02-01,115.41,458.74
19295,94677908,2023-02-03,117.22,575.96
19296,94677908,2023-02-03,88.14,664.1
19297,94677908,2023-02-04,-106.07,558.03
19298,94677908,2023-02-07,-121.46,436.57
19299,94677908,2023-02-08,-143.85,292.72
19300,94677908,2023-02-09,138.19,430.90999999999997
19301,94677908,2023-02-12,-1534.6,-1103.69
19302,94677908,2023-02-13,170.79,-932.9000000000001
19303,94716844,2023-01-31,,605.84
19304,94716844,2023-02-01,-102.9,502.94000000000005
19305,94716844,2023-02-04,168.29,671.23
19306,94716844,2023-02-04,-90.09,581.14
19307,94716844,2023-02-06,-58.17,522.97
19308,94716844,2023-02-08,123.06,646.03
19309,94716844,2023-02-10,62.94,708.97
19310,94716844,2023-02-11,-62.9,646.07
19311,94716844,2023-02-13,80.74,726.81
19312,94716844,2023-02-13,-101.87,624.94
19313,94716844,2023-02-14,198.2,823.14
19314,94716844,2023-02-14,94.45,917.59
19315,94729530,2023-01-31,,635.76
19316,94729530,2023-02-01,136.75,772.51
19317,94729530,2023-02-01,62.95,835.46
19318,94729530,2023-02-01,58.96,894.42
19319,94729530,2023-02-10,-142.57,751.85
19320,94729530,2023-02-13,163.99,915.84
19321,94729530,2023-02-13,104.5,1020.34
19322,94732589,2023-01-31,,697.54
19323,94732589,2023-02-02,-90.91,606.63
19324,94732589,2023-02-03,-139.6,467.03
19325,94732589,2023-02-03,-180.87,286.15999999999997
19326,94732589,2023-02-04,102.44,388.59999999999997
19327,94732589,2023-02-06,124.22,512.8199999999999
19328,94732589,2023-02-06,47.78,560.5999999999999
19329,94732589,2023-02-14,-120.42,440.17999999999995
19330,94748860,2023-01-31,,630.6
19331,94748860,2023-02-04,44.05,674.65
19332,94748860,2023-02-08,119.07,793.72
19333,94748860,2023-02-08,31.3,825.02
19334,94796578,2023-01-31,,700.49
19335,94796578,2023-02-01,-1057.7,-357.21000000000004
19336,94796578,2023-02-03,65.14,-292.07000000000005
19337,94796578,2023-02-03,40.39,-251.68000000000004
19338,94796578,2023-02-05,112.69,-138.99000000000004
19339,94796578,2023-02-06,110.83,-28.16000000000004
19340,94796578,2023-02-06,84.58,56.41999999999996
19341,94796578,2023-02-07,-169.36,-112.94000000000005
19342,94796578,2023-02-08,-167.11,-280.05000000000007
19343,94796578,2023-02-10,249.81,-30.240000000000066
19344,94796578,2023-02-12,48.09,17.849999999999937
19345,94796578,2023-02-13,34.3,52.149999999999935
19346,94796578,2023-02-14,79.54,131.68999999999994
19347,94796578,2023-02-14,68.12,199.80999999999995
19348,94814824,2023-01-31,,716.75
19349,94814824,2023-02-05,159.3,876.05
19350,94814824,2023-02-07,11.37,887.42
19351,94814824,2023-02-09,-87.99,799.4300000000001
19352,94814824,2023-02-13,-119.69,679.74
19353,94814824,2023-02-14,60.02,739.76
19354,94893604,2023-01-31,,289.19
19355,94893604,2023-02-01,122.07,411.26
19356,94893604,2023-02-02,-140.27,270.99
19357,94893604,2023-02-04,150.79,421.78
19358,94893604,2023-02-08,90.52,512.3
19359,94893604,2023-02-12,104.51,616.81
19360,94935991,2023-01-31,,645.53
19361,94935991,2023-02-03,-109.74,535.79
19362,94935991,2023-02-04,118.19,653.98
19363,94935991,2023-02-04,7.06,661.04
19364,94935991,2023-02-09,84.03,745.0699999999999
19365,94935991,2023-02-10,116.72,861.79
19366,94935991,2023-02-12,1015.8,1877.59
19367,94935991,2023-02-14,-36.6,1840.99
19368,94973297,2023-01-31,,761.68
19369,94973297,2023-02-04,-112.13,649.55
19370,94973297,2023-02-06,-81.6,567.9499999999999
19371,94973297,2023-02-09,-69.64,498.30999999999995
19372,94973297,2023-02-10,1275.3,1773.61
19373,94973297,2023-02-10,-73.16,1700.4499999999998
19374,94973297,2023-02-14,-1365.0,335.4499999999998
19375,95009921,2023-01-31,,658.77
19376,95009921,2023-02-01,124.27,783.04
19377,95009921,2023-02-02,103.03,886.0699999999999
19378,95009921,2023-02-04,153.28,1039.35
19379,95009921,2023-02-05,158.54,1197.8899999999999
19380,95009921,2023-02-06,87.21,1285.1
19381,95009921,2023-02-08,94.29,1379.3899999999999
19382,95009921,2023-02-09,-144.93,1234.46
19383,95009921,2023-02-12,87.73,1322.19
19384,95009921,2023-02-14,188.3,1510.49
19385,95009921,2023-02-14,110.66,1621.1499999999999
19386,95009921,2023-02-14,-111.08,1510.07
19387,95060122,2023-01-31,,771.61
19388,95060122,2023-02-03,-116.84,654.77
19389,95060122,2023-02-03,-119.68,535.09
19390,95060122,2023-02-04,152.03,687.12
19391,95060122,2023-02-06,-633.0,54.120000000000005
19392,95060122,2023-02-10,70.94,125.06
19393,95060122,2023-02-10,-65.02,60.040000000000006
19394,95060122,2023-02-10,-163.3,-103.26
19395,95060122,2023-02-14,-29.41,-132.67000000000002
19396,95081571,2023-01-31,,712.07
19397,95081571,2023-02-01,-76.26,635.8100000000001
19398,95081571,2023-02-02,-88.57,547.24
19399,95081571,2023-02-02,-125.99,421.25000000000006
19400,95081571,2023-02-07,17.58,438.83000000000004
19401,95081571,2023-02-07,-168.17,270.6600000000001
19402,95081571,2023-02-08,1330.7,1601.3600000000001
19403,95081571,2023-02-08,60.7,1662.0600000000002
19404,95081571,2023-02-09,156.71,1818.7700000000002
19405,95081571,2023-02-13,104.02,1922.7900000000002
19406,95113741,2023-01-31,,102.12
19407,95113741,2023-02-02,113.73,215.85000000000002
19408,95113741,2023-02-03,189.03,404.88
19409,95113741,2023-02-07,171.53,576.41
19410,95113741,2023-02-08,63.41,639.8199999999999
19411,95213279,2023-01-31,,441.59
19412,95213279,2023-02-04,-7.06,434.53
19413,95213279,2023-02-04,-85.93,348.59999999999997
19414,95213279,2023-02-05,-33.85,314.74999999999994
19415,95213279,2023-02-07,-50.49,264.26
19416,95213279,2023-02-08,-2591.7,-2327.4399999999996
19417,95213279,2023-02-11,-96.92,-2424.3599999999997
19418,95258436,2023-01-31,,59.55
19419,95258436,2023-02-02,139.25,198.8
19420,95258436,2023-02-02,-89.87,108.93
19421,95258436,2023-02-02,-158.32,-49.389999999999986
19422,95258436,2023-02-06,75.55,26.16000000000001
19423,95258436,2023-02-09,141.82,167.98000000000002
19424,95258436,2023-02-09,112.05,280.03000000000003
19425,95258436,2023-02-10,121.81,401.84000000000003
19426,95258436,2023-02-14,963.5,1365.3400000000001
19427,95258436,2023-02-14,-101.59,1263.75
19428,95258436,2023-02-14,-105.98,1157.77
19429,95274344,2023-01-31,,990.84
19430,95274344,2023-02-05,159.79,1150.63
19431,95274344,2023-02-05,-165.04,985.59
19432,95274344,2023-02-05,-962.0,23.590000000000032
19433,95274344,2023-02-06,-99.03,-75.43999999999997
19434,95274344,2023-02-08,123.12,47.680000000000035
19435,95274344,2023-02-14,-85.48,-37.79999999999997
19436,95277712,2023-01-31,,235.91
19437,95277712,2023-02-03,83.69,319.6
19438,95277712,2023-02-04,-88.83,230.76999999999998
19439,95277712,2023-02-05,99.25,330.02
19440,95277712,2023-02-07,-123.68,206.33999999999997
19441,95277712,2023-02-11,-133.67,72.67000000000002
19442,95277712,2023-02-12,-934.7,-862.03
19443,95307629,2023-01-31,,502.48
19444,95307629,2023-02-01,89.15,591.63
19445,95307629,2023-02-05,41.65,633.28
19446,95307629,2023-02-09,-1324.2,-690.9200000000001
19447,95307629,2023-02-12,-68.37,-759.2900000000001
19448,95307629,2023-02-14,171.69,-587.6000000000001
19449,95307629,2023-02-14,31.7,-555.9000000000001
19450,95309911,2023-01-31,,171.61
19451,95309911,2023-02-01,-82.42,89.19000000000001
19452,95309911,2023-02-02,110.35,199.54000000000002
19453,95309911,2023-02-05,39.2,238.74
19454,95309911,2023-02-06,154.75,393.49
19455,95309911,2023-02-06,32.34,425.83000000000004
19456,95309911,2023-02-09,363.8,789.63
19457,95309911,2023-02-09,-97.89,691.74
19458,95309911,2023-02-12,109.26,801.0
19459,95356167,2023-01-31,,170.2
19460,95356167,2023-02-08,-38.77,131.42999999999998
19461,95356167,2023-02-10,28.58,160.01
19462,95356167,2023-02-12,103.79,263.79999999999995
19463,95356167,2023-02-14,123.85,387.65
19464,95367755,2023-01-31,,926.51
19465,95367755,2023-02-04,-622.4,304.11
19466,95367755,2023-02-07,70.62,374.73
19467,95367755,2023-02-08,-130.71,244.02
19468,95367755,2023-02-13,63.17,307.19
19469,95367755,2023-02-13,-101.66,205.53000000000003
19470,95390412,2023-01-31,,553.04
19471,95390412,2023-02-01,-149.8,403.23999999999995
19472,95390412,2023-02-02,-52.25,350.98999999999995
19473,95390412,2023-02-03,79.35,430.3399999999999
19474,95390412,2023-02-07,98.57,528.91
19475,95390412,2023-02-09,-1176.8,-647.89
19476,95390412,2023-02-11,-100.23,-748.12
19477,95412973,2023-01-31,,892.85
19478,95412973,2023-02-02,-200.43,692.4200000000001
19479,95412973,2023-02-10,-163.93,528.49
19480,95412973,2023-02-13,-33.78,494.71000000000004
19481,95446510,2023-01-31,,581.43
19482,95446510,2023-02-04,121.95,703.38
19483,95446510,2023-02-04,88.15,791.53
19484,95446510,2023-02-04,-200.42,591.1099999999999
19485,95446510,2023-02-06,-45.01,546.0999999999999
19486,95446510,2023-02-08,-129.87,416.22999999999996
19487,95446510,2023-02-13,-96.41,319.81999999999994
19488,95452518,2023-01-31,,390.37
19489,95452518,2023-02-06,172.27,562.64
19490,95452518,2023-02-08,-110.07,452.57000000000005
19491,95452518,2023-02-12,-86.17,366.40000000000003
19492,95467370,2023-01-31,,307.45
19493,95467370,2023-02-02,1273.1,1580.55
19494,95467370,2023-02-03,31.0,1611.55
19495,95467370,2023-02-04,50.69,1662.24
19496,95467370,2023-02-05,-20.31,1641.93
19497,95467370,2023-02-06,-124.17,1517.76
19498,95467370,2023-02-09,-73.6,1444.1599999999999
19499,95467370,2023-02-10,162.32,1606.48
19500,95527674,2023-01-31,,688.37
19501,95527674,2023-02-01,164.94,853.31
19502,95527674,2023-02-03,-145.97,707.34
19503,95527674,2023-02-07,-86.51,620.83
19504,95527674,2023-02-09,123.88,744.71
19505,95527674,2023-02-09,-102.14,642.5699999999999
19506,95527674,2023-02-11,133.59,776.16
19507,95527674,2023-02-11,107.57,883.73
19508,95527674,2023-02-11,106.62,990.35
19509,95527674,2023-02-14,-167.84,822.51
19510,95564462,2023-01-31,,643.45
19511,95564462,2023-02-04,165.42,808.87
19512,95564462,2023-02-06,-22.99,785.88
19513,95564462,2023-02-12,78.89,864.77
19514,95600095,2023-01-31,,400.05
19515,95600095,2023-02-07,125.12,525.1700000000001
19516,95600095,2023-02-12,91.81,616.98
19517,95600095,2023-02-13,-125.16,491.82000000000005
19518,95642341,2023-01-31,,695.88
19519,95642341,2023-02-01,546.3,1242.1799999999998
19520,95642341,2023-02-05,-97.45,1144.73
19521,95642341,2023-02-07,-56.49,1088.24
19522,95642341,2023-02-10,-1375.3,-287.05999999999995
19523,95642341,2023-02-12,134.41,-152.64999999999995
19524,95642341,2023-02-13,104.51,-48.139999999999944
19525,95642341,2023-02-13,42.26,-5.879999999999946
19526,95642341,2023-02-14,-175.48,-181.35999999999993
19527,95645055,2023-01-31,,645.58
19528,95645055,2023-02-06,78.61,724.19
19529,95645055,2023-02-10,99.28,823.47
19530,95645055,2023-02-11,24.18,847.6500000000001
19531,95645055,2023-02-11,-40.71,806.94
19532,95674888,2023-01-31,,838.92
19533,95674888,2023-02-01,124.86,963.78
19534,95674888,2023-02-08,-19.59,944.1899999999999
19535,95674888,2023-02-13,1258.1,2202.29
19536,95674888,2023-02-13,77.47,2279.7599999999998
19537,95674888,2023-02-13,4.66,2284.42
19538,95674888,2023-02-13,-49.89,2234.5299999999997
19539,95674888,2023-02-14,178.46,2412.99
19540,95710324,2023-01-31,,978.16
19541,95710324,2023-02-02,-30.01,948.15
19542,95710324,2023-02-02,-82.72,865.43
19543,95710324,2023-02-09,-188.14,677.29
19544,95710324,2023-02-10,1484.2,2161.49
19545,95710324,2023-02-10,73.65,2235.14
19546,95710324,2023-02-10,-142.13,2093.01
19547,95723006,2023-01-31,,861.2
19548,95723006,2023-02-04,1084.8,1946.0
19549,95723006,2023-02-06,-83.83,1862.17
19550,95723006,2023-02-09,-96.82,1765.35
19551,95723006,2023-02-10,128.96,1894.31
19552,95723006,2023-02-10,91.88,1986.19
19553,95723006,2023-02-11,-73.66,1912.53
19554,95743658,2023-01-31,,586.9
19555,95743658,2023-02-01,58.18,645.0799999999999
19556,95743658,2023-02-02,-86.69,558.39
19557,95743658,2023-02-03,-147.01,411.38
19558,95743658,2023-02-07,934.2,1345.58
19559,95743658,2023-02-07,107.79,1453.3700000000001
19560,95743658,2023-02-07,54.63,1508.0
19561,95743658,2023-02-09,-96.52,1411.48
19562,95743658,2023-02-09,-121.16,1290.3200000000002
19563,95743658,2023-02-11,96.16,1386.48
19564,95743658,2023-02-12,27.74,1414.22
19565,95743658,2023-02-13,81.01,1495.23
19566,95759022,2023-01-31,,78.02
19567,95759022,2023-02-01,76.39,154.41
19568,95759022,2023-02-02,-28.18,126.22999999999999
19569,95759022,2023-02-05,33.85,160.07999999999998
19570,95759022,2023-02-06,179.08,339.16
19571,95759022,2023-02-09,484.0,823.1600000000001
19572,95759022,2023-02-09,-156.08,667.08
19573,95868007,2023-01-31,,974.32
19574,95868007,2023-02-01,-89.15,885.1700000000001
19575,95868007,2023-02-02,-69.41,815.76
19576,95868007,2023-02-03,-267.7,548.0600000000001
19577,95868007,2023-02-05,-134.55,413.51000000000005
19578,95868007,2023-02-06,56.08,469.59000000000003
19579,95868007,2023-02-06,-92.7,376.89000000000004
19580,95868007,2023-02-06,-95.31,281.58000000000004
19581,95868007,2023-02-07,79.32,360.90000000000003
19582,95868007,2023-02-11,-134.5,226.40000000000003
19583,95898143,2023-01-31,,197.65
19584,95898143,2023-02-05,97.37,295.02
19585,95898143,2023-02-09,-50.63,244.39000000000001
19586,95898143,2023-02-10,-782.2,-537.8100000000001
19587,95898143,2023-02-12,109.9,-427.9100000000001
19588,95993993,2023-01-31,,95.41
19589,95993993,2023-02-03,-1266.7,-1171.29
19590,95993993,2023-02-07,113.79,-1057.5
19591,95993993,2023-02-13,38.7,-1018.8
19592,95993993,2023-02-14,1137.7,118.90000000000009
19593,96050548,2023-01-31,,299.46
19594,96050548,2023-02-04,-72.83,226.63
19595,96050548,2023-02-08,125.91,352.53999999999996
19596,96050548,2023-02-09,102.32,454.85999999999996
19597,96050548,2023-02-09,-84.55,370.30999999999995
19598,96050548,2023-02-11,-107.86,262.45
19599,96051784,2023-01-31,,21.7
19600,96051784,2023-02-01,111.89,133.59
19601,96051784,2023-02-05,-1121.5,-987.91
19602,96051784,2023-02-06,99.31,-888.5999999999999
19603,96051784,2023-02-07,77.46,-811.14
19604,96051784,2023-02-13,-141.46,-952.5999999999999
19605,96121732,2023-01-31,,771.81
19606,96121732,2023-02-01,84.68,856.49
19607,96121732,2023-02-01,-101.68,754.81
19608,96121732,2023-02-04,70.76,825.5699999999999
19609,96121732,2023-02-04,-81.94,743.63
19610,96121732,2023-02-05,98.3,841.93
19611,96121732,2023-02-05,-98.3,743.63
19612,96121732,2023-02-05,-99.15,644.4799999999999
19613,96121732,2023-02-10,102.74,747.2199999999999
19614,96121732,2023-02-11,1669.7,2416.92
19615,96121732,2023-02-11,-75.16,2341.7599999999998
19616,96121732,2023-02-13,164.0,2505.7599999999998
19617,96121732,2023-02-13,99.06,2604.8199999999997
19618,96121732,2023-02-14,-164.38,2440.44
19619,96153427,2023-01-31,,24.33
19620,96153427,2023-02-01,84.08,108.41
19621,96153427,2023-02-03,120.56,228.97
19622,96153427,2023-02-07,85.35,314.32
19623,96197628,2023-01-31,,829.37
19624,96197628,2023-02-04,-104.91,724.46
19625,96197628,2023-02-08,-27.53,696.9300000000001
19626,96197628,2023-02-13,134.97,831.9
19627,96200049,2023-01-31,,959.58
19628,96200049,2023-02-01,61.23,1020.8100000000001
19629,96200049,2023-02-02,94.5,1115.31
19630,96200049,2023-02-02,28.18,1143.49
19631,96200049,2023-02-03,141.04,1284.53
19632,96200049,2023-02-03,43.6,1328.13
19633,96200049,2023-02-13,23.37,1351.5
19634,96208050,2023-01-31,,171.46
19635,96208050,2023-02-01,-48.99,122.47
19636,96208050,2023-02-01,-139.18,-16.710000000000008
19637,96208050,2023-02-08,-100.19,-116.9
19638,96208050,2023-02-09,99.18,-17.72
19639,96208050,2023-02-10,-115.74,-133.45999999999998
19640,96208050,2023-02-11,89.22,-44.239999999999995
19641,96208050,2023-02-12,92.93,48.69000000000001
19642,96224831,2023-01-31,,926.76
19643,96224831,2023-02-02,-46.46,880.3
19644,96224831,2023-02-03,107.3,987.6
19645,96224831,2023-02-06,-66.16,921.44
19646,96224831,2023-02-09,-108.36,813.08
19647,96224831,2023-02-10,168.64,981.72
19648,96224831,2023-02-11,91.93,1073.65
19649,96224831,2023-02-12,1265.1,2338.75
19650,96224831,2023-02-14,-113.07,2225.68
19651,96227490,2023-01-31,,242.11
19652,96227490,2023-02-05,118.23,360.34000000000003
19653,96227490,2023-02-07,945.2,1305.54
19654,96227490,2023-02-07,-162.51,1143.0300000000002
19655,96227490,2023-02-12,-1291.9,-148.8699999999999
19656,96227490,2023-02-13,-48.77,-197.6399999999999
19657,96227490,2023-02-14,-76.93,-274.56999999999994
19658,96236719,2023-01-31,,999.32
19659,96236719,2023-02-02,1015.8,2015.12
19660,96236719,2023-02-03,-177.67,1837.45
19661,96236719,2023-02-09,55.83,1893.28
19662,96236719,2023-02-13,1370.1,3263.38
19663,96278865,2023-01-31,,930.45
19664,96278865,2023-02-06,1069.0,1999.45
19665,96278865,2023-02-06,100.71,2100.16
19666,96278865,2023-02-07,69.22,2169.38
19667,96278865,2023-02-07,-1298.9,870.48
19668,96278865,2023-02-09,37.9,908.38
19669,96281358,2023-01-31,,463.07
19670,96281358,2023-02-06,49.54,512.61
19671,96281358,2023-02-08,163.93,676.54
19672,96281358,2023-02-11,-56.16,620.38
19673,96291927,2023-01-31,,227.22
19674,96291927,2023-02-01,79.4,306.62
19675,96291927,2023-02-03,-84.7,221.92000000000002
19676,96291927,2023-02-07,-146.76,75.16000000000003
19677,96291927,2023-02-09,-99.44,-24.279999999999973
19678,96291927,2023-02-09,-123.88,-148.15999999999997
19679,96291927,2023-02-12,148.17,0.010000000000019327
19680,96291927,2023-02-14,38.4,38.41000000000002
19681,96319450,2023-01-31,,779.16
19682,96319450,2023-02-01,186.45,965.6099999999999
19683,96319450,2023-02-09,16.12,981.7299999999999
19684,96319450,2023-02-10,-38.95,942.78
19685,96319450,2023-02-11,-207.88,734.9
19686,96319450,2023-02-13,119.69,854.5899999999999
19687,96367781,2023-01-31,,880.44
19688,96367914,2023-01-31,,528.67
19689,96367914,2023-02-09,155.69,684.3599999999999
19690,96367914,2023-02-12,-18.96,665.4
19691,96401230,2023-01-31,,21.44
19692,96401230,2023-02-01,1663.4,1684.8400000000001
19693,96401230,2023-02-02,-198.28,1486.5600000000002
19694,96401230,2023-02-03,-44.59,1441.9700000000003
19695,96401230,2023-02-03,-85.24,1356.7300000000002
19696,96401230,2023-02-07,-24.41,1332.3200000000002
19697,96401230,2023-02-08,96.33,1428.65
19698,96401230,2023-02-08,-797.2,631.45
19699,96401230,2023-02-11,-1813.6,-1182.1499999999999
19700,96510893,2023-01-31,,396.83
19701,96510893,2023-02-02,185.26,582.0899999999999
19702,96510893,2023-02-09,74.41,656.5
19703,96510893,2023-02-11,-782.2,-125.70000000000005
19704,96510893,2023-02-14,-108.65,-234.35000000000005
19705,96605778,2023-01-31,,70.72
19706,96605778,2023-02-01,-112.98,-42.260000000000005
19707,96605778,2023-02-02,-116.89,-159.15
19708,96605778,2023-02-02,-158.28,-317.43
19709,96605778,2023-02-04,-303.4,-620.8299999999999
19710,96605778,2023-02-08,697.8,76.97000000000003
19711,96605778,2023-02-09,75.39,152.36
19712,96605778,2023-02-09,51.97,204.33000000000004
19713,96605778,2023-02-09,-226.54,-22.20999999999998
19714,96649120,2023-01-31,,307.91
19715,96649120,2023-02-04,105.93,413.84000000000003
19716,96649120,2023-02-05,-46.34,367.5
19717,96649120,2023-02-05,-126.99,240.51000000000005
19718,96649120,2023-02-07,98.77,339.28000000000003
19719,96649120,2023-02-07,79.53,418.81000000000006
19720,96649120,2023-02-08,-135.91,282.90000000000003
19721,96649120,2023-02-12,-36.33,246.57000000000005
19722,96649120,2023-02-13,53.33,299.90000000000003
19723,96689242,2023-01-31,,896.22
19724,96689242,2023-02-01,45.7,941.9200000000001
19725,96689242,2023-02-03,85.62,1027.54
19726,96689242,2023-02-05,142.12,1169.66
19727,96689242,2023-02-06,-1253.1,-83.43999999999983
19728,96689242,2023-02-11,82.15,-1.2899999999998215
19729,96719450,2023-01-31,,633.74
19730,96719450,2023-02-07,-744.0,-110.25999999999999
19731,96719450,2023-02-08,118.94,8.680000000000007
19732,96719450,2023-02-08,-104.01,-95.33
19733,96719450,2023-02-10,1362.1,1266.77
19734,96719450,2023-02-10,82.33,1349.1
19735,96719450,2023-02-11,-59.16,1289.94
19736,96719450,2023-02-11,-86.86,1203.08
19737,96719450,2023-02-11,-754.3,448.78
19738,96756719,2023-01-31,,601.68
19739,96756719,2023-02-04,-69.05,532.63
19740,96756719,2023-02-05,-49.84,482.78999999999996
19741,96756719,2023-02-06,-64.62,418.16999999999996
19742,96756719,2023-02-06,-887.9,-469.73
19743,96756719,2023-02-07,113.6,-356.13
19744,96756719,2023-02-07,-155.69,-511.82000000000005
19745,96756719,2023-02-08,-104.55,-616.37
19746,96756719,2023-02-10,871.2,254.83000000000004
19747,96756719,2023-02-12,61.95,316.78000000000003
19748,96756719,2023-02-13,-154.58,162.20000000000005
19749,96837696,2023-01-31,,889.9
19750,96837696,2023-02-05,-1131.8,-241.89999999999998
19751,96837696,2023-02-07,-164.7,-406.59999999999997
19752,96837696,2023-02-08,19.11,-387.48999999999995
19753,96837696,2023-02-11,-173.7,-561.1899999999999
19754,96847078,2023-01-31,,412.48
19755,96847078,2023-02-01,105.94,518.4200000000001
19756,96847078,2023-02-02,-179.67,338.75
19757,96847078,2023-02-08,105.67,444.42
19758,96847078,2023-02-08,-24.38,420.04
19759,96847078,2023-02-10,121.67,541.71
19760,96847078,2023-02-10,-118.13,423.58000000000004
19761,96847078,2023-02-13,20.17,443.75000000000006
19762,96948178,2023-01-31,,217.26
19763,96948178,2023-02-07,86.52,303.78
19764,96948178,2023-02-07,-71.18,232.59999999999997
19765,96948178,2023-02-08,103.89,336.49
19766,96948178,2023-02-10,-80.58,255.90999999999997
19767,96948178,2023-02-12,134.36,390.27
19768,97010482,2023-01-31,,542.39
19769,97010482,2023-02-01,83.77,626.16
19770,97010482,2023-02-05,103.38,729.54
19771,97010482,2023-02-09,-41.77,687.77
19772,97010482,2023-02-13,78.01,765.78
19773,97036090,2023-01-31,,349.78
19774,97036090,2023-02-03,-161.37,188.40999999999997
19775,97036090,2023-02-04,118.37,306.78
19776,97036090,2023-02-06,86.95,393.72999999999996
19777,97036090,2023-02-09,951.0,1344.73
19778,97036090,2023-02-09,65.76,1410.49
19779,97048058,2023-01-31,,977.42
19780,97048058,2023-02-03,584.3,1561.7199999999998
19781,97048058,2023-02-03,96.94,1658.6599999999999
19782,97048058,2023-02-08,-77.23,1581.4299999999998
19783,97048058,2023-02-09,-121.34,1460.09
19784,97048058,2023-02-10,103.59,1563.6799999999998
19785,97098684,2023-01-31,,463.91
19786,97098684,2023-02-01,-0.96,462.95000000000005
19787,97098684,2023-02-03,72.77,535.72
19788,97098684,2023-02-04,76.94,612.6600000000001
19789,97098684,2023-02-05,144.38,757.04
19790,97098684,2023-02-07,-68.86,688.1800000000001
19791,97098684,2023-02-08,204.91,893.09
19792,97187999,2023-01-31,,170.66
19793,97187999,2023-02-01,43.65,214.31
19794,97187999,2023-02-03,-94.5,119.81
19795,97187999,2023-02-05,-27.88,91.93
19796,97187999,2023-02-10,-70.11,21.820000000000007
19797,97187999,2023-02-11,-9.25,12.570000000000007
19798,97187999,2023-02-13,518.3,530.87
19799,97187999,2023-02-14,-60.02,470.85
19800,97187999,2023-02-14,-725.0,-254.14999999999998
19801,97258853,2023-01-31,,348.49
19802,97258853,2023-02-01,106.33,454.82
19803,97258853,2023-02-02,1157.4,1612.22
19804,97258853,2023-02-03,78.66,1690.88
19805,97258853,2023-02-06,1912.9,3603.78
19806,97258853,2023-02-06,-833.9,2769.88
19807,97258853,2023-02-11,157.05,2926.9300000000003
19808,97258853,2023-02-12,-81.63,2845.3
19809,97258853,2023-02-14,-47.84,2797.46
19810,97265555,2023-01-31,,73.24
19811,97265555,2023-02-01,137.25,210.49
19812,97265555,2023-02-03,99.42,309.91
19813,97265555,2023-02-04,-77.66,232.25
19814,97265555,2023-02-09,-159.05,73.19999999999999
19815,97265555,2023-02-13,-158.03,-84.83000000000001
19816,97294152,2023-01-31,,700.06
19817,97294152,2023-02-01,1194.4,1894.46
19818,97294152,2023-02-01,120.93,2015.39
19819,97294152,2023-02-01,3.55,2018.94
19820,97294152,2023-02-03,-240.55,1778.39
19821,97294152,2023-02-04,-153.31,1625.08
19822,97294152,2023-02-07,162.51,1787.5900000000001
19823,97294152,2023-02-11,-159.09,1628.5
19824,97294152,2023-02-12,-95.61,1532.89
19825,97294152,2023-02-13,-111.96,1420.93
19826,97294152,2023-02-14,-149.9,1271.03
19827,97305293,2023-01-31,,241.02
19828,97305293,2023-02-03,196.95,437.97
19829,97305293,2023-02-09,145.02,582.99
19830,97305293,2023-02-10,-158.94,424.05
19831,97305293,2023-02-11,-99.56,324.49
19832,97305293,2023-02-14,-65.5,258.99
19833,97328154,2023-01-31,,535.51
19834,97328154,2023-02-03,-90.64,444.87
19835,97328154,2023-02-07,-78.9,365.96999999999997
19836,97328154,2023-02-08,-143.22,222.75
19837,97328154,2023-02-09,135.18,357.93
19838,97328154,2023-02-11,55.67,413.6
19839,97328154,2023-02-11,-107.57,306.03000000000003
19840,97405607,2023-01-31,,981.02
19841,97405607,2023-02-02,93.09,1074.11
19842,97405607,2023-02-06,527.4,1601.51
19843,97405607,2023-02-06,5.35,1606.86
19844,97405607,2023-02-08,-147.08,1459.78
19845,97405607,2023-02-10,-98.32,1361.46
19846,97405607,2023-02-11,56.36,1417.82
19847,97405607,2023-02-12,122.13,1539.95
19848,97405607,2023-02-12,-139.57,1400.38
19849,97405607,2023-02-13,144.57,1544.95
19850,97426293,2023-01-31,,771.74
19851,97426293,2023-02-03,-44.25,727.49
19852,97426293,2023-02-08,-4.84,722.65
19853,97426293,2023-02-10,-28.23,694.42
19854,97426293,2023-02-11,-116.14,578.28
19855,97426293,2023-02-12,-26.9,551.38
19856,97426293,2023-02-12,-112.63,438.75
19857,97426293,2023-02-14,-79.54,359.21
19858,97439311,2023-01-31,,196.91
19859,97439311,2023-02-06,74.25,271.15999999999997
19860,97439311,2023-02-06,-43.59,227.57
19861,97439311,2023-02-07,218.5,446.07
19862,97439311,2023-02-10,705.9,1151.97
19863,97439311,2023-02-13,-2.0,1149.9699999999998
19864,97439311,2023-02-14,136.93,1286.8999999999999
19865,97445899,2023-01-31,,195.42
19866,97445899,2023-02-01,-473.7,-278.28
19867,97445899,2023-02-04,94.61,-183.67000000000002
19868,97445899,2023-02-04,-123.12,-306.79
19869,97445899,2023-02-06,42.54,-264.25000000000006
19870,97445899,2023-02-08,-687.1,-951.3500000000001
19871,97487639,2023-01-31,,403.96
19872,97487639,2023-02-01,110.45,514.41
19873,97487639,2023-02-01,-119.97,394.44
19874,97487639,2023-02-02,151.59,546.03
19875,97487639,2023-02-03,48.79,594.8199999999999
19876,97487639,2023-02-08,157.04,751.8599999999999
19877,97487639,2023-02-09,-1582.3,-830.44
19878,97487639,2023-02-10,200.96,-629.48
19879,97501557,2023-01-31,,572.14
19880,97501557,2023-02-05,148.09,720.23
19881,97501557,2023-02-08,-114.12,606.11
19882,97501557,2023-02-10,144.36,750.47
19883,97501557,2023-02-10,41.65,792.12
19884,97501557,2023-02-10,-66.98,725.14
19885,97501557,2023-02-10,-87.35,637.79
19886,97521278,2023-01-31,,833.78
19887,97521278,2023-02-06,-86.95,746.8299999999999
19888,97521278,2023-02-08,-165.57,581.26
19889,97521278,2023-02-10,121.92,703.18
19890,97521278,2023-02-13,-66.09,637.09
19891,97521278,2023-02-14,-120.16,516.93
19892,97526378,2023-01-31,,540.88
19893,97526378,2023-02-02,-63.42,477.46
19894,97526378,2023-02-03,-769.3,-291.84
19895,97526378,2023-02-04,200.42,-91.41999999999999
19896,97526378,2023-02-07,-55.28,-146.7
19897,97526378,2023-02-12,-89.7,-236.39999999999998
19898,97541080,2023-01-31,,677.34
19899,97541080,2023-02-03,102.16,779.5
19900,97541080,2023-02-11,-2361.6,-1582.1
19901,97542348,2023-01-31,,768.87
19902,97542348,2023-02-01,97.36,866.23
19903,97542348,2023-02-01,77.94,944.17
19904,97542348,2023-02-02,33.06,977.23
19905,97542348,2023-02-03,89.38,1066.61
19906,97542348,2023-02-05,-897.5,169.11
19907,97542348,2023-02-06,114.33,283.44
19908,97542348,2023-02-06,-193.06,90.38
19909,97542348,2023-02-14,-187.3,-96.92000000000002
19910,97555037,2023-01-31,,405.29
19911,97555037,2023-02-05,141.29,546.58
19912,97555037,2023-02-10,67.07,613.65
19913,97555037,2023-02-14,175.06,788.71
19914,97555037,2023-02-14,-77.4,711.31
19915,97558121,2023-01-31,,699.28
19916,97558121,2023-02-05,135.59,834.87
19917,97558121,2023-02-08,-119.07,715.8
19918,97558121,2023-02-14,132.91,848.71
19919,97558121,2023-02-14,105.11,953.8199999999999
19920,97558121,2023-02-14,53.27,1007.09
19921,97571696,2023-01-31,,622.92
19922,97571696,2023-02-01,1361.0,1983.92
19923,97571696,2023-02-08,15.71,1999.63
19924,97581232,2023-01-31,,608.89
19925,97581232,2023-02-07,135.32,744.21
19926,97581232,2023-02-09,1166.4,1910.6100000000001
19927,97581232,2023-02-11,134.72,2045.3300000000002
19928,97581232,2023-02-12,-143.91,1901.42
19929,97581232,2023-02-12,-146.24,1755.18
19930,97624673,2023-01-31,,481.09
19931,97624673,2023-02-07,-92.81,388.28
19932,97624673,2023-02-08,95.08,483.35999999999996
19933,97624673,2023-02-11,130.33,613.69
19934,97624673,2023-02-13,116.67,730.36
19935,97738591,2023-01-31,,254.4
19936,97738591,2023-02-09,101.26,355.66
19937,97738591,2023-02-12,-88.41,267.25
19938,97738591,2023-02-14,81.15,348.40000000000003
19939,97762952,2023-01-31,,411.87
19940,97762952,2023-02-01,-38.91,372.96000000000004
19941,97762952,2023-02-02,-15.44,357.52
19942,97762952,2023-02-04,-97.94,259.58000000000004
19943,97762952,2023-02-08,128.28,387.86
19944,97762952,2023-02-09,-101.53,286.33000000000004
19945,97762952,2023-02-11,471.8,758.13
19946,97762952,2023-02-13,-113.3,644.83
19947,97773835,2023-01-31,,165.51
19948,97773835,2023-02-03,-72.44,93.07
19949,97773835,2023-02-09,-134.52,-41.45000000000002
19950,97843608,2023-01-31,,19.05
19951,97843608,2023-02-03,349.6,368.65000000000003
19952,97843608,2023-02-04,111.47,480.12
19953,97843608,2023-02-06,22.17,502.29
19954,97843608,2023-02-12,104.69,606.98
19955,97843608,2023-02-13,-187.8,419.18
19956,97844854,2023-01-31,,547.15
19957,97844854,2023-02-02,-142.95,404.2
19958,97844854,2023-02-12,-133.45,270.75
19959,97844854,2023-02-14,-91.73,179.01999999999998
19960,97870414,2023-01-31,,818.88
19961,97870414,2023-02-01,-160.61,658.27
19962,97870414,2023-02-01,-913.5,-255.23000000000002
19963,97870414,2023-02-03,-195.63,-450.86
19964,97870414,2023-02-06,-374.5,-825.36
19965,97870414,2023-02-07,-164.87,-990.23
19966,97870414,2023-02-12,-81.53,-1071.76
19967,97913385,2023-01-31,,498.49
19968,97913385,2023-02-01,98.26,596.75
19969,97913385,2023-02-01,50.55,647.3
19970,97913385,2023-02-03,117.86,765.16
19971,97913385,2023-02-05,-78.62,686.54
19972,97913385,2023-02-08,-362.6,323.94
19973,97913385,2023-02-10,210.62,534.56
19974,97913385,2023-02-10,-27.72,506.84000000000003
19975,97913385,2023-02-13,74.3,581.14
19976,97935683,2023-01-31,,40.96
19977,97935683,2023-02-06,-152.16,-111.19999999999999
19978,97935683,2023-02-14,-173.88,-285.08
19979,97939041,2023-01-31,,320.97
19980,97939041,2023-02-04,66.17,387.14000000000004
19981,97939041,2023-02-06,-68.88,318.26000000000005
19982,97939041,2023-02-11,792.4,1110.66
19983,97939041,2023-02-11,-18.39,1092.27
19984,97939041,2023-02-13,80.1,1172.37
19985,97939041,2023-02-13,-145.1,1027.27
19986,97944124,2023-01-31,,258.19
19987,97944124,2023-02-14,-100.16,158.03
19988,97954732,2023-01-31,,506.16
19989,97954732,2023-02-04,-142.88,363.28000000000003
19990,97954732,2023-02-11,116.92,480.20000000000005
19991,97954732,2023-02-14,154.35,634.55
19992,97970258,2023-01-31,,309.14
19993,97970258,2023-02-01,-35.88,273.26
19994,97970258,2023-02-01,-89.15,184.10999999999999
19995,97970258,2023-02-03,-110.38,73.72999999999999
19996,97970258,2023-02-08,-64.87,8.859999999999985
19997,97970258,2023-02-11,-72.82,-63.96000000000001
19998,97970258,2023-02-12,-94.05,-158.01
19999,97970258,2023-02-13,-37.31,-195.32
20000,97983552,2023-01-31,,584.92
20001,97983552,2023-02-01,670.1,1255.02
20002,97983552,2023-02-03,-214.53,1040.49
20003,97983552,2023-02-06,-1912.9,-872.4100000000001
20004,97983552,2023-02-10,-819.0,-1691.41
20005,97985291,2023-01-31,,234.19
20006,97985291,2023-02-02,-53.0,181.19
20007,97985291,2023-02-03,79.51,260.7
20008,97985291,2023-02-05,131.72,392.42
20009,97985291,2023-02-08,187.67,580.09
20010,97985291,2023-02-08,-62.88,517.21
20011,97985291,2023-02-13,-123.05,394.15999999999997
20012,97988499,2023-01-31,,344.28
20013,97988499,2023-02-01,-97.37,246.90999999999997
20014,97988499,2023-02-05,104.95,351.85999999999996
20015,97988499,2023-02-06,-160.17,191.69
20016,97988499,2023-02-08,1026.8,1218.49
20017,97988499,2023-02-12,127.05,1345.54
20018,97988499,2023-02-12,-98.15,1247.39
20019,98043237,2023-01-31,,491.59
20020,98043237,2023-02-02,-99.34,392.25
20021,98043237,2023-02-08,-154.2,238.04999999999998
20022,98043237,2023-02-08,-473.2,-235.15
20023,98043237,2023-02-13,78.91,-156.24
20024,98043237,2023-02-13,-75.02,-231.26
20025,98070849,2023-01-31,,993.94
20026,98070849,2023-02-01,140.27,1134.21
20027,98070849,2023-02-01,125.14,1259.3500000000001
20028,98070849,2023-02-01,54.98,1314.3300000000002
20029,98070849,2023-02-01,-106.8,1207.53
20030,98070849,2023-02-04,132.93,1340.46
20031,98070849,2023-02-08,442.3,1782.7600000000002
20032,98070849,2023-02-08,-110.55,1672.21
20033,98070849,2023-02-11,96.9,1769.1100000000001
20034,98070849,2023-02-11,68.2,1837.3100000000002
20035,98070849,2023-02-14,120.46,1957.7700000000002
20036,98107200,2023-01-31,,325.82
20037,98107200,2023-02-02,140.34,466.15999999999997
20038,98107200,2023-02-03,-9.03,457.13
20039,98107200,2023-02-03,-66.9,390.23
20040,98107200,2023-02-10,55.17,445.4
20041,98112233,2023-01-31,,123.26
20042,98112233,2023-02-01,-54.5,68.76
20043,98112233,2023-02-04,163.03,231.79000000000002
20044,98112233,2023-02-04,111.88,343.66999999999996
20045,98112233,2023-02-04,74.95,418.62
20046,98112233,2023-02-04,-129.37,289.25
20047,98112233,2023-02-05,146.29,435.53999999999996
20048,98112233,2023-02-05,-44.78,390.76
20049,98112233,2023-02-06,75.16,465.91999999999996
20050,98112233,2023-02-06,-739.3,-273.38
20051,98112233,2023-02-13,114.36,-159.01999999999998
20052,98112233,2023-02-13,113.41,-45.61
20053,98112233,2023-02-13,-101.49,-147.1
20054,98119030,2023-01-31,,179.3
20055,98119030,2023-02-04,75.25,254.55
20056,98119030,2023-02-04,48.63,303.18
20057,98119030,2023-02-07,89.15,392.33000000000004
20058,98119030,2023-02-14,-81.37,310.96000000000004
20059,98138904,2023-01-31,,885.18
20060,98138904,2023-02-08,-40.97,844.2099999999999
20061,98138904,2023-02-10,46.29,890.5
20062,98138904,2023-02-13,-126.07,764.43
20063,98138904,2023-02-14,-118.69,645.74
20064,98156945,2023-01-31,,449.81
20065,98156945,2023-02-02,45.22,495.03
20066,98156945,2023-02-06,711.2,1206.23
20067,98156945,2023-02-07,-1567.0,-360.77
20068,98156945,2023-02-08,150.5,-210.26999999999998
20069,98156945,2023-02-12,44.88,-165.39
20070,98156945,2023-02-14,60.92,-104.46999999999997
20071,98159348,2023-01-31,,703.62
20072,98159348,2023-02-02,-61.45,642.17
20073,98159348,2023-02-04,-503.6,138.57
20074,98159348,2023-02-10,128.06,266.63
20075,98159348,2023-02-11,63.01,329.64
20076,98159348,2023-02-14,92.59,422.23
20077,98221133,2023-01-31,,596.52
20078,98221133,2023-02-01,97.92,694.4399999999999
20079,98221133,2023-02-03,-55.63,638.81
20080,98221133,2023-02-05,111.54,750.35
20081,98221133,2023-02-06,33.32,783.67
20082,98221133,2023-02-06,-28.71,754.96
20083,98221133,2023-02-08,1002.0,1756.96
20084,98221133,2023-02-09,89.48,1846.44
20085,98221133,2023-02-09,-132.75,1713.69
20086,98221133,2023-02-11,-557.0,1156.69
20087,98221133,2023-02-12,37.35,1194.04
20088,98221133,2023-02-12,-62.63,1131.41
20089,98221133,2023-02-14,40.73,1172.14
20090,98237008,2023-01-31,,437.26
20091,98237008,2023-02-02,865.4,1302.6599999999999
20092,98237008,2023-02-04,61.06,1363.72
20093,98237008,2023-02-05,72.53,1436.25
20094,98237008,2023-02-08,61.29,1497.54
20095,98237008,2023-02-09,-1038.5,459.03999999999996
20096,98237008,2023-02-12,93.16,552.1999999999999
20097,98237008,2023-02-13,199.57,751.77
20098,98237008,2023-02-13,-162.05,589.7199999999999
20099,98336782,2023-01-31,,266.46
20100,98336782,2023-02-06,-34.2,232.26
20101,98336782,2023-02-06,-95.71,136.54999999999998
20102,98336782,2023-02-08,-106.87,29.67999999999998
20103,98336782,2023-02-11,128.1,157.77999999999997
20104,98336782,2023-02-13,55.26,213.03999999999996
20105,98353764,2023-01-31,,763.6
20106,98353764,2023-02-03,-179.54,584.0600000000001
20107,98353764,2023-02-04,-85.2,498.86
20108,98353764,2023-02-13,80.09,578.95
20109,98372749,2023-01-31,,136.21
20110,98372749,2023-02-01,130.44,266.65
20111,98372749,2023-02-01,-45.11,221.54000000000002
20112,98372749,2023-02-07,-101.79,119.75
20113,98372749,2023-02-09,-75.46,44.290000000000006
20114,98372749,2023-02-10,72.61,116.9
20115,98372749,2023-02-12,-44.97,71.93
20116,98377332,2023-01-31,,343.09
20117,98377332,2023-02-03,127.44,470.53
20118,98377332,2023-02-08,1779.2,2249.73
20119,98377332,2023-02-14,-132.91,2116.82
20120,98459176,2023-01-31,,168.19
20121,98459176,2023-02-01,-229.8,-61.610000000000014
20122,98459176,2023-02-03,-87.44,-149.05
20123,98459176,2023-02-03,-88.58,-237.63
20124,98459176,2023-02-05,-135.88,-373.51
20125,98459176,2023-02-06,82.75,-290.76
20126,98459176,2023-02-07,-737.4,-1028.1599999999999
20127,98459176,2023-02-12,-155.17,-1183.33
20128,98459176,2023-02-13,-63.98,-1247.31
20129,98517701,2023-01-31,,277.91
20130,98517701,2023-02-07,54.52,332.43
20131,98517701,2023-02-09,-151.14,181.29000000000005
20132,98568929,2023-01-31,,396.03
20133,98568929,2023-02-04,157.68,553.71
20134,98568929,2023-02-05,139.75,693.46
20135,98568929,2023-02-09,-83.47,609.99
20136,98568929,2023-02-13,1121.3,1731.29
20137,98568929,2023-02-14,-119.48,1611.81
20138,98575383,2023-01-31,,937.72
20139,98575383,2023-02-01,-152.59,785.13
20140,98575383,2023-02-03,-10.53,774.6
20141,98575383,2023-02-08,-87.34,687.26
20142,98575383,2023-02-09,-24.12,663.14
20143,98575383,2023-02-11,-33.32,629.82
20144,98575383,2023-02-11,-83.01,546.8100000000001
20145,98575383,2023-02-11,-99.42,447.39
20146,98575383,2023-02-13,-139.76,307.63
20147,98575383,2023-02-13,-144.57,163.06000000000003
20148,98596312,2023-01-31,,768.92
20149,98596312,2023-02-03,-174.31,594.6099999999999
20150,98596312,2023-02-06,-158.11,436.49999999999994
20151,98596312,2023-02-07,-120.62,315.87999999999994
20152,98596312,2023-02-09,88.39,404.2699999999999
20153,98596312,2023-02-09,-33.68,370.5899999999999
20154,98611122,2023-01-31,,595.22
20155,98611122,2023-02-01,12.21,607.4300000000001
20156,98611122,2023-02-01,-84.44,522.99
20157,98611122,2023-02-03,913.8,1436.79
20158,98611122,2023-02-06,76.04,1512.83
20159,98611122,2023-02-07,-123.36,1389.47
20160,98611122,2023-02-09,126.2,1515.67
20161,98611122,2023-02-09,-57.19,1458.48
20162,98611122,2023-02-13,118.5,1576.98
20163,98611122,2023-02-13,-170.79,1406.19
20164,98611122,2023-02-14,-103.89,1302.3
20165,98620342,2023-01-31,,976.13
20166,98620342,2023-02-05,1533.5,2509.63
20167,98620342,2023-02-10,39.48,2549.11
20168,98620342,2023-02-12,1006.5,3555.61
20169,98620342,2023-02-12,91.93,3647.54
20170,98620342,2023-02-14,152.69,3800.23
20171,98671410,2023-01-31,,218.46
20172,98671410,2023-02-01,-45.64,172.82
20173,98671410,2023-02-01,-83.63,89.19000000000001
20174,98671410,2023-02-02,198.45,287.64
20175,98671410,2023-02-02,95.44,383.08
20176,98671410,2023-02-03,1016.9,1399.98
20177,98671410,2023-02-05,90.06,1490.04
20178,98671410,2023-02-06,-32.37,1457.6699999999998
20179,98671410,2023-02-13,-73.86,1383.81
20180,98717357,2023-01-31,,183.63
20181,98717357,2023-02-03,-151.73,31.900000000000006
20182,98717357,2023-02-04,-1369.6,-1337.6999999999998
20183,98717357,2023-02-06,-51.75,-1389.4499999999998
20184,98717357,2023-02-06,-104.0,-1493.4499999999998
20185,98776498,2023-01-31,,79.4
20186,98821521,2023-01-31,,906.51
20187,98821521,2023-02-01,-54.71,851.8
20188,98821521,2023-02-02,-87.06,764.74
20189,98821521,2023-02-07,84.76,849.5
20190,98821521,2023-02-08,-88.56,760.9399999999999
20191,98821521,2023-02-13,139.98,900.92
20192,98821521,2023-02-13,-152.6,748.3199999999999
20193,98849007,2023-01-31,,58.26
20194,98849007,2023-02-01,4.45,62.71
20195,98849007,2023-02-11,103.41,166.12
20196,98849007,2023-02-12,183.53,349.65
20197,98882065,2023-01-31,,630.68
20198,98882065,2023-02-01,92.81,723.49
20199,98882065,2023-02-01,-75.85,647.64
20200,98882065,2023-02-06,-1065.6,-417.9599999999999
20201,98882065,2023-02-07,84.81,-333.1499999999999
20202,98882065,2023-02-07,-125.12,-458.2699999999999
20203,98882065,2023-02-09,56.29,-401.9799999999999
20204,98882065,2023-02-11,-45.84,-447.81999999999994
20205,98882225,2023-01-31,,881.65
20206,98882225,2023-02-05,153.59,1035.24
20207,98882225,2023-02-05,-1712.2,-676.96
20208,98882225,2023-02-11,259.39,-417.57000000000005
20209,98882225,2023-02-13,56.85,-360.72
20210,98886699,2023-01-31,,300.31
20211,98886699,2023-02-01,152.86,453.17
20212,98886699,2023-02-04,80.75,533.9200000000001
20213,98886699,2023-02-04,-44.06,489.86
20214,98886699,2023-02-10,-1124.9,-635.0400000000001
20215,98886699,2023-02-11,32.04,-603.0000000000001
20216,98886699,2023-02-12,180.44,-422.56000000000006
20217,98931016,2023-01-31,,561.33
20218,98931016,2023-02-02,89.8,651.13
20219,98931016,2023-02-02,69.41,720.5400000000001
20220,98931016,2023-02-02,-755.3,-34.75999999999988
20221,98931016,2023-02-10,96.34,61.580000000000126
20222,98931016,2023-02-14,349.1,410.6800000000002
20223,98940578,2023-01-31,,59.28
20224,98940578,2023-02-06,1032.3,1091.58
20225,98940578,2023-02-06,-94.25,997.3299999999999
20226,98940578,2023-02-07,99.74,1097.07
20227,98940578,2023-02-08,-44.49,1052.58
20228,99000939,2023-01-31,,155.29
20229,99000939,2023-02-04,-58.31,96.97999999999999
20230,99000939,2023-02-06,-138.14,-41.16
20231,99000939,2023-02-07,-11.35,-52.51
20232,99000939,2023-02-07,-92.7,-145.21
20233,99000939,2023-02-09,-84.51,-229.72
20234,99015119,2023-01-31,,443.55
20235,99015119,2023-02-03,565.2,1008.75
20236,99015119,2023-02-03,-112.46,896.29
20237,99015119,2023-02-05,49.2,945.49
20238,99015119,2023-02-06,-76.0,869.49
20239,99015119,2023-02-09,147.12,1016.61
20240,99015119,2023-02-11,-125.31,891.3
20241,99015119,2023-02-12,-18.99,872.3100000000001
20242,99244906,2023-01-31,,965.33
20243,99244906,2023-02-01,-88.65,876.6800000000001
20244,99244906,2023-02-02,51.28,927.96
20245,99244906,2023-02-04,-105.17,822.7900000000001
20246,99244906,2023-02-08,-133.74,689.05
20247,99244906,2023-02-10,-50.52,638.53
20248,99244906,2023-02-13,-72.94,565.59
20249,99261094,2023-01-31,,475.8
20250,99261094,2023-02-01,-119.5,356.3
20251,99261094,2023-02-04,85.2,441.5
20252,99261094,2023-02-06,646.5,1088.0
20253,99261094,2023-02-10,-25.17,1062.83
20254,99261094,2023-02-12,209.98,1272.81
20255,99261094,2023-02-12,38.33,1311.14
20256,99261094,2023-02-14,-98.11,1213.03
20257,99261094,2023-02-14,-111.83,1101.2
20258,99296816,2023-01-31,,814.56
20259,99296816,2023-02-01,-246.14,568.42
20260,99296816,2023-02-02,-634.2,-65.78000000000009
20261,99296816,2023-02-05,-76.31,-142.0900000000001
20262,99296816,2023-02-06,56.09,-86.00000000000009
20263,99296816,2023-02-06,-77.23,-163.23000000000008
20264,99296816,2023-02-08,66.6,-96.6300000000001
20265,99296816,2023-02-10,178.01,81.3799999999999
20266,99296816,2023-02-14,-83.33,-1.9500000000001023
20267,99481977,2023-01-31,,940.06
20268,99481977,2023-02-01,114.04,1054.1
20269,99481977,2023-02-02,1695.5,2749.6
20270,99481977,2023-02-07,-43.31,2706.29
20271,99481977,2023-02-07,-1808.5,897.79
20272,99481977,2023-02-09,-89.48,808.31
20273,99481977,2023-02-13,-129.28,679.03
20274,99481977,2023-02-14,-40.82,638.2099999999999
20275,99496896,2023-01-31,,431.32
20276,99496896,2023-02-08,65.82,497.14
20277,99514298,2023-01-31,,154.78
20278,99514298,2023-02-01,-73.14,81.64
20279,99514298,2023-02-02,111.58,193.22
20280,99514298,2023-02-04,-62.25,130.97
20281,99514298,2023-02-05,-81.05,49.92
20282,99514298,2023-02-06,-75.9,-25.980000000000004
20283,99514298,2023-02-07,1121.9,1095.92
20284,99514298,2023-02-07,-104.21,991.71
20285,99514298,2023-02-10,-147.51,844.2
20286,99514298,2023-02-12,-148.17,696.0300000000001
20287,99514298,2023-02-14,-558.8,137.23000000000013
20288,99553778,2023-01-31,,621.65
20289,99553778,2023-02-04,180.29,801.9399999999999
20290,99553778,2023-02-04,163.96,965.9
20291,99553778,2023-02-04,104.91,1070.81
20292,99553778,2023-02-04,-141.33,929.48
20293,99553778,2023-02-05,-974.8,-45.319999999999936
20294,99553778,2023-02-10,97.9,52.58000000000007
20295,99553778,2023-02-12,-63.69,-11.109999999999928
20296,99553778,2023-02-13,-47.54,-58.64999999999993
20297,99553778,2023-02-14,-76.31,-134.95999999999992
20298,99611232,2023-01-31,,849.72
20299,99611232,2023-02-01,-119.74,729.98
20300,99611232,2023-02-04,-117.6,612.38
20301,99611232,2023-02-06,69.84,682.22
20302,99611232,2023-02-09,-161.19,521.03
20303,99611232,2023-02-10,-38.38,482.65000000000003
20304,99611232,2023-02-14,49.55,532.2
20305,99657974,2023-01-31,,263.32
20306,99657974,2023-02-01,-114.47,148.85
20307,99657974,2023-02-03,-157.43,-8.580000000000013
20308,99657974,2023-02-06,1.58,-7.000000000000012
20309,99657974,2023-02-08,160.99,153.99
20310,99657974,2023-02-09,82.14,236.13
20311,99657974,2023-02-10,57.04,293.17
20312,99657974,2023-02-14,134.42,427.59000000000003
20313,99678854,2023-01-31,,664.0
20314,99678854,2023-02-06,128.13,792.13
20315,99678854,2023-02-07,199.41,991.54
20316,99678854,2023-02-07,76.35,1067.8899999999999
20317,99678854,2023-02-14,111.15,1179.04
20318,99685765,2023-01-31,,43.01
20319,99685765,2023-02-02,10.1,53.11
20320,99685765,2023-02-04,91.11,144.22
20321,99685765,2023-02-06,-120.6,23.620000000000005
20322,99685765,2023-02-08,-957.8,-934.18
20323,99685765,2023-02-09,34.17,-900.01
20324,99685765,2023-02-10,-98.69,-998.6999999999999
20325,99685765,2023-02-11,1815.0,816.3000000000001
20326,99709741,2023-01-31,,98.23
20327,99709741,2023-02-07,12.69,110.92
20328,99709741,2023-02-09,73.82,184.74
20329,99709741,2023-02-13,-138.4,46.339999999999975
20330,99729369,2023-01-31,,751.01
20331,99729369,2023-02-01,-1194.4,-443.3900000000001
20332,99729369,2023-02-02,124.21,-319.1800000000001
20333,99729369,2023-02-03,-240.26,-559.44
20334,99729369,2023-02-03,-1619.6,-2179.04
20335,99729369,2023-02-04,127.68,-2051.36
20336,99729369,2023-02-06,-89.63,-2140.99
20337,99729369,2023-02-07,138.38,-2002.61
20338,99729369,2023-02-10,-144.33,-2146.94
20339,99730589,2023-01-31,,988.44
20340,99730589,2023-02-03,58.23,1046.67
20341,99730589,2023-02-09,155.34,1202.01
20342,99730589,2023-02-10,62.26,1264.27
20343,99734848,2023-01-31,,354.29
20344,99734848,2023-02-04,503.6,857.8900000000001
20345,99734848,2023-02-12,-1342.4,-484.51
20346,99734848,2023-02-14,-79.76,-564.27
20347,99760030,2023-01-31,,988.0
20348,99760030,2023-02-02,616.7,1604.7
20349,99760030,2023-02-02,-1028.8,575.9000000000001
20350,99760030,2023-02-07,-173.55,402.3500000000001
20351,99760030,2023-02-08,80.13,482.4800000000001
20352,99760030,2023-02-11,118.35,600.83
20353,99760030,2023-02-12,-139.76,461.07000000000005
20354,99760030,2023-02-14,140.07,601.1400000000001
20355,99791709,2023-01-31,,15.05
20356,99791709,2023-02-03,-89.38,-74.33
20357,99791709,2023-02-04,142.88,68.55
20358,99791709,2023-02-04,-2.86,65.69
20359,99791709,2023-02-06,-1359.0,-1293.31
20360,99791709,2023-02-11,78.32,-1214.99
20361,99791709,2023-02-13,800.9,-414.0899999999999
20362,99877007,2023-01-31,,582.0
20363,99877007,2023-02-01,-103.16,478.84000000000003
20364,99877007,2023-02-02,189.79,668.63
20365,99877007,2023-02-05,-72.33,596.3
20366,99877007,2023-02-07,154.41,750.71
20367,99877007,2023-02-11,84.59,835.3
20368,99937043,2023-01-31,,918.42
20369,99937043,2023-02-01,71.22,989.64
20370,99937043,2023-02-02,-142.45,847.1899999999999
20371,99937043,2023-02-03,-52.49,794.6999999999999
20372,99937043,2023-02-04,123.12,917.8199999999999
20373,99937043,2023-02-05,52.36,970.18
20374,99937043,2023-02-06,-92.42,877.76
20375,99937043,2023-02-09,-122.91,754.8499999999999
20376,99937043,2023-02-11,-125.33,629.52
20377,99937043,2023-02-13,75.16,704.68
